;ensembl_gene_id;hgnc_symbol;chromosome_name;start_position;end_position;gene_length;DEG
1;ENSG00000000457;SCYL3;1;169818772;169863408;44636;0
2;ENSG00000000460;C1orf112;1;169631245;169823221;191976;0
3;ENSG00000001460;STPG1;1;24683489;24743424;59935;0
4;ENSG00000001461;NIPAL3;1;24742284;24799466;57182;0
5;ENSG00000002016;RAD52;12;1021243;1099219;77976;0
6;ENSG00000002330;BAD;11;64037302;64052176;14874;0
7;ENSG00000003056;M6PR;12;9092959;9102551;9592;0
8;ENSG00000004455;AK2;1;33473585;33546597;73012;0
9;ENSG00000004478;FKBP4;12;2904119;2914576;10457;0
10;ENSG00000004487;KDM1A;1;23345941;23410182;64241;0
11;ENSG00000004700;RECQL;12;21621845;21654603;32758;0
12;ENSG00000005175;RPAP3;12;48057070;48099844;42774;0
13;ENSG00000005801;ZNF195;11;3360491;3400448;39957;0
14;ENSG00000006071;ABCC8;11;17414432;17498449;84017;0
15;ENSG00000006118;TMEM132A;11;60691935;60704631;12696;0
16;ENSG00000006534;ALDH3B1;11;67776048;67796744;20696;0
17;ENSG00000006831;ADIPOR2;12;1797740;1897844;100104;0
18;ENSG00000007341;ST7L;1;113066140;113163447;97307;0
19;ENSG00000007372;PAX6;11;31806340;31839509;33169;1
20;ENSG00000007923;DNAJC11;1;6694228;6761984;67756;0
21;ENSG00000007968;E2F2;1;23832922;23857712;24790;0
22;ENSG00000008118;CAMK1G;1;209757062;209787283;30221;0
23;ENSG00000008128;CDK11A;1;1634169;1655766;21597;0
24;ENSG00000008130;NADK;1;1682671;1711896;29225;0
25;ENSG00000008394;MGST1;12;16500076;16762193;262117;0
26;ENSG00000008405;CRY1;12;107385142;107487607;102465;0
27;ENSG00000009307;CSDE1;1;115259534;115301297;41763;0
28;ENSG00000009709;PAX7;1;18957500;19075360;117860;1
29;ENSG00000009780;FAM76A;1;28052490;28089633;37143;0
30;ENSG00000010072;SPRTN;1;231472850;231490769;17919;0
31;ENSG00000010165;METTL13;1;171750788;171783163;32375;0
32;ENSG00000010219;DYRK4;12;4671370;4723325;51955;0
33;ENSG00000010278;CD9;12;6308881;6347425;38544;0
34;ENSG00000010292;NCAPD2;12;6602522;6641121;38599;0
35;ENSG00000010295;IFFO1;12;6647541;6665239;17698;0
36;ENSG00000010379;SLC6A13;12;329789;372039;42250;0
37;ENSG00000010626;LRRC23;12;6982733;7023407;40674;0
38;ENSG00000010803;SCMH1;1;41492872;41707826;214954;0
39;ENSG00000011007;TCEB3;1;24069645;24088549;18904;0
40;ENSG00000011009;LYPLA2;1;24117460;24122029;4569;0
41;ENSG00000011021;CLCN6;1;11866207;11903201;36994;0
42;ENSG00000011105;TSPAN9;12;3186521;3395730;209209;0
43;ENSG00000011347;SYT7;11;61282785;61348620;65835;0
44;ENSG00000011405;PIK3C2A;11;17099277;17229530;130253;0
45;ENSG00000012822;CALCOCO1;12;54104903;54121529;16626;0
46;ENSG00000013503;POLR3B;12;106751436;106903976;152540;0
47;ENSG00000013573;DDX11;12;31226779;31257725;30946;0
48;ENSG00000013583;HEBP1;12;13127798;13153207;25409;0
49;ENSG00000013725;CD6;11;60739115;60787849;48734;0
50;ENSG00000014138;POLA2;11;65029233;65073060;43827;0
51;ENSG00000014216;CAPN1;11;64948037;64979477;31440;0
52;ENSG00000014914;MTMR11;1;149900543;149908791;8248;0
53;ENSG00000014919;COX15;10;101471601;101491857;20256;0
54;ENSG00000015153;YAF2;12;42550906;42632151;81245;0
55;ENSG00000015171;ZMYND11;10;180405;300577;120172;0
56;ENSG00000017427;IGF1;12;102789645;102874423;84778;0
57;ENSG00000018236;CNTN1;12;41086244;41466220;379976;0
58;ENSG00000018625;ATP1A2;1;160085549;160113381;27832;0
59;ENSG00000019102;VSIG2;11;124617368;124622134;4766;0
60;ENSG00000019144;PHLDB1;11;118477155;118528741;51586;0
61;ENSG00000019485;PRDM11;11;45115564;45247734;132170;0
62;ENSG00000019505;SYT13;11;45261852;45307870;46018;0
63;ENSG00000019995;ZRANB1;10;126630692;126676758;46066;0
64;ENSG00000020129;NCDN;1;36023074;36032875;9801;0
65;ENSG00000020922;MRE11A;11;94152895;94227074;74179;0
66;ENSG00000021300;PLEKHB1;11;73357223;73373864;16641;1
67;ENSG00000021762;OSBPL5;11;3108346;3187969;79623;0
68;ENSG00000022840;RNF10;12;120971283;121015397;44114;0
69;ENSG00000023041;ZDHHC6;10;114190058;114206672;16614;0
70;ENSG00000023171;GRAMD1B;11;123396344;123498482;102138;0
71;ENSG00000023191;RNH1;11;494512;507300;12788;0
72;ENSG00000023516;AKAP11;13;42846289;42897396;51107;0
73;ENSG00000023572;GLRX2;1;193065598;193075244;9646;0
74;ENSG00000023697;DERA;12;16064106;16190220;126114;0
75;ENSG00000023734;STRAP;12;16035325;16056412;21087;0
76;ENSG00000023839;ABCC2;10;101542489;101611949;69460;0
77;ENSG00000023902;PLEKHO1;1;150121373;150136916;15543;0
78;ENSG00000023909;GCLM;1;94350761;94374966;24205;0
79;ENSG00000024526;DEPDC1;1;68939835;68962904;23069;0
80;ENSG00000025423;HSD17B6;12;57145945;57181574;35629;0
81;ENSG00000025434;NR1H3;11;47269851;47290396;20545;0
82;ENSG00000025800;KPNA6;1;32573639;32642169;68530;0
83;ENSG00000026025;VIM;10;17270258;17279592;9334;1
84;ENSG00000026103;FAS;10;90750414;90775542;25128;0
85;ENSG00000026508;CD44;11;35160417;35253949;93532;1
86;ENSG00000027001;MIPEP;13;24304328;24463558;159230;0
87;ENSG00000028203;VEZT;12;95611522;95696566;85044;0
88;ENSG00000029153;ARNTL2;12;27485787;27576241;90454;0
89;ENSG00000030066;NUP160;11;47799639;47870107;70468;0
90;ENSG00000031698;SARS;1;109756540;109780791;24251;0
91;ENSG00000032742;IFT88;13;21140585;21265503;124918;0
92;ENSG00000033030;ZCCHC8;12;122957417;122985518;28101;0
93;ENSG00000033122;LRRC7;1;70034081;70617628;583547;0
94;ENSG00000033327;GAB2;11;77926343;78129394;203051;0
95;ENSG00000035403;VCL;10;75757872;75879918;122046;0
96;ENSG00000035687;ADSS;1;244571796;244615436;43640;0
97;ENSG00000036549;ZZZ3;1;78028101;78149104;121003;0
98;ENSG00000036672;USP2;11;119225925;119252436;26511;0
99;ENSG00000037637;FBXO42;1;16573334;16678949;105615;0
100;ENSG00000037897;METTL1;12;58162254;58166576;4322;0
101;ENSG00000040487;PQLC2;1;19638820;19655794;16974;0
102;ENSG00000041988;THAP3;1;6684926;6695646;10720;0
103;ENSG00000042286;AIFM2;10;71857979;71892690;34711;0
104;ENSG00000042429;MED17;11;93517393;93547861;30468;0
105;ENSG00000042781;USH2A;1;215796236;216596738;800502;0
106;ENSG00000043514;TRIT1;1;40306723;40349183;42460;0
107;ENSG00000047056;WDR37;10;1095478;1178237;82759;0
108;ENSG00000047410;TPR;1;186280784;186344825;64041;0
109;ENSG00000047617;ANO2;12;5641035;6055398;414363;0
110;ENSG00000047621;C12orf4;12;4596894;4647674;50780;0
111;ENSG00000048028;USP28;11;113668596;113746292;77696;0
112;ENSG00000048540;LMO3;12;16701307;16763528;62221;0
113;ENSG00000048649;RSF1;11;77371041;77532063;161022;0
114;ENSG00000048707;VPS13D;1;12290124;12572099;281975;0
115;ENSG00000048740;CELF2;10;11047259;11378674;331415;0
116;ENSG00000049089;COL9A2;1;40766159;40783488;17329;0
117;ENSG00000049130;KITLG;12;88886570;88974628;88058;1
118;ENSG00000049239;H6PD;1;9294834;9331396;36562;0
119;ENSG00000049245;VAMP3;1;7831329;7841492;10163;0
120;ENSG00000049246;PER3;1;7844380;7905237;60857;0
121;ENSG00000049449;RCN1;11;31833939;32127301;293362;0
122;ENSG00000050165;DKK3;11;11984653;12031316;46663;0
123;ENSG00000050405;LIMA1;12;50569571;50677329;107758;0
124;ENSG00000050426;LETMD1;12;51441745;51454207;12462;0
125;ENSG00000050438;SLC4A8;12;51785101;51902980;117879;0
126;ENSG00000050628;PTGER3;1;71318036;71513491;195455;0
127;ENSG00000051009;FAM160A2;11;6232565;6255941;23376;0
128;ENSG00000051825;MPHOSPH9;12;123636867;123728561;91694;0
129;ENSG00000052126;PLEKHA5;12;19282648;19529334;246686;0
130;ENSG00000052723;SIKE1;1;115312100;115323306;11206;0
131;ENSG00000052749;RRP12;10;99116115;99161127;45012;0
132;ENSG00000052841;TTC17;11;43380482;43516483;136001;0
133;ENSG00000053371;AKR7A2;1;19630459;19638640;8181;0
134;ENSG00000053372;MRTO4;1;19578033;19586622;8589;0
135;ENSG00000054116;TRAPPC3;1;36602173;36615098;12925;0
136;ENSG00000054118;THRAP3;1;36690017;36770958;80941;0
137;ENSG00000054267;ARID4B;1;235294949;235491534;196585;0
138;ENSG00000054277;OPN3;1;241753404;241840678;87274;0
139;ENSG00000054282;SDCCAG8;1;243419320;243663394;244074;0
140;ENSG00000054392;HHAT;1;210501596;210849638;348042;0
141;ENSG00000054523;KIF1B;1;10270863;10441661;170798;0
142;ENSG00000054965;FAM168A;11;73111532;73309234;197702;0
143;ENSG00000054967;RELT;11;73087309;73108519;21210;0
144;ENSG00000055070;SZRD1;1;16679070;16724640;45570;0
145;ENSG00000055950;MRPL43;10;102729215;102747272;18057;0
146;ENSG00000057252;SOAT1;1;179262925;179327815;64890;0
147;ENSG00000057294;PKP2;12;32943679;33049774;106095;0
148;ENSG00000057468;MSH4;1;76262567;76378923;116356;0
149;ENSG00000057608;GDI2;10;5807186;5884095;76909;0
150;ENSG00000057704;TMCC3;12;94960900;95044338;83438;0
151;ENSG00000057757;PITHD1;1;24104895;24114722;9827;0
152;ENSG00000058085;LAMC2;1;183155373;183214035;58662;0
153;ENSG00000058272;PPP1R12A;12;80167343;80329240;161897;0
154;ENSG00000058453;CROCC;1;17066768;17299474;232706;0
155;ENSG00000058668;ATP2B4;1;203595689;203713209;117520;0
156;ENSG00000058673;ZC3H11A;1;203764782;203823252;58470;0
157;ENSG00000058799;YIPF1;1;54317392;54356407;39015;0
158;ENSG00000058804;NDC1;1;54231133;54304533;73400;0
159;ENSG00000059573;ALDH18A1;10;97365696;97416463;50767;0
160;ENSG00000059588;TARBP1;1;234527059;234614849;87790;0
161;ENSG00000059758;CDK17;12;96672039;96794338;122299;0
162;ENSG00000059804;SLC2A3;12;8071826;8088871;17045;0
163;ENSG00000059915;PSD;10;104162376;104181296;18920;0
164;ENSG00000060138;YBX3;12;10851683;10875911;24228;1
165;ENSG00000060140;STYK1;12;10771538;10826917;55379;0
166;ENSG00000060237;WNK1;12;861759;1020618;158859;0
167;ENSG00000060339;CCAR1;10;70480769;70552134;71365;0
168;ENSG00000060642;PIGV;1;27113963;27124889;10926;0
169;ENSG00000060656;PTPRU;1;29563028;29653325;90297;0
170;ENSG00000060688;SNRNP40;1;31732417;31769662;37245;0
171;ENSG00000060709;RIMBP2;12;130880682;131200826;320144;0
172;ENSG00000060718;COL11A1;1;103342023;103574052;232029;0
173;ENSG00000060749;QSER1;11;32914724;33014862;100138;0
174;ENSG00000060982;BCAT1;12;24964295;25102393;138098;0
175;ENSG00000061273;HDAC7;12;48176505;48226915;50410;0
176;ENSG00000061794;MRPS35;12;27863706;27909228;45522;0
177;ENSG00000061936;SFSWAP;12;132195626;132284282;88656;0
178;ENSG00000061987;MON2;12;62860597;62991363;130766;0
179;ENSG00000062282;DGAT2;11;75470557;75512579;42022;0
180;ENSG00000062485;CS;12;56665483;56694176;28693;0
181;ENSG00000062650;WAPAL;10;88195013;88281572;86559;0
182;ENSG00000063046;EIF4B;12;53399942;53435993;36051;0
183;ENSG00000064102;ASUN;12;27058114;27091259;33145;0
184;ENSG00000064115;TM7SF3;12;27126128;27167367;41239;0
185;ENSG00000064199;SPA17;11;124543694;124567414;23720;0
186;ENSG00000064309;CDON;11;125825691;125933230;107539;0
187;ENSG00000064703;DDX20;1;112297867;112310638;12771;0
188;ENSG00000064763;FAR2;12;29302036;29493913;191877;1
189;ENSG00000065135;GNAI3;1;110091233;110136975;45742;0
190;ENSG00000065154;OAT;10;126085872;126107545;21673;0
191;ENSG00000065183;WDR3;1;118472343;118509165;36822;0
192;ENSG00000065243;PKN2;1;89149905;89301938;152033;0
193;ENSG00000065328;MCM10;10;13203554;13253104;49550;0
194;ENSG00000065357;DGKA;12;56321103;56347811;26708;0
195;ENSG00000065361;ERBB3;12;56473641;56497289;23648;0
196;ENSG00000065526;SPEN;1;16174359;16266955;92596;0
197;ENSG00000065600;TMEM206;1;212537273;212588243;50970;0
198;ENSG00000065613;SLK;10;105726959;105788991;62032;0
199;ENSG00000065621;GSTO2;10;106028631;106064703;36072;0
200;ENSG00000065665;SEC61A2;10;12171636;12211960;40324;1
201;ENSG00000065675;PRKCQ;10;6469105;6622263;153158;0
202;ENSG00000065809;FAM107B;10;14560556;14816896;256340;0
203;ENSG00000065970;FOXJ2;12;8185299;8208099;22800;0
204;ENSG00000065978;YBX1;1;43148098;43168020;19922;0
205;ENSG00000066027;PPP2R5A;1;212458879;212535200;76321;0
206;ENSG00000066056;TIE1;1;43766664;43788779;22115;0
207;ENSG00000066084;DIP2B;12;50898768;51142450;243682;0
208;ENSG00000066117;SMARCD1;12;50478755;50494495;15740;0
209;ENSG00000066135;KDM4A;1;44115829;44171186;55357;0
210;ENSG00000066136;NFYC;1;41157320;41237275;79955;0
211;ENSG00000066185;ZMYND12;1;42896000;42921938;25938;0
212;ENSG00000066279;ASPM;1;197053258;197115824;62566;0
213;ENSG00000066322;ELOVL1;1;43829068;43833696;4628;0
214;ENSG00000066382;MPPED2;11;30406040;30608419;202379;0
215;ENSG00000066468;FGFR2;10;123237848;123357972;120124;0
216;ENSG00000066557;LRRC40;1;70610488;70671303;60815;0
217;ENSG00000067057;PFKP;10;3108525;3179904;71379;0
218;ENSG00000067064;IDI1;10;1085848;1095110;9262;1
219;ENSG00000067082;KLF6;10;3818188;3827473;9285;0
220;ENSG00000067182;TNFRSF1A;12;6437923;6451280;13357;0
221;ENSG00000067208;EVI5;1;92974253;93257961;283708;0
222;ENSG00000067334;DNTTIP2;1;94333373;94345474;12101;0
223;ENSG00000067533;RRP15;1;218458629;218511325;52696;0
224;ENSG00000067606;PRKCZ;1;1981909;2116834;134925;0
225;ENSG00000067704;IARS2;1;220267444;220321380;53936;0
226;ENSG00000067715;SYT1;12;79257773;79845788;588015;0
227;ENSG00000067798;NAV3;12;78224685;78606790;382105;0
228;ENSG00000068383;INPP5A;10;134351324;134596979;245655;0
229;ENSG00000068831;RASGRP2;11;64494383;64512928;18545;0
230;ENSG00000068971;PPP2R5B;11;64685025;64701945;16920;0
231;ENSG00000068976;PYGM;11;64513861;64527769;13908;0
232;ENSG00000069248;NUP133;1;229577045;229644103;67058;0
233;ENSG00000069275;NUCKS1;1;205681947;205719404;37457;0
234;ENSG00000069424;KCNAB2;1;6051526;6161253;109727;0
235;ENSG00000069431;ABCC9;12;21950335;22094336;144001;0
236;ENSG00000069493;CLEC2D;12;9817565;9848413;30848;0
237;ENSG00000069696;DRD4;11;637293;640706;3413;0
238;ENSG00000069702;TGFBR3;1;92145902;92371892;225990;0
239;ENSG00000069712;KIAA1107;1;92632542;92650280;17738;0
240;ENSG00000069812;HES2;1;6472478;6484730;12252;0
241;ENSG00000070018;LRP6;12;12268959;12419946;150987;0
242;ENSG00000070047;PHRF1;11;576486;612222;35736;0
243;ENSG00000070081;NUCB2;11;17229700;17371521;141821;0
244;ENSG00000070748;CHAT;10;50817141;50901925;84784;0
245;ENSG00000070759;TESK2;1;45809555;45956872;147317;0
246;ENSG00000070785;EIF2B3;1;45316450;45452282;135832;0
247;ENSG00000070831;CDC42;1;22379120;22419437;40317;0
248;ENSG00000070886;EPHA8;1;22890057;22930087;40030;0
249;ENSG00000070961;ATP2B1;12;89981828;90103077;121249;0
250;ENSG00000072041;SLC6A15;12;85253492;85307394;53902;0
251;ENSG00000072401;UBE2D1;10;60094735;60130513;35778;0
252;ENSG00000072422;RHOBTB1;10;62629196;62761198;132002;0
253;ENSG00000072444;ASAH2C;10;48001603;48055018;53415;0
254;ENSG00000072518;MARK2;11;63606400;63678491;72091;0
255;ENSG00000072609;CHFR;12;133398773;133532890;134117;0
256;ENSG00000072657;TRHDE;12;72481046;73059422;578376;0
257;ENSG00000072952;MRVI1;11;10594638;10715535;120897;0
258;ENSG00000073060;SCARB1;12;125261402;125367214;105812;0
259;ENSG00000073614;KDM5A;12;389295;498620;109325;0
260;ENSG00000073756;PTGS2;1;186640923;186649559;8636;0
261;ENSG00000073910;FRY;13;32605437;32870794;265357;0
262;ENSG00000073921;PICALM;11;85668727;85780924;112197;0
263;ENSG00000074201;CLNS1A;11;77225981;77348850;122869;0
264;ENSG00000074266;EED;11;85955586;85989855;34269;0
265;ENSG00000074319;TSG101;11;18489883;18548779;58896;0
266;ENSG00000074527;NTN4;12;96051583;96184930;133347;1
267;ENSG00000074590;NUAK1;12;106457118;106533811;76693;0
268;ENSG00000074800;ENO1;1;8921061;8939308;18247;0
269;ENSG00000074964;ARHGEF10L;1;17866330;18024369;158039;0
270;ENSG00000075035;WSCD2;12;108523248;108644314;121066;0
271;ENSG00000075089;ACTR6;12;100592900;100635643;42743;0
272;ENSG00000075151;EIF4G3;1;21132963;21503377;370414;0
273;ENSG00000075188;NUP37;12;102467967;102513902;45935;0
274;ENSG00000075239;ACAT1;11;107992243;108018503;26260;0
275;ENSG00000075391;RASAL2;1;178062864;178448644;385780;0
276;ENSG00000075407;ZNF37A;10;38383264;38414472;31208;0
277;ENSG00000075415;SLC25A3;12;98987369;98995946;8577;0
278;ENSG00000075673;ATP12A;13;25254549;25285921;31372;0
279;ENSG00000075826;SEC31B;10;102246399;102289628;43229;0
280;ENSG00000075856;SART3;12;108916357;108955176;38819;0
281;ENSG00000075891;PAX2;10;102495360;102589698;94338;1
282;ENSG00000075945;KIFAP3;1;169890467;170054349;163882;0
283;ENSG00000076043;REXO2;11;114310108;114321001;10893;0
284;ENSG00000076053;RBM7;11;114270752;114284925;14173;0
285;ENSG00000076067;RBMS2;12;56915713;56984745;69032;0
286;ENSG00000076108;BAZ2A;12;56989380;57030600;41220;0
287;ENSG00000076248;UNG;12;109535379;109548797;13418;0
288;ENSG00000076258;FMO4;1;171283347;171311223;27876;0
289;ENSG00000076321;KLHL20;1;173684080;173755840;71760;0
290;ENSG00000076356;PLXNA2;1;208195587;208417665;222078;0
291;ENSG00000076513;ANKRD13A;12;110436991;110477568;40577;0
292;ENSG00000076555;ACACB;12;109554400;109706031;151631;0
293;ENSG00000076685;NT5C2;10;104845940;104953056;107116;0
294;ENSG00000076706;MCAM;11;119179241;119192231;12990;1
295;ENSG00000076864;RAP1GAP;1;21922708;21995801;73093;0
296;ENSG00000077147;TM9SF3;10;98277866;98347209;69343;0
297;ENSG00000077150;NFKB2;10;104153867;104162281;8414;0
298;ENSG00000077152;UBE2T;1;202300785;202311108;10323;0
299;ENSG00000077157;PPP1R12B;1;202317827;202561834;244007;0
300;ENSG00000077254;USP33;1;78161672;78225537;63865;0
301;ENSG00000077327;SPAG6;10;22634399;22743153;108754;0
302;ENSG00000077458;FAM76B;11;95502106;95523573;21467;0
303;ENSG00000077514;POLD3;11;74204896;74380162;175266;0
304;ENSG00000077522;ACTN2;1;236849754;236927931;78177;0
305;ENSG00000077549;CAPZB;1;19665267;19812066;146799;0
306;ENSG00000077585;GPR137B;1;236305832;236385165;79333;0
307;ENSG00000077616;NAALAD2;11;89864683;89926062;61379;0
308;ENSG00000078114;NEBL;10;21068902;21463116;394214;0
309;ENSG00000078124;ACER3;11;76571911;76737841;165930;0
310;ENSG00000078237;C12orf5;12;4430371;4462338;31967;0
311;ENSG00000078246;TULP3;12;2986389;3050306;63917;0
312;ENSG00000078369;GNB1;1;1716729;1822495;105766;0
313;ENSG00000078403;MLLT10;10;21823094;22032559;209465;0
314;ENSG00000078618;NRD1;1;52254863;52344477;89614;0
315;ENSG00000078808;SDF4;1;1152288;1167411;15123;0
316;ENSG00000078902;TOLLIP;11;1295601;1330884;35283;0
317;ENSG00000079277;MKNK1;1;47023090;47082515;59425;0
318;ENSG00000079332;SAR1A;10;71907045;71930279;23234;0
319;ENSG00000079335;CDC14A;1;100810584;100985833;175249;0
320;ENSG00000079337;RAPGEF3;12;48128455;48164823;36368;0
321;ENSG00000079387;SENP1;12;48436681;48500091;63410;0
322;ENSG00000079739;PGM1;1;64058947;64125916;66969;0
323;ENSG00000080371;RAB21;12;72148654;72184699;36045;0
324;ENSG00000080854;IGSF9B;11;133778459;133826880;48421;0
325;ENSG00000080947;CROCCP3;1;16793931;16825752;31821;0
326;ENSG00000081019;RSBN1;1;114304454;114355098;50644;0
327;ENSG00000081026;MAGI3;1;113933371;114228545;295174;0
328;ENSG00000081248;CACNA1S;1;201008642;201081694;73052;0
329;ENSG00000081692;JMJD4;1;227918126;227923112;4986;0
330;ENSG00000081721;DUSP12;1;161719548;161727028;7480;0
331;ENSG00000081760;AACS;12;125549925;125627873;77948;0
332;ENSG00000081870;HSPB11;1;54382247;54411602;29355;0
333;ENSG00000081985;IL12RB2;1;67773047;67862583;89536;0
334;ENSG00000082482;KCNK2;1;215179118;215410436;231318;0
335;ENSG00000082497;SERTAD4;1;210406144;210419976;13832;0
336;ENSG00000082512;TRAF5;1;211499957;211548288;48331;0
337;ENSG00000082805;ERC1;12;1099675;1605099;505424;0
338;ENSG00000083444;PLOD1;1;11994262;12035595;41333;0
339;ENSG00000083635;NUFIP1;13;45513384;45563618;50234;0
340;ENSG00000083642;PDS5B;13;33160564;33352157;191593;0
341;ENSG00000084070;SMAP2;1;40810522;40888998;78476;0
342;ENSG00000084072;PPIE;1;40157854;40229586;71732;0
343;ENSG00000084073;ZMPSTE24;1;40723779;40759856;36077;0
344;ENSG00000084112;SSH1;12;109176466;109251366;74900;0
345;ENSG00000084207;GSTP1;11;67351066;67354131;3065;0
346;ENSG00000084234;APLP2;11;129939732;130014699;74967;0
347;ENSG00000084444;KIAA1467;12;13197218;13295455;98237;0
348;ENSG00000084453;SLCO1A2;12;21417534;21572528;154994;0
349;ENSG00000084463;WBP11;12;14939410;14956474;17064;0
350;ENSG00000084623;EIF3I;1;32687529;32697205;9676;0
351;ENSG00000084628;NKAIN1;1;31652592;31712401;59809;0
352;ENSG00000084636;COL16A1;1;32117848;32169920;52072;0
353;ENSG00000084652;TXLNA;1;32645287;32663886;18599;0
354;ENSG00000085063;CD59;11;33719807;33757991;38184;0
355;ENSG00000085117;CD82;11;44585977;44641913;55936;0
356;ENSG00000085433;WDR47;1;109512836;109584850;72014;0
357;ENSG00000085465;OVGP1;1;111956936;111970399;13463;0
358;ENSG00000085491;SLC25A24;1;108676658;108743471;66813;0
359;ENSG00000085552;IGSF9;1;159896829;159915386;18557;0
360;ENSG00000085733;CTTN;11;70244510;70282690;38180;0
361;ENSG00000085741;WNT11;11;75897369;75921780;24411;0
362;ENSG00000085831;TTC39A;1;51752930;51810788;57858;0
363;ENSG00000085832;EPS15;1;51819935;51985000;165065;0
364;ENSG00000085840;ORC1;1;52838501;52870131;31630;0
365;ENSG00000085998;POMGNT1;1;46654354;46685977;31623;0
366;ENSG00000085999;RAD54L;1;46713360;46744145;30785;0
367;ENSG00000086015;MAST2;1;46252659;46501796;249137;0
368;ENSG00000086205;FOLH1;11;49168187;49230222;62035;0
369;ENSG00000086475;SEPHS1;10;13359424;13390297;30873;0
370;ENSG00000086598;TMED2;12;124069078;124083116;14038;0
371;ENSG00000086619;ERO1LB;1;236378855;236445319;66464;0
372;ENSG00000086827;ZW10;11;113603909;113644533;40624;0
373;ENSG00000086848;ALG9;11;111652919;111742305;89386;0
374;ENSG00000086991;NOX4;11;89057524;89322779;265255;0
375;ENSG00000087053;MTMR2;11;95566046;95658479;92433;0
376;ENSG00000087365;SF3B2;11;65818200;65836779;18579;0
377;ENSG00000087448;KLHL42;12;27932953;27955973;23020;0
378;ENSG00000087470;DNM1L;12;32832134;32898486;66352;0
379;ENSG00000087494;PTHLH;12;28111017;28125638;14621;0
380;ENSG00000087502;ERGIC2;12;29490285;29534122;43837;0
381;ENSG00000087884;AAMDC;11;77532155;77629478;97323;1
382;ENSG00000088035;ALG6;1;63833261;63904233;70972;0
383;ENSG00000088280;ASAP3;1;23755056;23811061;56005;0
384;ENSG00000088986;DYNLL1;12;120907653;120936296;28643;0
385;ENSG00000088992;TESC;12;117476728;117537284;60556;1
386;ENSG00000089009;RPL6;12;112842994;112856642;13648;0
387;ENSG00000089022;MAPKAPK5;12;112279782;112334343;54561;0
388;ENSG00000089053;ANAPC5;12;121746048;121837699;91651;0
389;ENSG00000089060;SLC8B1;12;113736564;113797298;60734;0
390;ENSG00000089094;KDM2B;12;121866900;122018920;152020;0
391;ENSG00000089116;LHX5;12;113899839;113910085;10246;1
392;ENSG00000089154;GCN1L1;12;120565007;120632513;67506;0
393;ENSG00000089157;RPLP0;12;120634489;120639038;4549;0
394;ENSG00000089159;PXN;12;120648250;120703574;55324;0
395;ENSG00000089163;SIRT4;12;120740119;120751052;10933;0
396;ENSG00000089169;RPH3A;12;113008184;113336686;328502;0
397;ENSG00000089220;PEBP1;12;118573663;118583389;9726;0
398;ENSG00000089225;TBX5;12;114791736;114846247;54511;0
399;ENSG00000089234;BRAP;12;112079950;112123790;43840;0
400;ENSG00000089248;ERP29;12;112451120;112461255;10135;0
401;ENSG00000089250;NOS1;12;117645947;117889975;244028;0
402;ENSG00000089597;GANAB;11;62392298;62414104;21806;0
403;ENSG00000089692;LAG3;12;6881678;6887621;5943;0
404;ENSG00000089693;MLF2;12;6857170;6876641;19471;0
405;ENSG00000089818;NECAP1;12;8234807;8250367;15560;0
406;ENSG00000089876;DHX32;10;127524906;127585005;60099;0
407;ENSG00000090020;SLC9A1;1;27425306;27493472;68166;0
408;ENSG00000090273;NUDC;1;27226729;27273353;46624;0
409;ENSG00000090376;IRAK3;12;66582659;66648402;65743;0
410;ENSG00000090382;LYZ;12;69742121;69748014;5893;0
411;ENSG00000090432;MUL1;1;20825943;20834654;8711;0
412;ENSG00000090612;ZNF268;12;133707570;133783698;76128;0
413;ENSG00000090615;GOLGA3;12;133345495;133405444;59949;0
414;ENSG00000090621;PABPC4;1;40026488;40042462;15974;0
415;ENSG00000090686;USP48;1;22004791;22110099;105308;0
416;ENSG00000090975;PITPNM2;12;123468027;123634562;166535;0
417;ENSG00000091039;OSBPL8;12;76745577;76953589;208012;0
418;ENSG00000091483;FH;1;241660903;241683061;22158;0
419;ENSG00000091664;SLC17A6;11;22359643;22401049;41406;0
420;ENSG00000092607;TBX15;1;119425669;119532179;106510;0
421;ENSG00000092621;PHGDH;1;120202421;120286838;84417;1
422;ENSG00000092841;MYL6;12;56551945;56557280;5335;0
423;ENSG00000092847;AGO1;1;36335409;36395211;59802;0
424;ENSG00000092850;TEKT2;1;36549676;36553876;4200;0
425;ENSG00000092853;CLSPN;1;36185819;36235568;49749;1
426;ENSG00000092969;TGFB2;1;218519577;218617961;98384;0
427;ENSG00000092978;GPATCH2;1;217600334;217804424;204090;0
428;ENSG00000094914;AAAS;12;53701240;53718648;17408;0
429;ENSG00000094916;CBX5;12;54624724;54673886;49162;0
430;ENSG00000094975;SUCO;1;172501489;172580971;79482;0
431;ENSG00000095139;ARCN1;11;118443105;118473748;30643;0
432;ENSG00000095485;CWF19L1;10;101992055;102027437;35382;0
433;ENSG00000095539;SEMA4G;10;102729275;102745628;16353;0
434;ENSG00000095564;BTAF1;10;93683526;93790082;106556;0
435;ENSG00000095574;IKZF5;10;124750322;124768333;18011;0
436;ENSG00000095587;TLL2;10;98124363;98273675;149312;0
437;ENSG00000095596;CYP26A1;10;94833232;94837647;4415;0
438;ENSG00000095637;SORBS1;10;97071528;97321171;249643;0
439;ENSG00000095739;BAMBI;10;28966271;28971868;5597;0
440;ENSG00000095777;MYO3A;10;26223196;26501456;278260;0
441;ENSG00000095787;WAC;10;28821422;28912041;90619;0
442;ENSG00000095794;CREM;10;35415719;35501886;86167;0
443;ENSG00000096717;SIRT1;10;69644427;69678147;33720;0
444;ENSG00000096746;HNRNPH3;10;70090931;70102948;12017;0
445;ENSG00000097021;ACOT7;1;6324329;6454451;130122;0
446;ENSG00000097033;SH3GLB1;1;87170259;87213867;43608;0
447;ENSG00000097046;CDC7;1;91966408;91991321;24913;0
448;ENSG00000097096;SYDE2;1;85622556;85666729;44173;0
449;ENSG00000099194;SCD;10;102106881;102124591;17710;0
450;ENSG00000099204;ABLIM1;10;116190872;116444762;253890;0
451;ENSG00000099246;RAB18;10;27793197;27831143;37946;0
452;ENSG00000099250;NRP1;10;33466420;33625190;158770;0
453;ENSG00000099251;HSD17B7P2;10;38645305;38667433;22128;1
454;ENSG00000099256;PRTFDC1;10;25137536;25241533;103997;0
455;ENSG00000099260;PALMD;1;100111499;100160097;48598;0
456;ENSG00000099282;TSPAN15;10;71211229;71267425;56196;0
457;ENSG00000099284;H2AFY2;10;71812552;71872036;59484;0
458;ENSG00000099290;FAM21A;10;51827648;51893269;65621;0
459;ENSG00000099849;RASSF7;11;560404;564021;3617;0
460;ENSG00000102189;EEA1;12;93164413;93323107;158694;0
461;ENSG00000102445;KIAA0226L;13;46916139;47012325;96186;0
462;ENSG00000102468;HTR2A;13;47405685;47471169;65484;0
463;ENSG00000102531;FNDC3A;13;49550048;49783915;233867;0
464;ENSG00000102543;CDADC1;13;49822047;49867618;45571;0
465;ENSG00000102547;CAB39L;13;49882786;50018262;135476;0
466;ENSG00000102678;FGF9;13;22245522;22278637;33115;0
467;ENSG00000102683;SGCG;13;23755091;23899304;144213;0
468;ENSG00000102699;PARP4;13;24995064;25086948;91884;1
469;ENSG00000102710;SUPT20H;13;37583449;37633850;50401;0
470;ENSG00000102738;MRPS31;13;41303432;41345309;41877;0
471;ENSG00000102743;SLC25A15;13;41363548;41384247;20699;0
472;ENSG00000102753;KPNA3;13;50273447;50367057;93610;0
473;ENSG00000102760;RGCC;13;42031695;42045018;13323;0
474;ENSG00000102763;VWA8;13;42140973;42535256;394283;0
475;ENSG00000102780;DGKH;13;42614176;42830714;216538;0
476;ENSG00000102781;KATNAL1;13;30776767;30881621;104854;0
477;ENSG00000102786;INTS6;13;51928213;52028400;100187;0
478;ENSG00000102796;DHRS12;13;52342129;52378293;36164;0
479;ENSG00000102804;TSC22D1;13;45007655;45151283;143628;0
480;ENSG00000102837;OLFM4;13;53602894;53626192;23298;0
481;ENSG00000107404;DVL1;1;1270656;1284730;14074;0
482;ENSG00000107438;PDLIM1;10;96997329;97050781;53452;0
483;ENSG00000107443;CCNJ;10;97803151;97820627;17476;0
484;ENSG00000107518;ATRNL1;10;116853124;117708503;855379;0
485;ENSG00000107521;HPS1;10;100175955;100206684;30729;0
486;ENSG00000107537;PHYH;10;13319796;13344412;24616;0
487;ENSG00000107551;RASSF4;10;45454855;45491339;36484;0
488;ENSG00000107554;DNMBP;10;101635334;101769676;134342;0
489;ENSG00000107560;RAB11FIP2;10;119764427;119806114;41687;0
490;ENSG00000107566;ERLIN1;10;101909851;101948091;38240;0
491;ENSG00000107581;EIF3A;10;120794356;120840316;45960;0
492;ENSG00000107611;CUBN;10;16865963;17171830;305867;0
493;ENSG00000107614;TRDMT1;10;17184253;17244053;59800;0
494;ENSG00000107623;GDF10;10;48425815;48438976;13161;0
495;ENSG00000107625;DDX50;10;70661034;70706603;45569;0
496;ENSG00000107643;MAPK8;10;49514698;49647403;132705;0
497;ENSG00000107651;SEC23IP;10;121652223;121702014;49791;0
498;ENSG00000107669;ATE1;10;123499939;123688316;188377;0
499;ENSG00000107672;NSMCE4A;10;123716603;123734732;18129;0
500;ENSG00000107679;PLEKHA1;10;124134212;124191867;57655;0
501;ENSG00000107719;PALD1;10;72238577;72328205;89628;0
502;ENSG00000107731;UNC5B;10;72972327;73062621;90294;0
503;ENSG00000107736;CDH23;10;73156691;73575702;419011;0
504;ENSG00000107742;SPOCK2;10;73818793;73848790;29997;0
505;ENSG00000107745;MICU1;10;74127098;74385899;258801;0
506;ENSG00000107758;PPP3CB;10;75196186;75255782;59596;0
507;ENSG00000107771;CCSER2;10;86088342;86278273;189931;0
508;ENSG00000107779;BMPR1A;10;88516407;88692595;176188;0
509;ENSG00000107789;MINPP1;10;89264632;89313217;48585;0
510;ENSG00000107796;ACTA2;10;90694831;90751147;56316;1
511;ENSG00000107798;LIPA;10;90973326;91174314;200988;0
512;ENSG00000107815;C10orf2;10;102747124;102754158;7034;0
513;ENSG00000107816;LZTS2;10;102756375;102767593;11218;0
514;ENSG00000107819;SFXN3;10;102790991;102800998;10007;0
515;ENSG00000107821;KAZALD1;10;102821598;102827888;6290;0
516;ENSG00000107829;FBXW4;10;103370423;103455052;84629;0
517;ENSG00000107833;NPM3;10;103541082;103543170;2088;0
518;ENSG00000107854;TNKS2;10;93558069;93625033;66964;0
519;ENSG00000107862;GBF1;10;104005289;104142656;137367;0
520;ENSG00000107863;ARHGAP21;10;24872538;25012597;140059;0
521;ENSG00000107864;CPEB3;10;93806449;94050844;244395;0
522;ENSG00000107872;FBXL15;10;104178946;104182893;3947;0
523;ENSG00000107874;CUEDC2;10;104183002;104192418;9416;0
524;ENSG00000107882;SUFU;10;104263744;104393292;129548;0
525;ENSG00000107890;ANKRD26;10;27280843;27389421;108578;0
526;ENSG00000107897;ACBD5;10;27484146;27531059;46913;0
527;ENSG00000107902;LHPP;10;126150403;126306457;156054;0
528;ENSG00000107929;LARP4B;10;855484;977564;122080;0
529;ENSG00000107937;GTPBP4;10;1034338;1065876;31538;0
530;ENSG00000107938;EDRF1;10;127408084;127452712;44628;0
531;ENSG00000107949;BCCIP;10;127512115;127542264;30149;0
532;ENSG00000107951;MTPAP;10;30598730;30663377;64647;0
533;ENSG00000107954;NEURL1;10;105253736;105352309;98573;0
534;ENSG00000107957;SH3PXD2A;10;105348285;105615301;267016;0
535;ENSG00000107959;PITRM1;10;3179920;3215003;35083;0
536;ENSG00000107960;OBFC1;10;105642300;105677963;35663;1
537;ENSG00000107968;MAP3K8;10;30722866;30750762;27896;0
538;ENSG00000107984;DKK1;10;54074056;54077802;3746;0
539;ENSG00000108001;EBF3;10;131633547;131762105;128558;1
540;ENSG00000108010;GLRX3;10;131934663;131982785;48122;0
541;ENSG00000108018;SORCS1;10;108333421;108924292;590871;0
542;ENSG00000108021;FAM208B;10;5726801;5805703;78902;0
543;ENSG00000108039;XPNPEP1;10;111624524;111683311;58787;0
544;ENSG00000108055;SMC3;10;112327449;112364394;36945;0
545;ENSG00000108061;SHOC2;10;112679301;112773425;94124;0
546;ENSG00000108064;TFAM;10;60144782;60158981;14199;0
547;ENSG00000108091;CCDC6;10;61548521;61666414;117893;0
548;ENSG00000108094;CUL2;10;35297479;35379570;82091;0
549;ENSG00000108100;CCNY;10;35535953;35860852;324899;0
550;ENSG00000108175;ZMIZ1;10;80828792;81076276;247484;0
551;ENSG00000108176;DNAJC12;10;69556427;69597924;41497;0
552;ENSG00000108179;PPIF;10;81107225;81115093;7868;0
553;ENSG00000108187;PBLD;10;70042417;70092806;50389;0
554;ENSG00000108219;TSPAN14;10;82213922;82292879;78957;0
555;ENSG00000108231;LGI1;10;95517566;95557916;40350;0
556;ENSG00000108239;TBC1D12;10;96162261;96295687;133426;0
557;ENSG00000109832;DDX25;11;125773271;125793158;19887;0
558;ENSG00000109846;CRYAB;11;111779289;111794446;15157;0
559;ENSG00000109861;CTSC;11;88026760;88070955;44195;0
560;ENSG00000109881;CCDC34;11;27352374;27385415;33041;0
561;ENSG00000109906;ZBTB16;11;113930315;114121398;191083;0
562;ENSG00000109911;ELP4;11;31531297;31805546;274249;0
563;ENSG00000109917;ZNF259;11;116648436;116658766;10330;0
564;ENSG00000109919;MTCH2;11;47638867;47664175;25308;0
565;ENSG00000109920;FNBP4;11;47738072;47788995;50923;0
566;ENSG00000109927;TECTA;11;120971882;121062202;90320;0
567;ENSG00000109929;SC5D;11;121163162;121179403;16241;0
568;ENSG00000109944;C11orf63;11;122753391;122830506;77115;0
569;ENSG00000109956;B3GAT1;11;134248398;134281812;33414;0
570;ENSG00000109971;HSPA8;11;122928197;122933938;5741;0
571;ENSG00000109991;P2RX3;11;57105848;57138073;32225;1
572;ENSG00000110002;VWA5A;11;123986069;124018428;32359;1
573;ENSG00000110011;DNAJC4;11;63997750;64001758;4008;0
574;ENSG00000110013;SIAE;11;124503009;124565603;62594;0
575;ENSG00000110025;SNX15;11;64794880;64808044;13164;0
576;ENSG00000110031;LPXN;11;58294344;58345693;51349;0
577;ENSG00000110042;DTX4;11;58938903;58976060;37157;0
578;ENSG00000110046;ATG2A;11;64662007;64684722;22715;0
579;ENSG00000110047;EHD1;11;64619114;64655768;36654;0
580;ENSG00000110048;OSBP;11;59341871;59383617;41746;0
581;ENSG00000110057;UNC93B1;11;67758575;67772452;13877;0
582;ENSG00000110060;PUS3;11;125763381;125773116;9735;0
583;ENSG00000110063;DCPS;11;126173647;126215644;41997;0
584;ENSG00000110066;SUV420H1;11;67922330;67981295;58965;0
585;ENSG00000110074;FOXRED1;11;126138950;126148026;9076;0
586;ENSG00000110075;PPP6R3;11;68228186;68382802;154616;0
587;ENSG00000110076;NRXN2;11;64373646;64490660;117014;0
588;ENSG00000110080;ST3GAL4;11;126225535;126310239;84704;0
589;ENSG00000110090;CPT1A;11;68522088;68611878;89790;0
590;ENSG00000110092;CCND1;11;69455855;69469242;13387;0
591;ENSG00000110104;CCDC86;11;60609544;60618554;9010;0
592;ENSG00000110107;PRPF19;11;60658202;60674060;15858;0
593;ENSG00000110108;TMEM109;11;60681346;60690915;9569;0
594;ENSG00000110148;CCKBR;11;6280966;6293357;12391;0
595;ENSG00000110169;HPX;11;6452279;6463847;11568;1
596;ENSG00000110171;TRIM3;11;6469843;6495689;25846;0
597;ENSG00000110172;CHORDC1;11;89934328;89956532;22204;0
598;ENSG00000110200;ANAPC15;11;71817424;71823826;6402;0
599;ENSG00000110218;PANX1;11;93862094;93915138;53044;0
600;ENSG00000110237;ARHGEF17;11;73019334;73080136;60802;0
601;ENSG00000110274;CEP164;11;117185273;117283984;98711;0
602;ENSG00000110315;RNF141;11;10533225;10562777;29552;0
603;ENSG00000110318;KIAA1377;11;101785746;101871789;86043;0
604;ENSG00000110321;EIF4G2;11;10818597;10830657;12060;0
605;ENSG00000110324;IL10RA;11;117857063;117872196;15133;0
606;ENSG00000110328;GALNT18;11;11292423;11643552;351129;0
607;ENSG00000110330;BIRC2;11;102217942;102249401;31459;0
608;ENSG00000110344;UBE4A;11;118230300;118269926;39626;0
609;ENSG00000110367;DDX6;11;118620034;118661858;41824;0
610;ENSG00000110375;UPK2;11;118795873;118829269;33396;0
611;ENSG00000110395;CBL;11;119076752;119178859;102107;0
612;ENSG00000110400;PVRL1;11;119494120;119599794;105674;0
613;ENSG00000110422;HIPK3;11;33278218;33378569;100351;0
614;ENSG00000110427;KIAA1549L;11;33563618;33695648;132030;0
615;ENSG00000110429;FBXO3;11;33762485;33796089;33604;0
616;ENSG00000110435;PDHX;11;34937376;35042138;104762;0
617;ENSG00000110436;SLC1A2;11;35272753;35441610;168857;0
618;ENSG00000110442;COMMD9;11;36295051;36310999;15948;0
619;ENSG00000110446;SLC15A3;11;60704556;60720002;15446;0
620;ENSG00000110492;MDK;11;46402306;46405375;3069;0
621;ENSG00000110497;AMBRA1;11;46417964;46615675;197711;0
622;ENSG00000110514;MADD;11;47290712;47351582;60870;0
623;ENSG00000110536;PTPMT1;11;47586982;47595013;8031;0
624;ENSG00000110583;NAA40;11;63706431;63724800;18369;0
625;ENSG00000110619;CARS;11;3022152;3078843;56691;0
626;ENSG00000110628;SLC22A18;11;2920951;2946476;25525;0
627;ENSG00000110651;CD81;11;2397407;2418649;21242;0
628;ENSG00000110660;SLC35F2;11;107661717;107799019;137302;0
629;ENSG00000110675;ELMOD1;11;107461817;107537505;75688;1
630;ENSG00000110693;SOX6;11;15987995;16761138;773143;0
631;ENSG00000110696;C11orf58;11;16634679;16778428;143749;0
632;ENSG00000110697;PITPNM1;11;67259239;67273734;14495;0
633;ENSG00000110700;RPS13;11;17095936;17099334;3398;0
634;ENSG00000110711;AIP;11;67250512;67258574;8062;0
635;ENSG00000110713;NUP98;11;3692313;3819022;126709;0
636;ENSG00000110717;NDUFS8;11;67798084;67804111;6027;0
637;ENSG00000110719;TCIRG1;11;67806483;67818362;11879;0
638;ENSG00000110721;CHKA;11;67820326;67888911;68585;0
639;ENSG00000110723;EXPH5;11;108376158;108464465;88307;0
640;ENSG00000110756;HPS5;11;18300223;18343745;43522;0
641;ENSG00000110768;GTF2H1;11;18343842;18388591;44749;0
642;ENSG00000110786;PTPN5;11;18749475;18814268;64793;0
643;ENSG00000110801;PSMD9;12;122326637;122356203;29566;0
644;ENSG00000110811;LEPREL2;12;6937572;6949018;11446;0
645;ENSG00000110841;PPFIBP1;12;27676364;27848497;172133;0
646;ENSG00000110844;PRPF40B;12;49962001;50038449;76448;0
647;ENSG00000110851;PRDM4;12;108126643;108155049;28406;0
648;ENSG00000110871;COQ5;12;120941077;120972237;31160;0
649;ENSG00000110876;SELPLG;12;109015686;109027735;12049;1
650;ENSG00000110880;CORO1C;12;109038885;109125372;86487;0
651;ENSG00000110881;ASIC1;12;50451331;50477394;26063;0
652;ENSG00000110888;CAPRIN2;12;30862486;30907885;45399;0
653;ENSG00000110900;TSPAN11;12;31079362;31149534;70172;0
654;ENSG00000110906;KCTD10;12;109886461;109915349;28888;0
655;ENSG00000110911;SLC11A2;12;51373184;51422349;49165;0
656;ENSG00000110917;MLEC;12;121124672;121139667;14995;0
657;ENSG00000110921;MVK;12;110011060;110035067;24007;0
658;ENSG00000110925;CSRNP2;12;51454990;51477447;22457;0
659;ENSG00000110931;CAMKK2;12;121675497;121736111;60614;0
660;ENSG00000110955;ATP5B;12;57031959;57039798;7839;0
661;ENSG00000110958;PTGES3;12;57057127;57082159;25032;0
662;ENSG00000110975;SYT10;12;33527173;33592754;65581;0
663;ENSG00000110987;BCL7A;12;122457328;122499948;42620;0
664;ENSG00000111011;RSRC2;12;122989190;123011547;22357;0
665;ENSG00000111012;CYP27B1;12;58156117;58162769;6652;0
666;ENSG00000111052;LIN7A;12;81186299;81331704;145405;0
667;ENSG00000111058;ACSS3;12;81331594;81650533;318939;1
668;ENSG00000111077;TENC1;12;53440753;53458156;17403;0
669;ENSG00000111110;PPM1H;12;63037762;63328817;291055;1
670;ENSG00000111142;METAP2;12;95867296;95909615;42319;0
671;ENSG00000111144;LTA4H;12;96394606;96437298;42692;0
672;ENSG00000111145;ELK3;12;96588160;96663613;75453;0
673;ENSG00000111181;SLC6A12;12;299243;323736;24493;0
674;ENSG00000111186;WNT5B;12;1639057;1756409;117352;0
675;ENSG00000111196;MAGOHB;12;10758612;10766222;7610;0
676;ENSG00000111203;ITFG2;12;2921788;2968957;47169;0
677;ENSG00000111206;FOXM1;12;2966847;2986206;19359;1
678;ENSG00000111215;PRR4;12;10977559;11324212;346653;0
679;ENSG00000111218;PRMT8;12;3490515;3703139;212624;1
680;ENSG00000111224;PARP11;12;3900213;3982608;82395;0
681;ENSG00000111229;ARPC3;12;110872630;110888227;15597;0
682;ENSG00000111231;GPN3;12;110890289;110907073;16784;0
683;ENSG00000111237;VPS29;12;110928902;110939922;11020;0
684;ENSG00000111247;RAD51AP1;12;4647950;4669214;21264;0
685;ENSG00000111249;CUX2;12;111471828;111788358;316530;0
686;ENSG00000111252;SH2B3;12;111843752;111889427;45675;0
687;ENSG00000111254;AKAP3;12;4724674;4758213;33539;1
688;ENSG00000111261;MANSC1;12;12482198;12503475;21277;0
689;ENSG00000111262;KCNA1;12;5019071;5040527;21456;0
690;ENSG00000111266;DUSP16;12;12628829;12715317;86488;1
691;ENSG00000111269;CREBL2;12;12764761;12798042;33281;0
692;ENSG00000111271;ACAD10;12;112123857;112194903;71046;0
693;ENSG00000111275;ALDH2;12;112204691;112247782;43091;0
694;ENSG00000111276;CDKN1B;12;12867992;12875305;7313;0
695;ENSG00000111300;NAA25;12;112464500;112546826;82326;0
696;ENSG00000111305;GSG1;12;13236494;13256619;20125;0
697;ENSG00000111325;OGFOD2;12;123459127;123464590;5463;0
698;ENSG00000111328;CDK2AP1;12;123745528;123756881;11353;0
699;ENSG00000111358;GTF2H3;12;124118375;124147153;28778;0
700;ENSG00000111361;EIF2B1;12;124104953;124118313;13360;0
701;ENSG00000111364;DDX55;12;124086624;124105488;18864;0
702;ENSG00000111371;SLC38A1;12;46576846;46663800;86954;0
703;ENSG00000111412;C12orf49;12;117153593;117175875;22282;0
704;ENSG00000111424;VDR;12;48235320;48336831;101511;0
705;ENSG00000111445;RFC5;12;118451393;118470935;19542;0
706;ENSG00000111450;STX2;12;131274145;131323811;49666;0
707;ENSG00000111481;COPZ1;12;54694986;54745633;50647;0
708;ENSG00000111490;TBC1D30;12;65174589;65274812;100223;0
709;ENSG00000111530;CAND1;12;67663061;67713731;50670;0
710;ENSG00000111540;RAB5B;12;56367697;56388490;20793;0
711;ENSG00000111554;MDM1;12;68666223;68726161;59938;0
712;ENSG00000111581;NUP107;12;69080514;69136785;56271;0
713;ENSG00000111596;CNOT2;12;70636774;70748773;111999;0
714;ENSG00000111602;TIMELESS;12;56810903;56843187;32284;0
715;ENSG00000111605;CPSF6;12;69633317;69668138;34821;0
716;ENSG00000111615;KRR1;12;75890684;75905416;14732;0
717;ENSG00000111639;MRPL51;12;6601150;6603007;1857;0
718;ENSG00000111640;GAPDH;12;6643093;6647537;4444;0
719;ENSG00000111641;NOP2;12;6666029;6677857;11828;0
720;ENSG00000111642;CHD4;12;6679249;6716642;37393;0
721;ENSG00000111644;ACRBP;12;6747241;6756626;9385;0
722;ENSG00000111647;UHRF1BP1L;12;100422233;100536626;114393;0
723;ENSG00000111652;COPS7A;12;6832907;6841041;8134;0
724;ENSG00000111653;ING4;12;6759446;6772314;12868;0
725;ENSG00000111664;GNB3;12;6949118;6956557;7439;0
726;ENSG00000111665;CDCA3;12;6953957;6961230;7273;0
727;ENSG00000111666;CHPT1;12;102090725;102137918;47193;0
728;ENSG00000111667;USP5;12;6961292;6975796;14504;0
729;ENSG00000111669;TPI1;12;6976283;6980112;3829;0
730;ENSG00000111670;GNPTAB;12;102139275;102224716;85441;0
731;ENSG00000111671;SPSB2;12;6980099;6998522;18423;0
732;ENSG00000111674;ENO2;12;7022909;7032861;9952;0
733;ENSG00000111676;ATN1;12;7033626;7051484;17858;0
734;ENSG00000111678;C12orf57;12;7052141;7055166;3025;0
735;ENSG00000111679;PTPN6;12;7055631;7070479;14848;0
736;ENSG00000111684;LPCAT3;12;7085348;7125814;40466;0
737;ENSG00000111696;NT5DC3;12;104164231;104234975;70744;1
738;ENSG00000111707;SUDS3;12;118814185;118855840;41655;0
739;ENSG00000111711;GOLT1B;12;21654715;21671342;16627;0
740;ENSG00000111713;GYS2;12;21689123;21757781;68658;1
741;ENSG00000111716;LDHB;12;21788276;21910791;122515;0
742;ENSG00000111725;PRKAB1;12;120105558;120119435;13877;0
743;ENSG00000111726;CMAS;12;22199108;22218608;19500;0
744;ENSG00000111727;HCFC2;12;104458235;104498639;40404;0
745;ENSG00000111728;ST8SIA1;12;22216707;22589975;373268;0
746;ENSG00000111729;CLEC4A;12;8276228;8291203;14975;0
747;ENSG00000111731;C2CD5;12;22601517;22697480;95963;0
748;ENSG00000111737;RAB35;12;120532899;120555306;22407;0
749;ENSG00000111752;PHC1;12;9066492;9094063;27571;0
750;ENSG00000111775;COX6A1;12;120875893;120878545;2652;0
751;ENSG00000111783;RFX4;12;106976685;107156581;179896;0
752;ENSG00000111785;RIC8B;12;107168373;107283090;114717;0
753;ENSG00000111786;SRSF9;12;120899471;120907596;8125;0
754;ENSG00000111788;;12;9429831;9466684;36853;0
755;ENSG00000111790;FGFR1OP2;12;27091316;27119583;28267;0
756;ENSG00000112787;FBRSL1;12;133066137;133161774;95637;0
757;ENSG00000116128;BCL9;1;147013182;147098017;84835;0
758;ENSG00000116132;PRRX1;1;170631869;170708560;76691;0
759;ENSG00000116133;DHCR24;1;55315306;55352891;37585;0
760;ENSG00000116138;DNAJC16;1;15853308;15918874;65566;0
761;ENSG00000116141;MARK1;1;220701568;220837803;136235;0
762;ENSG00000116147;TNR;1;175284330;175712906;428576;1
763;ENSG00000116151;MORN1;1;2252692;2323146;70454;0
764;ENSG00000116157;GPX7;1;53068044;53074723;6679;0
765;ENSG00000116161;CACYBP;1;174968300;174980851;12551;0
766;ENSG00000116171;SCP2;1;53392901;53517375;124474;0
767;ENSG00000116183;PAPPA2;1;176432307;176814735;382428;1
768;ENSG00000116191;RALGPS2;1;178694300;178889238;194938;0
769;ENSG00000116194;ANGPTL1;1;178818840;178840187;21347;0
770;ENSG00000116198;CEP104;1;3728645;3773778;45133;0
771;ENSG00000116199;FAM20B;1;178994939;179045697;50758;0
772;ENSG00000116205;TCEANC2;1;54519260;54578192;58932;0
773;ENSG00000116209;TMEM59;1;54497347;54519177;21830;0
774;ENSG00000116212;LRRC42;1;54411750;54433841;22091;0
775;ENSG00000116213;WRAP73;1;3547331;3569325;21994;0
776;ENSG00000116221;MRPL37;1;54649714;54691137;41423;0
777;ENSG00000116237;ICMT;1;6281253;6296032;14779;0
778;ENSG00000116251;RPL22;1;6241329;6269449;28120;0
779;ENSG00000116254;CHD5;1;6161853;6240183;78330;0
780;ENSG00000116260;QSOX1;1;180123969;180173165;49196;0
781;ENSG00000116266;STXBP3;1;109289296;109352148;62852;0
782;ENSG00000116273;PHF13;1;6673745;6684093;10348;0
783;ENSG00000116285;ERRFI1;1;8064464;8086368;21904;0
784;ENSG00000116288;PARK7;1;8014351;8045565;31214;0
785;ENSG00000116299;KIAA1324;1;109656301;109749401;93100;0
786;ENSG00000116337;AMPD2;1;110158726;110174673;15947;0
787;ENSG00000116350;SRSF4;1;29474255;29508499;34244;0
788;ENSG00000116353;MECR;1;29519385;29557454;38069;0
789;ENSG00000116396;KCNC4;1;110753965;110825722;71757;0
790;ENSG00000116406;EDEM3;1;184659365;184724047;64682;0
791;ENSG00000116455;WDR77;1;111982512;111991998;9486;0
792;ENSG00000116459;ATP5F1;1;111991486;112005395;13909;0
793;ENSG00000116473;RAP1A;1;112084840;112259313;174473;0
794;ENSG00000116478;HDAC1;1;32757687;32799236;41549;0
795;ENSG00000116489;CAPZA1;1;113161795;113214241;52446;0
796;ENSG00000116497;S100PBP;1;33282368;33324476;42108;0
797;ENSG00000116514;RNF19B;1;33402046;33430286;28240;0
798;ENSG00000116521;SCAMP3;1;155225770;155232221;6451;0
799;ENSG00000116525;TRIM62;1;33611003;33647660;36657;0
800;ENSG00000116539;ASH1L;1;155305059;155532598;227539;0
801;ENSG00000116544;DLGAP3;1;35331037;35395186;64149;0
802;ENSG00000116560;SFPQ;1;35641979;35658749;16770;0
803;ENSG00000116574;RHOU;1;228870824;228882416;11592;0
804;ENSG00000116580;GON4L;1;155719508;155829191;109683;0
805;ENSG00000116584;ARHGEF2;1;155916630;155976861;60231;0
806;ENSG00000116586;LAMTOR2;1;156024543;156028301;3758;0
807;ENSG00000116604;MEF2D;1;156433519;156470620;37101;0
808;ENSG00000116641;DOCK7;1;62920399;63153969;233570;0
809;ENSG00000116649;SRM;1;11114641;11120081;5440;0
810;ENSG00000116652;DLEU2L;1;64014588;64015405;817;0
811;ENSG00000116661;FBXO2;1;11708424;11715842;7418;0
812;ENSG00000116663;FBXO6;1;11724181;11734411;10230;0
813;ENSG00000116667;C1orf21;1;184356192;184598154;241962;0
814;ENSG00000116668;SWT1;1;185126212;185260897;134685;0
815;ENSG00000116670;MAD2L2;1;11734537;11751707;17170;0
816;ENSG00000116675;DNAJC6;1;65713902;65881552;167650;0
817;ENSG00000116678;LEPR;1;65886248;66107242;220994;0
818;ENSG00000116679;IVNS1ABP;1;185265520;185286461;20941;0
819;ENSG00000116685;KIAA2013;1;11979648;11986485;6837;0
820;ENSG00000116688;MFN2;1;12040238;12073571;33333;0
821;ENSG00000116691;MIIP;1;12079523;12092102;12579;0
822;ENSG00000116698;SMG7;1;183441351;183567381;126030;0
823;ENSG00000116704;SLC35D1;1;67465015;67519782;54767;0
824;ENSG00000116711;PLA2G4A;1;186798085;186958113;160028;0
825;ENSG00000116717;GADD45A;1;68150744;68154021;3277;0
826;ENSG00000116729;WLS;1;68564142;68698803;134661;0
827;ENSG00000116731;PRDM2;1;14026693;14151574;124881;0
828;ENSG00000116741;RGS2;1;192778169;192781403;3234;0
829;ENSG00000116745;RPE65;1;68894505;68915642;21137;0
830;ENSG00000116747;TROVE2;1;193028552;193060907;32355;0
831;ENSG00000116750;UCHL5;1;192981380;193029237;47857;0
832;ENSG00000116752;BCAS2;1;115110178;115124260;14082;0
833;ENSG00000116754;SRSF11;1;70671365;70718735;47370;0
834;ENSG00000116761;CTH;1;70876901;70905534;28633;0
835;ENSG00000116771;AGMAT;1;15898848;15911605;12757;0
836;ENSG00000116774;OLFML3;1;114522063;114524876;2813;0
837;ENSG00000116783;TNNI3K;1;74663947;75010112;346165;0
838;ENSG00000116786;PLEKHM2;1;16010827;16061264;50437;0
839;ENSG00000116791;CRYZ;1;75171170;75199092;27922;0
840;ENSG00000116793;PHTF1;1;114239453;114302111;62658;0
841;ENSG00000116809;ZBTB17;1;16268364;16302627;34263;0
842;ENSG00000116815;CD58;1;117057157;117113661;56504;0
843;ENSG00000116819;TFAP2E;1;36038971;36060929;21958;0
844;ENSG00000116830;TTF2;1;117602925;117650075;47150;0
845;ENSG00000116852;KIF21B;1;200938520;200992828;54308;0
846;ENSG00000116857;TMEM9;1;201103900;201140702;36802;0
847;ENSG00000116863;ADPRHL2;1;36554476;36559533;5057;0
848;ENSG00000116871;MAP7D1;1;36621180;36646450;25270;0
849;ENSG00000116874;WARS2;1;119573839;119683294;109455;0
850;ENSG00000116883;;1;36789335;36794822;5487;0
851;ENSG00000116885;OSCP1;1;36881428;36916086;34658;0
852;ENSG00000116898;MRPS15;1;36921319;36930038;8719;0
853;ENSG00000116903;EXOC8;1;231468480;231473598;5118;0
854;ENSG00000116906;GNPAT;1;231376953;231413719;36766;0
855;ENSG00000116918;TSNAX;1;231664399;231702270;37871;0
856;ENSG00000116922;C1orf109;1;38147242;38157914;10672;0
857;ENSG00000116954;RRAGC;1;39303870;39325495;21625;0
858;ENSG00000116957;TBCE;1;235530675;235612283;81608;0
859;ENSG00000116962;NID1;1;236139130;236228462;89332;1
860;ENSG00000116977;LGALS8;1;236681300;236716281;34981;0
861;ENSG00000116981;NT5C1A;1;40124793;40137710;12917;0
862;ENSG00000116983;HPCAL4;1;40144320;40157361;13041;0
863;ENSG00000116984;MTR;1;236958610;237067281;108671;0
864;ENSG00000116985;BMP8B;1;40222854;40254533;31679;0
865;ENSG00000116990;MYCL;1;40361098;40367928;6830;0
866;ENSG00000116991;SIPA1L2;1;232533711;232697304;163593;0
867;ENSG00000117000;RLF;1;40627045;40706593;79548;0
868;ENSG00000117010;ZNF684;1;40997233;41013841;16608;0
869;ENSG00000117013;KCNQ4;1;41249684;41306124;56440;0
870;ENSG00000117016;RIMS3;1;41086351;41131329;44978;0
871;ENSG00000117020;AKT3;1;243651535;244014381;362846;0
872;ENSG00000117036;ETV3;1;157090983;157108266;17283;0
873;ENSG00000117054;ACADM;1;76190036;76253260;63224;0
874;ENSG00000117069;ST6GALNAC5;1;77333126;77531396;198270;0
875;ENSG00000117114;LPHN2;1;81771845;82458120;686275;0
876;ENSG00000117115;PADI2;1;17393256;17445948;52692;1
877;ENSG00000117118;SDHB;1;17345217;17380665;35448;0
878;ENSG00000117122;MFAP2;1;17300997;17307330;6333;0
879;ENSG00000117133;RPF1;1;84944942;84963473;18531;0
880;ENSG00000117139;KDM5B;1;202696526;202778598;82072;0
881;ENSG00000117143;UAP1;1;162531323;162569627;38304;0
882;ENSG00000117151;CTBS;1;85015289;85040163;24874;0
883;ENSG00000117152;RGS4;1;163038565;163046592;8027;0
884;ENSG00000117153;KLHL12;1;202860228;202897764;37536;0
885;ENSG00000117155;SSX2IP;1;85109390;85156486;47096;0
886;ENSG00000117174;ZNHIT6;1;86115106;86174116;59010;0
887;ENSG00000117222;RBBP5;1;205055270;205091143;35873;0
888;ENSG00000117242;PINK1-AS;1;20969150;20978686;9536;0
889;ENSG00000117245;KIF17;1;20990507;21044510;54003;0
890;ENSG00000117262;GPR89A;1;145764411;145827103;62692;0
891;ENSG00000117266;CDK18;1;205473723;205501921;28198;0
892;ENSG00000117280;RAB7L1;1;205737114;205744588;7474;0
893;ENSG00000117289;TXNIP;1;145438469;145442635;4166;0
894;ENSG00000117298;ECE1;1;21543740;21671997;128257;0
895;ENSG00000117305;HMGCL;1;24128375;24165110;36735;0
896;ENSG00000117308;GALE;1;24122089;24127271;5182;0
897;ENSG00000117318;ID3;1;23884409;23886285;1876;0
898;ENSG00000117335;CD46;1;207925402;207968858;43456;0
899;ENSG00000117360;PRPF3;1;150293925;150325671;31746;0
900;ENSG00000117362;APH1A;1;150237804;150241980;4176;0
901;ENSG00000117385;LEPRE1;1;43212006;43232755;20749;0
902;ENSG00000117394;SLC2A1;1;43391052;43424530;33478;0
903;ENSG00000117395;EBNA1BP2;1;43629846;43736607;106761;0
904;ENSG00000117399;CDC20;1;43824626;43828874;4248;0
905;ENSG00000117407;ARTN;1;44398992;44402913;3921;1
906;ENSG00000117408;IPO13;1;44412611;44433694;21083;0
907;ENSG00000117410;ATP6V0B;1;44440159;44443967;3808;0
908;ENSG00000117411;B4GALT2;1;44444615;44456840;12225;0
909;ENSG00000117419;ERI3;1;44686742;44820932;134190;0
910;ENSG00000117425;PTCH2;1;45285516;45308735;23219;0
911;ENSG00000117448;AKR1A1;1;46016215;46035721;19506;0
912;ENSG00000117450;PRDX1;1;45976708;45988719;12011;0
913;ENSG00000117461;PIK3R3;1;46505812;46642160;136348;0
914;ENSG00000117472;TSPAN1;1;46640745;46651630;10885;1
915;ENSG00000117475;BLZF1;1;169337208;169365778;28570;0
916;ENSG00000117477;CCDC181;1;169364108;169429907;65799;0
917;ENSG00000117479;SLC19A2;1;169433147;169455241;22094;0
918;ENSG00000117480;FAAH;1;46859937;46879520;19583;0
919;ENSG00000117481;NSUN4;1;46805849;46830824;24975;0
920;ENSG00000117500;TMED5;1;93615299;93646285;30986;0
921;ENSG00000117505;DR1;1;93811445;93835055;23610;0
922;ENSG00000117519;CNN3;1;95362507;95392834;30327;0
923;ENSG00000117523;PRRC2C;1;171454651;171562650;107999;0
924;ENSG00000117525;F3;1;94994781;95007356;12575;1
925;ENSG00000117528;ABCD3;1;94883933;94984222;100289;0
926;ENSG00000117533;VAMP4;1;171669300;171711387;42087;0
927;ENSG00000117543;DPH5;1;101455179;101491644;36465;0
928;ENSG00000117569;PTBP2;1;97187221;97289294;102073;0
929;ENSG00000117586;TNFSF4;1;173152873;173176452;23579;0
930;ENSG00000117592;PRDX6;1;173446405;173457946;11541;0
931;ENSG00000117593;DARS2;1;173793641;173827684;34043;0
932;ENSG00000117597;DIEXF;1;210001352;210030910;29558;0
933;ENSG00000117598;;1;99355806;99470588;114782;0
934;ENSG00000117600;;1;99729509;99775146;45637;0
935;ENSG00000117601;SERPINC1;1;173872947;173886516;13569;0
936;ENSG00000117602;RCAN3;1;24829387;24867530;38143;0
937;ENSG00000117614;SYF2;1;25549170;25558993;9823;0
938;ENSG00000117616;C1orf63;1;25568728;25664704;95976;0
939;ENSG00000117620;SLC35A3;1;100435345;100492535;57190;0
940;ENSG00000117625;RCOR3;1;211431719;211489727;58008;0
941;ENSG00000117632;STMN1;1;26210672;26233482;22810;0
942;ENSG00000117640;MTFR1L;1;26145131;26159432;14301;0
943;ENSG00000117643;MAN1C1;1;25943959;26112698;168739;0
944;ENSG00000117650;NEK2;1;211836114;211848960;12846;0
945;ENSG00000117676;RPS6KA1;1;26856252;26901521;45269;0
946;ENSG00000117682;DHDDS;1;26758773;26797785;39012;0
947;ENSG00000117691;NENF;1;212606229;212619714;13485;0
948;ENSG00000117697;NSL1;1;212899495;212965124;65629;0
949;ENSG00000117707;PROX1;1;214156524;214214595;58071;0
950;ENSG00000117713;ARID1A;1;27022524;27108595;86071;0
951;ENSG00000117724;CENPF;1;214776538;214837931;61393;1
952;ENSG00000117748;RPA2;1;28218035;28241257;23222;0
953;ENSG00000117751;PPP1R8;1;28157289;28178187;20898;0
954;ENSG00000117758;STX12;1;28099694;28150963;51269;0
955;ENSG00000117791;02-Mar;1;220921567;220958150;36583;0
956;ENSG00000117859;OSBPL9;1;52042851;52254889;212038;0
957;ENSG00000117862;TXNDC12;1;52485803;52521843;36040;0
958;ENSG00000117984;CTSD;11;1773982;1785222;11240;0
959;ENSG00000118058;KMT2A;11;118307205;118397539;90334;0
960;ENSG00000118096;IFT46;11;118415243;118443685;28442;0
961;ENSG00000118181;RPS25;11;118886422;118889401;2979;0
962;ENSG00000118193;KIF14;1;200520628;200589862;69234;0
963;ENSG00000118197;DDX59;1;200593024;200639097;46073;0
964;ENSG00000118200;CAMSAP2;1;200708686;200829832;121146;0
965;ENSG00000118217;ATF6;1;161736084;161933860;197776;0
966;ENSG00000118292;C1orf54;1;150240600;150253327;12727;0
967;ENSG00000118298;CA14;1;150229554;150237478;7924;0
968;ENSG00000118307;CASC1;12;25261354;25348096;86742;0
969;ENSG00000118363;SPCS2;11;74660292;74690076;29784;0
970;ENSG00000118369;USP35;11;77899858;77925757;25899;0
971;ENSG00000118454;ANKRD13C;1;70726271;70820417;94146;0
972;ENSG00000118473;SGIP1;1;66999066;67213982;214916;0
973;ENSG00000118596;SLC16A7;12;59989848;60176395;186547;0
974;ENSG00000118600;TMEM5;12;64173583;64203338;29755;0
975;ENSG00000118655;DCLRE1B;1;114447763;114456708;8945;0
976;ENSG00000118733;OLFM3;1;102268130;102462586;194456;0
977;ENSG00000118873;RAB3GAP2;1;220321635;220445796;124161;0
978;ENSG00000118971;CCND2;12;4382938;4414516;31578;0
979;ENSG00000119242;CCDC92;12;124403207;124457378;54171;0
980;ENSG00000119280;C1orf198;1;230972865;231005335;32470;0
981;ENSG00000119283;TRIM67;1;231297858;231357302;59444;0
982;ENSG00000119285;HEATR1;1;236712305;236767804;55499;0
983;ENSG00000119906;FAM178A;10;102672326;102724893;52567;0
984;ENSG00000119912;IDE;10;94211441;94333833;122392;0
985;ENSG00000119917;IFIT3;10;91087651;91100728;13077;0
986;ENSG00000119922;IFIT2;10;91061712;91069033;7321;0
987;ENSG00000119927;GPAM;10;113909624;113975135;65511;0
988;ENSG00000119929;CUTC;10;101462315;101515891;53576;0
989;ENSG00000119938;PPP1R3C;10;93388199;93392811;4612;0
990;ENSG00000119943;PYROXD2;10;100143322;100174941;31619;0
991;ENSG00000119946;CNNM1;10;101088856;101154087;65231;0
992;ENSG00000119950;MXI1;10;111967363;112047123;79760;0
993;ENSG00000119953;SMNDC1;10;112050488;112064709;14221;0
994;ENSG00000119965;C10orf88;10;124690419;124713919;23500;0
995;ENSG00000119969;HELLS;10;96305547;96373662;68115;0
996;ENSG00000119977;TCTN3;10;97423158;97453900;30742;0
997;ENSG00000119979;FAM45A;10;120863598;120897496;33898;0
998;ENSG00000119986;AVPI1;10;99437181;99447080;9899;0
999;ENSG00000120008;WDR11;10;122610687;122669036;58349;0
1000;ENSG00000120029;C10orf76;10;103605356;103815950;210594;0
1001;ENSG00000120049;KCNIP2;10;103585731;103603677;17946;0
1002;ENSG00000120053;GOT1;10;101156627;101190381;33754;0
1003;ENSG00000120057;SFRP5;10;99526508;99531709;5201;0
1004;ENSG00000120332;TNN;1;175036994;175117202;80208;0
1005;ENSG00000120333;MRPS14;1;174979925;174992561;12636;0
1006;ENSG00000120334;CENPL;1;173768688;173793858;25170;0
1007;ENSG00000120370;GORAB;1;170501270;170522587;21317;0
1008;ENSG00000120451;SNX19;11;130745331;130786404;41073;0
1009;ENSG00000120457;KCNJ5;11;128761251;128790930;29679;1
1010;ENSG00000120458;MSANTD2;11;124636394;124670569;34175;0
1011;ENSG00000120471;TP53AIP1;11;128804626;128813040;8414;0
1012;ENSG00000120539;MASTL;10;27443753;27475853;32100;0
1013;ENSG00000120549;KIAA1217;10;23983675;24836772;853097;0
1014;ENSG00000120555;SEPT7P9;10;38671997;38691844;19847;0
1015;ENSG00000120594;PLXDC2;10;20105168;20578785;473617;0
1016;ENSG00000120616;EPC1;10;32556679;32667726;111047;0
1017;ENSG00000120645;IQSEC3;12;175931;287626;111695;0
1018;ENSG00000120647;CCDC77;12;498439;551811;53372;0
1019;ENSG00000120656;TAF12;1;28915835;28969597;53762;0
1020;ENSG00000120658;ENOX1;13;43787654;44361044;573390;0
1021;ENSG00000120662;MTRF1;13;41790505;41837742;47237;0
1022;ENSG00000120664;SPG20OS;13;36920568;36943738;23170;0
1023;ENSG00000120675;DNAJC15;13;43597339;43683045;85706;0
1024;ENSG00000120685;PROSER1;13;39584003;39612252;28249;0
1025;ENSG00000120686;UFM1;13;38923986;38937140;13154;0
1026;ENSG00000120688;WBP4;13;41635410;41658137;22727;0
1027;ENSG00000120690;ELF1;13;41506056;41635576;129520;0
1028;ENSG00000120693;SMAD9;13;37418968;37494902;75934;0
1029;ENSG00000120694;HSPH1;13;31710762;31736525;25763;0
1030;ENSG00000120696;KBTBD7;13;41763969;41768702;4733;0
1031;ENSG00000120697;ALG5;13;37523912;37574398;50486;0
1032;ENSG00000120699;EXOSC8;13;37572953;37583750;10797;0
1033;ENSG00000120798;NR2C1;12;95414005;95467479;53474;0
1034;ENSG00000120800;UTP20;12;101673887;101780394;106507;0
1035;ENSG00000120802;TMPO;12;98909290;98944157;34867;0
1036;ENSG00000120805;ARL1;12;101786898;101801598;14700;0
1037;ENSG00000120820;GLT8D2;12;104382762;104457961;75199;1
1038;ENSG00000120832;MTERFD3;12;107371069;107380944;9875;0
1039;ENSG00000120833;SOCS2;12;93963590;93977263;13673;0
1040;ENSG00000120837;NFYB;12;104510855;104532067;21212;0
1041;ENSG00000120860;CCDC53;12;102406705;102455927;49222;0
1042;ENSG00000120868;APAF1;12;99038919;99129204;90285;0
1043;ENSG00000120942;UBIAD1;1;11333263;11356106;22843;0
1044;ENSG00000120948;TARDBP;1;11072414;11085796;13382;0
1045;ENSG00000121310;ECHDC2;1;53361656;53392884;31228;0
1046;ENSG00000121318;TAS2R10;12;10977916;10978957;1041;1
1047;ENSG00000121350;PYROXD1;12;21590549;21623300;32751;0
1048;ENSG00000121351;IAPP;12;21507893;21532912;25019;0
1049;ENSG00000121361;KCNJ8;12;21917889;21928515;10626;0
1050;ENSG00000121390;PSPC1;13;20248896;20357142;108246;0
1051;ENSG00000121481;RNF2;1;185014496;185071740;57244;0
1052;ENSG00000121486;TRMT1L;1;185087220;185126204;38984;0
1053;ENSG00000121621;KIF18A;11;28042167;28129855;87688;0
1054;ENSG00000121644;DESI2;1;244816237;244872335;56098;0
1055;ENSG00000121653;MAPK8IP1;11;45907202;45928016;20814;0
1056;ENSG00000121671;CRY2;11;45868669;45904798;36129;0
1057;ENSG00000121680;PEX16;11;45931220;45940363;9143;0
1058;ENSG00000121690;DEPDC7;11;33037410;33055128;17718;0
1059;ENSG00000121691;CAT;11;34460472;34493609;33137;0
1060;ENSG00000121741;ZMYM2;13;20532810;20665968;133158;0
1061;ENSG00000121749;TBC1D15;12;72233487;72320629;87142;0
1062;ENSG00000121753;BAI2;1;32192718;32230494;37776;0
1063;ENSG00000121764;HCRTR1;1;32083287;32098119;14832;0
1064;ENSG00000121766;ZCCHC17;1;31769842;31837783;67941;0
1065;ENSG00000121769;FABP3;1;31838472;31849697;11225;0
1066;ENSG00000121774;KHDRBS1;1;32479430;32526451;47021;0
1067;ENSG00000121775;TMEM39B;1;32537632;32568467;30835;0
1068;ENSG00000121848;RNF115;1;145611036;145696218;85182;0
1069;ENSG00000121851;POLR3GL;1;145456236;145470388;14152;0
1070;ENSG00000121898;CPXM2;10;125465723;125699783;234060;0
1071;ENSG00000121900;TMEM54;1;33360195;33367039;6844;0
1072;ENSG00000121903;ZSCAN20;1;33938246;33962107;23861;0
1073;ENSG00000121904;CSMD2;1;33979609;34631443;651834;0
1074;ENSG00000121905;HPCA;1;33351595;33364042;12447;0
1075;ENSG00000121931;LRIF1;1;111489807;111506701;16894;0
1076;ENSG00000121940;CLCC1;1;109472130;109506111;33981;0
1077;ENSG00000121957;GPSM2;1;109417972;109477167;59195;0
1078;ENSG00000122025;FLT3;13;28577411;28674729;97318;0
1079;ENSG00000122026;RPL21;13;27825446;27830828;5382;0
1080;ENSG00000122033;MTIF3;13;28009776;28024739;14963;0
1081;ENSG00000122034;GTF3A;13;27998681;28009958;11277;0
1082;ENSG00000122035;RASL11A;13;27844464;27847827;3363;0
1083;ENSG00000122042;UBL3;13;30338508;30424821;86313;0
1084;ENSG00000122218;COPA;1;160259063;160313190;54127;0
1085;ENSG00000122359;ANXA11;10;81910645;81965328;54683;0
1086;ENSG00000122376;FAM35A;10;88853918;88951225;97307;0
1087;ENSG00000122378;FAM213A;10;82167585;82192753;25168;0
1088;ENSG00000122406;RPL5;1;93297582;93307481;9899;0
1089;ENSG00000122417;ODF2L;1;86814344;86862023;47679;0
1090;ENSG00000122420;PTGFR;1;78769568;79005434;235866;0
1091;ENSG00000122435;TRMT13;1;100598706;100616053;17347;0
1092;ENSG00000122477;LRRC39;1;100614409;100643771;29362;0
1093;ENSG00000122481;RWDD3;1;95699711;95712781;13070;0
1094;ENSG00000122482;ZNF644;1;91380859;91487829;106970;0
1095;ENSG00000122483;CCDC18;1;93645476;93744287;98811;0
1096;ENSG00000122484;RPAP2;1;92764522;92867613;103091;0
1097;ENSG00000122497;NBPF14;1;148003642;148025863;22221;0
1098;ENSG00000122861;PLAU;10;75668935;75677255;8320;1
1099;ENSG00000122863;CHST3;10;73724123;73773322;49199;0
1100;ENSG00000122870;BICC1;10;60272900;60591195;318295;0
1101;ENSG00000122873;CISD1;10;60028818;60049346;20528;0
1102;ENSG00000122877;EGR2;10;64571756;64679660;107904;1
1103;ENSG00000122882;ECD;10;74889913;74928813;38900;0
1104;ENSG00000122884;P4HA1;10;74766975;74856732;89757;0
1105;ENSG00000122912;SLC25A16;10;70237756;70287231;49475;0
1106;ENSG00000122952;ZWINT;10;58116989;58121036;4047;1
1107;ENSG00000122958;VPS26A;10;70883268;70932617;49349;0
1108;ENSG00000122965;RBM19;12;114254543;114404176;149633;0
1109;ENSG00000122966;CIT;12;120123595;120315095;191500;0
1110;ENSG00000122970;IFT81;12;110562140;110656602;94462;0
1111;ENSG00000122971;ACADS;12;121163538;121177811;14273;0
1112;ENSG00000122986;HVCN1;12;111065646;111142755;77109;0
1113;ENSG00000123064;DDX54;12;113594979;113623284;28305;0
1114;ENSG00000123066;MED13L;12;116395711;116715143;319432;0
1115;ENSG00000123080;CDKN2C;1;51426417;51440305;13888;0
1116;ENSG00000123091;RNF11;1;51701943;51739127;37184;0
1117;ENSG00000123094;RASSF8;12;26111962;26232825;120863;0
1118;ENSG00000123095;BHLHE41;12;26272959;26278060;5101;0
1119;ENSG00000123096;SSPN;12;26274924;26452223;177299;0
1120;ENSG00000123104;ITPR2;12;26490342;26986131;495789;0
1121;ENSG00000123106;CCDC91;12;28286182;28732883;446701;0
1122;ENSG00000123178;SPRYD7;13;50486842;50510626;23784;0
1123;ENSG00000123179;EBPL;13;50234859;50265611;30752;0
1124;ENSG00000123191;ATP7B;13;52506809;52585630;78821;0
1125;ENSG00000123200;ZC3H13;13;46528600;46626894;98294;0
1126;ENSG00000123240;OPTN;10;13141449;13180291;38842;0
1127;ENSG00000123268;ATF1;12;51157493;51214905;57412;0
1128;ENSG00000123297;TSFM;12;58176372;58201854;25482;0
1129;ENSG00000123307;NEUROD4;12;55413729;55423798;10069;0
1130;ENSG00000123329;ARHGAP9;12;57866038;57882597;16559;0
1131;ENSG00000123338;NCKAP1L;12;54891495;54937726;46231;0
1132;ENSG00000123349;PFDN5;12;53689075;53693234;4159;0
1133;ENSG00000123352;SPATS2;12;49760367;49921205;160838;0
1134;ENSG00000123353;ORMDL2;12;56211703;56215663;3960;0
1135;ENSG00000123358;NR4A1;12;52416616;52453291;36675;0
1136;ENSG00000123360;PDE1B;12;54943134;54973023;29889;0
1137;ENSG00000123374;CDK2;12;56360553;56366568;6015;0
1138;ENSG00000123384;LRP1;12;57522276;57607134;84858;0
1139;ENSG00000123395;C12orf44;12;52463030;52471278;8248;0
1140;ENSG00000123411;IKZF4;12;56401443;56432219;30776;0
1141;ENSG00000123415;SMUG1;12;54558529;54582778;24249;0
1142;ENSG00000123416;TUBA1B;12;49521565;49525180;3615;0
1143;ENSG00000123427;METTL21B;12;58165275;58176324;11049;0
1144;ENSG00000123444;KBTBD4;11;47593749;47600567;6818;0
1145;ENSG00000123472;ATPAF1;1;47098409;47139539;41130;0
1146;ENSG00000123473;STIL;1;47715811;47779819;64008;0
1147;ENSG00000123684;LPGAT1;1;211916799;212004114;87315;0
1148;ENSG00000123685;BATF3;1;212859760;212873327;13567;0
1149;ENSG00000123836;PFKFB2;1;207222801;207254369;31568;0
1150;ENSG00000123892;RAB38;11;87846410;87908635;62225;0
1151;ENSG00000123901;GPR83;11;94110477;94134585;24108;0
1152;ENSG00000124920;MYRF;11;61520114;61555990;35876;0
1153;ENSG00000124942;AHNAK;11;62201016;62323707;122691;0
1154;ENSG00000125459;MSTO1;1;155579979;155718153;138174;0
1155;ENSG00000125462;C1orf61;1;156374042;156400493;26451;0
1156;ENSG00000125703;ATG4C;1;63249806;63331184;81378;0
1157;ENSG00000125944;HNRNPR;1;23630264;23670829;40565;0
1158;ENSG00000125945;ZNF436;1;23685941;23695935;9994;0
1159;ENSG00000126067;PSMB2;1;36067185;36107445;40260;0
1160;ENSG00000126070;AGO3;1;36396319;36538101;141782;0
1161;ENSG00000126088;UROD;1;45477819;45481247;3428;0
1162;ENSG00000126091;ST3GAL3;1;44171495;44396831;225336;0
1163;ENSG00000126106;TMEM53;1;45100910;45140227;39317;0
1164;ENSG00000126107;HECTD3;1;45468212;45477001;8789;0
1165;ENSG00000126391;FRMD8;11;65154070;65180996;26926;0
1166;ENSG00000126432;PRDX5;11;64085560;64089283;3723;0
1167;ENSG00000126500;FLRT1;11;63870660;63886645;15985;0
1168;ENSG00000126698;DNAJC8;1;28525967;28559536;33569;0
1169;ENSG00000126705;AHDC1;1;27860546;27930942;70396;0
1170;ENSG00000126709;IFI6;1;27992572;27998729;6157;0
1171;ENSG00000126746;ZNF384;12;6775643;6798738;23095;0
1172;ENSG00000126749;EMG1;12;7072408;7105520;33112;0
1173;ENSG00000127054;CPSF3L;1;1246965;1260071;13106;0
1174;ENSG00000127074;RGS13;1;192605275;192629390;24115;0
1175;ENSG00000127124;HIVEP3;1;41972036;42501596;529560;0
1176;ENSG00000127125;PPCS;1;42921788;42939056;17268;0
1177;ENSG00000127311;HELB;12;66696325;66737423;41098;0
1178;ENSG00000127314;RAP1B;12;69004619;69054372;49753;0
1179;ENSG00000127318;IL22;12;68642022;68647387;5365;0
1180;ENSG00000127328;RAB3IP;12;70132461;70216984;84523;0
1181;ENSG00000127329;PTPRB;12;70910630;71031220;120590;1
1182;ENSG00000127334;DYRK2;12;68042118;68059186;17068;0
1183;ENSG00000127337;YEATS4;12;69753483;69784576;31093;0
1184;ENSG00000127423;AUNIP;1;26158414;26185903;27489;0
1185;ENSG00000127463;EMC1;1;19542158;19578046;35888;0
1186;ENSG00000127481;UBR4;1;19401000;19536770;135770;0
1187;ENSG00000127483;HP1BP3;1;21069154;21113816;44662;0
1188;ENSG00000127603;MACF1;1;39546988;39952849;405861;0
1189;ENSG00000127720;METTL25;12;82752276;82873015;120739;0
1190;ENSG00000127863;TNFRSF19;13;24144509;24250232;105723;0
1191;ENSG00000127870;RNF6;13;26706253;26796791;90538;0
1192;ENSG00000127884;ECHS1;10;135175984;135187193;11209;0
1193;ENSG00000128805;ARHGAP22;10;49654077;49864310;210233;1
1194;ENSG00000129083;COPB1;11;14464986;14521573;56587;0
1195;ENSG00000129084;PSMA1;11;14515329;14665181;149852;0
1196;ENSG00000129151;BBOX1;11;27062272;27149356;87084;0
1197;ENSG00000129158;SERGEF;11;17809595;18034709;225114;0
1198;ENSG00000129159;KCNC1;11;17756359;17804602;48243;0
1199;ENSG00000129167;TPH1;11;18039111;18063973;24862;0
1200;ENSG00000129173;E2F8;11;19245610;19263167;17557;0
1201;ENSG00000129315;CCNT1;12;49082247;49110681;28434;0
1202;ENSG00000129317;PUS7L;12;44122410;44152620;30210;0
1203;ENSG00000129749;CHRNA10;11;3686817;3692614;5797;0
1204;ENSG00000129757;CDKN1C;11;2904443;2907111;2668;0
1205;ENSG00000130035;GALNT8;12;4829507;4960277;130770;1
1206;ENSG00000130037;KCNA5;12;5153085;5155949;2864;0
1207;ENSG00000130038;EFCAB4B;12;3715799;3873985;158186;0
1208;ENSG00000130413;STK33;11;8413418;8615836;202418;0
1209;ENSG00000130640;TUBGCP2;10;135093135;135125841;32706;0
1210;ENSG00000130643;CALY;10;135138927;135150475;11548;0
1211;ENSG00000130649;CYP2E1;10;135333910;135374724;40814;1
1212;ENSG00000130695;CEP85;1;26560691;26605299;44608;0
1213;ENSG00000130762;ARHGEF16;1;3370990;3397677;26687;0
1214;ENSG00000130764;LRRC47;1;3696784;3713068;16284;0
1215;ENSG00000130766;SESN2;1;28586038;28609002;22964;0
1216;ENSG00000130770;ATPIF1;1;28562620;28573417;10797;0
1217;ENSG00000130772;MED18;1;28655513;28662476;6963;0
1218;ENSG00000130775;THEMIS2;1;28199055;28213196;14141;0
1219;ENSG00000130779;CLIP1;12;122755979;122907179;151200;0
1220;ENSG00000130783;CCDC62;12;123258874;123312075;53201;0
1221;ENSG00000130787;HIP1R;12;123319000;123347507;28507;0
1222;ENSG00000130921;C12orf65;12;123717463;123742506;25043;0
1223;ENSG00000130939;UBE4B;1;10092890;10241297;148407;0
1224;ENSG00000130940;CASZ1;1;10696661;10856707;160046;0
1225;ENSG00000131236;CAP1;1;40505905;40538321;32416;0
1226;ENSG00000131238;PPT1;1;40538379;40563375;24996;0
1227;ENSG00000131584;ACAP3;1;1227756;1244989;17233;0
1228;ENSG00000131591;C1orf159;1;1017198;1051741;34543;0
1229;ENSG00000131626;PPFIA1;11;70116806;70230509;113703;0
1230;ENSG00000131697;NPHP4;1;5922871;6052533;129662;0
1231;ENSG00000131778;CHD1L;1;146714291;146767443;53152;0
1232;ENSG00000131779;PEX11B;1;145516252;145523730;7478;0
1233;ENSG00000131781;FMO5;1;146646930;146714700;67770;0
1234;ENSG00000131788;PIAS3;1;145575233;145586546;11313;0
1235;ENSG00000131791;PRKAB2;1;146626685;146644129;17444;0
1236;ENSG00000131795;RBM8A;1;145507598;145513536;5938;0
1237;ENSG00000132109;TRIM21;11;4406127;4414926;8799;1
1238;ENSG00000132122;SPATA6;1;48761044;48937845;176801;0
1239;ENSG00000132128;LRRC41;1;46726868;46769280;42412;0
1240;ENSG00000132196;HSD17B7;1;162760492;162782607;22115;0
1241;ENSG00000132254;ARFIP2;11;6496910;6502666;5756;0
1242;ENSG00000132256;TRIM5;11;5684425;5959849;275424;0
1243;ENSG00000132259;CNGA4;11;6255995;6265659;9664;0
1244;ENSG00000132274;TRIM22;11;5710919;5758319;47400;0
1245;ENSG00000132275;RRP8;11;6616305;6624850;8545;0
1246;ENSG00000132286;TIMM10B;11;6502677;6505909;3232;0
1247;ENSG00000132334;PTPRE;10;129705325;129884119;178794;0
1248;ENSG00000132341;RAN;12;131356424;131362223;5799;0
1249;ENSG00000132485;ZRANB2;1;71528974;71546980;18006;0
1250;ENSG00000132676;DAP3;1;155657751;155708801;51050;0
1251;ENSG00000132680;KIAA0907;1;155882834;155904191;21357;0
1252;ENSG00000132688;NES;1;156638555;156647189;8634;1
1253;ENSG00000132692;BCAN;1;156611182;156629324;18142;0
1254;ENSG00000132694;ARHGEF11;1;156904632;157015162;110530;0
1255;ENSG00000132698;RAB25;1;156030951;156040295;9344;0
1256;ENSG00000132702;HAPLN2;1;156589086;156595517;6431;1
1257;ENSG00000132716;DCAF8;1;160185505;160254920;69415;0
1258;ENSG00000132718;SYT11;1;155829300;155854990;25690;0
1259;ENSG00000132740;IGHMBP2;11;68671310;68708070;36760;0
1260;ENSG00000132749;MTL5;11;68474908;68519032;44124;0
1261;ENSG00000132763;MMACHC;1;45965725;45976739;11014;0
1262;ENSG00000132768;DPH2;1;44435672;44439041;3369;0
1263;ENSG00000132773;TOE1;1;45805342;45809647;4305;0
1264;ENSG00000132780;NASP;1;46049518;46084566;35048;0
1265;ENSG00000132781;MUTYH;1;45794835;45806142;11307;0
1266;ENSG00000132849;INADL;1;62208149;62629592;421443;0
1267;ENSG00000132854;KANK4;1;62702651;62785085;82434;1
1268;ENSG00000132879;FBXO44;1;11714432;11723384;8952;0
1269;ENSG00000132881;RSG1;1;16558195;16563657;5462;0
1270;ENSG00000132906;CASP9;1;15817327;15853029;35702;0
1271;ENSG00000132932;ATP8A2;13;25946209;26599989;653780;0
1272;ENSG00000132938;MTUS2;13;29598748;30077892;479144;0
1273;ENSG00000132950;ZMYM5;13;20397622;20437776;40154;0
1274;ENSG00000132952;USPL1;13;31191830;31233686;41856;0
1275;ENSG00000132953;XPO4;13;21351469;21477187;125718;0
1276;ENSG00000132958;TPTE2;13;19997017;20110903;113886;0
1277;ENSG00000132963;POMP;13;29233241;29253062;19821;0
1278;ENSG00000132964;CDK8;13;26828276;26979375;151099;0
1279;ENSG00000132970;WASF3;13;27131840;27263085;131245;0
1280;ENSG00000132975;GPR12;13;27329341;27334922;5581;1
1281;ENSG00000133019;CHRM3;1;239549865;240078750;528885;0
1282;ENSG00000133056;PIK3C2B;1;204391756;204463852;72096;0
1283;ENSG00000133059;DSTYK;1;205111632;205180727;69095;0
1284;ENSG00000133065;SLC41A1;1;205758221;205782876;24655;0
1285;ENSG00000133067;LGR6;1;202163029;202288909;125880;0
1286;ENSG00000133069;TMCC2;1;205197304;205242471;45167;0
1287;ENSG00000133083;DCLK1;13;36345478;36705443;359965;0
1288;ENSG00000133101;CCNA1;13;37005967;37017019;11052;0
1289;ENSG00000133103;COG6;13;40229764;40365802;136038;0
1290;ENSG00000133104;SPG20;13;36875775;36944317;68542;0
1291;ENSG00000133105;RXFP2;13;32313674;32377009;63335;0
1292;ENSG00000133106;EPSTI1;13;43460524;43566407;105883;0
1293;ENSG00000133107;TRPC4;13;38210773;38444562;233789;0
1294;ENSG00000133110;POSTN;13;38136720;38172981;36261;0
1295;ENSG00000133111;RFXAP;13;37393361;37403241;9880;0
1296;ENSG00000133112;TPT1;13;45911008;45915505;4497;0
1297;ENSG00000133114;GPALPP1;13;45563687;45607746;44059;0
1298;ENSG00000133115;STOML3;13;39540062;39565203;25141;0
1299;ENSG00000133119;RFC3;13;34392186;34540695;148509;0
1300;ENSG00000133121;STARD13;13;33677272;33924767;247495;0
1301;ENSG00000133216;EPHB2;1;23037332;23241818;204486;0
1302;ENSG00000133226;SRRM1;1;24958207;24999758;41551;0
1303;ENSG00000133315;MACROD1;11;63766030;63933578;167548;0
1304;ENSG00000133316;WDR74;11;62599814;62609281;9467;0
1305;ENSG00000133318;RTN3;11;63448918;63527363;78445;0
1306;ENSG00000133636;NTS;12;86268073;86276770;8697;0
1307;ENSG00000133639;BTG1;12;92536286;92539673;3387;0
1308;ENSG00000133640;LRRIQ1;12;85430092;85657002;226910;0
1309;ENSG00000133641;C12orf29;12;88427623;88443937;16314;0
1310;ENSG00000133661;SFTPD;10;81697496;81742370;44874;0
1311;ENSG00000133665;DYDC2;10;82104501;82127829;23328;0
1312;ENSG00000133678;TMEM254;10;81838402;81852313;13911;0
1313;ENSG00000133687;TMTC1;12;29653773;29937692;283919;0
1314;ENSG00000133703;KRAS;12;25357723;25403870;46147;0
1315;ENSG00000133704;IPO8;12;30781922;30848920;66998;0
1316;ENSG00000133773;CCDC59;12;82617460;82752584;135124;0
1317;ENSG00000133789;SWAP70;11;9685624;9774538;88914;0
1318;ENSG00000133794;ARNTL;11;13298199;13408813;110614;0
1319;ENSG00000133805;AMPD3;11;10329860;10529126;199266;0
1320;ENSG00000133812;SBF2;11;9800214;10315754;515540;0
1321;ENSG00000133816;MICAL2;11;12115543;12285334;169791;0
1322;ENSG00000133818;RRAS2;11;14299472;14386052;86580;0
1323;ENSG00000133858;ZFC3H1;12;72003252;72061505;58253;0
1324;ENSG00000133884;DPF2;11;65101225;65120720;19495;0
1325;ENSG00000133895;MEN1;11;64570982;64578766;7784;0
1326;ENSG00000134186;PRPF38B;1;109234945;109244425;9480;0
1327;ENSG00000134198;TSPAN2;1;115590632;115632121;41489;0
1328;ENSG00000134202;GSTM3;1;110276554;110284384;7830;0
1329;ENSG00000134207;SYT6;1;114631913;114696541;64628;1
1330;ENSG00000134215;VAV3;1;108113782;108507766;393984;0
1331;ENSG00000134222;PSRC1;1;109822178;109825808;3630;0
1332;ENSG00000134242;PTPN22;1;114356433;114414381;57948;0
1333;ENSG00000134243;SORT1;1;109852192;109940573;88381;0
1334;ENSG00000134245;WNT2B;1;113009163;113072787;63624;1
1335;ENSG00000134247;PTGFRN;1;117452679;117532980;80301;0
1336;ENSG00000134248;LAMTOR5;1;110943871;110950564;6693;0
1337;ENSG00000134250;NOTCH2;1;120454176;120612240;158064;1
1338;ENSG00000134253;TRIM45;1;117653682;117665209;11527;0
1339;ENSG00000134255;CEPT1;1;111682249;111727724;45475;0
1340;ENSG00000134256;CD101;1;117544382;117579167;34785;1
1341;ENSG00000134258;VTCN1;1;117686209;117753556;67347;0
1342;ENSG00000134262;AP4B1;1;114437370;114447823;10453;0
1343;ENSG00000134283;PPHLN1;12;42632249;42853517;221268;0
1344;ENSG00000134285;FKBP11;12;49315301;49320257;4956;0
1345;ENSG00000134287;ARF3;12;49329506;49351334;21828;0
1346;ENSG00000134291;TMEM106C;12;48357352;48362661;5309;0
1347;ENSG00000134294;SLC38A2;12;46751972;46766650;14678;0
1348;ENSG00000134297;PLEKHA8P1;12;45566847;45609824;42977;0
1349;ENSG00000134333;LDHA;11;18415935;18429972;14037;0
1350;ENSG00000134343;ANO3;11;26210829;26684835;474006;0
1351;ENSG00000134369;NAV1;1;201592411;201796102;203691;0
1352;ENSG00000134371;CDC73;1;193091147;193223031;131884;0
1353;ENSG00000134375;TIMM17A;1;201924619;201939789;15170;0
1354;ENSG00000134376;CRB1;1;197170592;197447585;276993;0
1355;ENSG00000134452;FBXO18;10;5931535;5979556;48021;0
1356;ENSG00000134453;RBM17;10;6130950;6159420;28470;0
1357;ENSG00000134461;ANKRD16;10;5903580;5931869;28289;0
1358;ENSG00000134531;EMP1;12;13349650;13369708;20058;0
1359;ENSG00000134532;SOX5;12;23682440;24103966;421526;0
1360;ENSG00000134533;RERG;12;15260717;15501609;240892;0
1361;ENSG00000134569;LRP4;11;46878419;46940193;61774;0
1362;ENSG00000134574;DDB2;11;47236493;47260767;24274;0
1363;ENSG00000134575;ACP2;11;47260853;47270457;9604;0
1364;ENSG00000134627;PIWIL4;11;94277006;94354587;77581;0
1365;ENSG00000134644;PUM1;1;31404353;31538838;134485;0
1366;ENSG00000134684;YARS;1;33240840;33283754;42914;0
1367;ENSG00000134686;PHC2;1;33789224;33896653;107429;0
1368;ENSG00000134690;CDCA8;1;38158090;38175391;17301;1
1369;ENSG00000134697;GNL2;1;38032417;38061536;29119;0
1370;ENSG00000134698;AGO4;1;36273773;36323491;49718;0
1371;ENSG00000134709;HOOK1;1;60280458;60342050;61592;0
1372;ENSG00000134716;CYP2J2;1;60358980;60392462;33482;0
1373;ENSG00000134717;BTF3L4;1;52521797;52556388;34591;0
1374;ENSG00000134744;ZCCHC11;1;52873954;53019159;145205;0
1375;ENSG00000134748;PRPF38A;1;52870236;52886511;16275;0
1376;ENSG00000134780;DAGLA;11;61447905;61514473;66568;0
1377;ENSG00000134802;SLC43A3;11;57174427;57195053;20626;0
1378;ENSG00000134809;TIMM10;11;57295936;57298276;2340;0
1379;ENSG00000134824;FADS2;11;61560452;61634826;74374;0
1380;ENSG00000134825;TMEM258;11;61535973;61560274;24301;0
1381;ENSG00000134909;ARHGAP32;11;128834955;129149219;314264;0
1382;ENSG00000134910;STT3A;11;125461607;125495110;33503;0
1383;ENSG00000134917;ADAMTS8;11;130274820;130298888;24068;0
1384;ENSG00000134940;ACRV1;11;125541417;125551018;9601;0
1385;ENSG00000135090;TAOK3;12;118587606;118810750;223144;0
1386;ENSG00000135093;USP30;12;109460894;109525831;64937;0
1387;ENSG00000135097;MSI1;12;120779133;120806983;27850;0
1388;ENSG00000135108;FBXO21;12;117581146;117628336;47190;0
1389;ENSG00000135116;HRK;12;117293949;117319246;25297;1
1390;ENSG00000135119;RNFT2;12;117176096;117291436;115340;0
1391;ENSG00000135124;P2RX4;12;121647660;121671909;24249;0
1392;ENSG00000135127;CCDC64;12;120427673;120532298;104625;0
1393;ENSG00000135144;DTX1;12;113494514;113535833;41319;0
1394;ENSG00000135148;TRAFD1;12;112563305;112591407;28102;0
1395;ENSG00000135362;PRR5L;11;36317838;36486754;168916;0
1396;ENSG00000135363;LMO2;11;33880122;33913836;33714;0
1397;ENSG00000135365;PHF21A;11;45950871;46142985;192114;0
1398;ENSG00000135372;NAT10;11;34127149;34169217;42068;0
1399;ENSG00000135378;PRRG4;11;32851489;32879669;28180;0
1400;ENSG00000135387;CAPRIN1;11;34073230;34122703;49473;0
1401;ENSG00000135390;ATP5G2;12;54026510;54071192;44682;0
1402;ENSG00000135392;DNAJC14;12;56214744;56224608;9864;0
1403;ENSG00000135404;CD63;12;56119107;56123491;4384;0
1404;ENSG00000135406;PRPH;12;49687035;49692465;5430;0
1405;ENSG00000135407;AVIL;12;58191159;58212487;21328;0
1406;ENSG00000135414;GDF11;12;56137064;56150911;13847;0
1407;ENSG00000135423;GLS2;12;56864736;56882198;17462;0
1408;ENSG00000135424;ITGA7;12;56078352;56109827;31475;0
1409;ENSG00000135437;RDH5;12;56114151;56118489;4338;0
1410;ENSG00000135439;AGAP2;12;58118980;58135940;16960;0
1411;ENSG00000135441;BLOC1S1;12;56109820;56113871;4051;0
1412;ENSG00000135446;CDK4;12;58141510;58149796;8286;0
1413;ENSG00000135447;PPP1R1A;12;54969171;54982443;13272;0
1414;ENSG00000135451;TROAP;12;49717019;49725514;8495;0
1415;ENSG00000135452;TSPAN31;12;58131796;58143994;12198;0
1416;ENSG00000135454;B4GALNT1;12;58017193;58027138;9945;0
1417;ENSG00000135457;TFCP2;12;51487446;51566926;79480;0
1418;ENSG00000135469;COQ10A;12;56660642;56664750;4108;0
1419;ENSG00000135472;FAIM2;12;50260679;50298000;37321;0
1420;ENSG00000135473;PAN2;12;56710007;56727837;17830;0
1421;ENSG00000135476;ESPL1;12;53662083;53687427;25344;0
1422;ENSG00000135482;ZC3H10;12;56511943;56516278;4335;0
1423;ENSG00000135486;HNRNPA1;12;54673977;54680872;6895;0
1424;ENSG00000135502;SLC26A10;12;58013310;58019934;6624;0
1425;ENSG00000135503;ACVR1B;12;52345451;52390862;45411;0
1426;ENSG00000135506;OS9;12;58087738;58115340;27602;0
1427;ENSG00000135517;MIP;12;56843286;56862950;19664;0
1428;ENSG00000135519;KCNH3;12;49932940;49952091;19151;0
1429;ENSG00000135643;KCNMB4;12;70760056;70828072;68016;0
1430;ENSG00000135655;USP15;12;62654119;62811211;157092;0
1431;ENSG00000135677;GNS;12;65107225;65153227;46002;0
1432;ENSG00000135678;CPM;12;69235977;69365350;129373;0
1433;ENSG00000135679;MDM2;12;69201956;69239214;37258;0
1434;ENSG00000135747;ZNF670;1;247108849;247242113;133264;0
1435;ENSG00000135749;PCNXL2;1;233119181;233431459;312278;0
1436;ENSG00000135750;KCNK1;1;233749750;233808258;58508;0
1437;ENSG00000135763;URB2;1;229761981;229795946;33965;0
1438;ENSG00000135766;EGLN1;1;231499497;231560790;61293;0
1439;ENSG00000135773;CAPN9;1;230883130;230937749;54619;0
1440;ENSG00000135775;COG2;1;230778235;230829728;51493;0
1441;ENSG00000135776;ABCB10;1;229652329;229694442;42113;0
1442;ENSG00000135778;NTPCR;1;233086351;233119628;33277;0
1443;ENSG00000135801;TAF5L;1;229728858;229761794;32936;0
1444;ENSG00000135821;GLUL;1;182350839;182361341;10502;0
1445;ENSG00000135823;STX6;1;180941861;180992047;50186;0
1446;ENSG00000135824;RGS8;1;182615239;182653711;38472;1
1447;ENSG00000135828;RNASEL;1;182542769;182558391;15622;0
1448;ENSG00000135829;DHX9;1;182808504;182856886;48382;0
1449;ENSG00000135835;KIAA1614;1;180882290;180920750;38460;0
1450;ENSG00000135837;CEP350;1;179923873;180084015;160142;0
1451;ENSG00000135838;NPL;1;182758428;182799519;41091;0
1452;ENSG00000135842;FAM129A;1;184759858;184943682;183824;1
1453;ENSG00000135845;PIGC;1;172339329;172413230;73901;0
1454;ENSG00000135847;ACBD6;1;180244515;180472089;227574;0
1455;ENSG00000135862;LAMC1;1;182992595;183114727;122132;0
1456;ENSG00000135870;RC3H1;1;173900352;173991435;91083;0
1457;ENSG00000136003;ISCU;12;108956358;108963160;6802;0
1458;ENSG00000136010;ALDH1L2;12;105413568;105478355;64787;0
1459;ENSG00000136014;USP44;12;95910336;95945266;34930;0
1460;ENSG00000136021;SCYL2;12;100660918;100735502;74584;0
1461;ENSG00000136026;CKAP4;12;106631655;106698057;66402;0
1462;ENSG00000136040;PLXNC1;12;94542499;94701451;158952;0
1463;ENSG00000136044;APPL2;12;105567074;105630016;62942;0
1464;ENSG00000136045;PWP1;12;108079509;108106944;27435;0
1465;ENSG00000136048;DRAM1;12;102271129;102405908;134779;0
1466;ENSG00000136051;KIAA1033;12;105501102;105562912;61810;0
1467;ENSG00000136052;SLC41A2;12;105196331;105352522;156191;0
1468;ENSG00000136098;NEK3;13;52706775;52733996;27221;0
1469;ENSG00000136099;PCDH8;13;53418109;53422775;4666;0
1470;ENSG00000136100;VPS36;13;52986737;53024763;38026;0
1471;ENSG00000136104;RNASEH2B;13;51483814;51544592;60778;0
1472;ENSG00000136108;CKAP2;13;53029564;53050763;21199;0
1473;ENSG00000136114;THSD1;13;52951305;52980629;29324;0
1474;ENSG00000136141;LRCH1;13;47127303;47327175;199872;0
1475;ENSG00000136143;SUCLA2;13;48510622;48612125;101503;0
1476;ENSG00000136144;RCBTB1;13;50106082;50159719;53637;0
1477;ENSG00000136146;MED4;13;48627459;48669267;41808;0
1478;ENSG00000136147;PHF11;13;50069746;50103123;33377;0
1479;ENSG00000136152;COG3;13;46039060;46110765;71705;0
1480;ENSG00000136156;ITM2B;13;48807294;48837063;29769;0
1481;ENSG00000136159;NUDT15;13;48611703;48621358;9655;0
1482;ENSG00000136161;RCBTB2;13;49063095;49107369;44274;0
1483;ENSG00000136167;LCP1;13;46700055;46786006;85951;0
1484;ENSG00000136169;SETDB2;13;50018429;50069138;50709;0
1485;ENSG00000136628;EPRS;1;220141943;220220000;78057;0
1486;ENSG00000136631;VPS45;1;150039369;150117505;78136;0
1487;ENSG00000136636;KCTD3;1;215740735;215795149;54414;0
1488;ENSG00000136643;RPS6KC1;1;213224589;213448116;223527;0
1489;ENSG00000136653;RASSF5;1;206680879;206762616;81737;0
1490;ENSG00000136738;STAM;10;17686124;17757913;71789;0
1491;ENSG00000136750;GAD2;10;26505236;26593487;88251;1
1492;ENSG00000136754;ABI1;10;27035522;27150016;114494;0
1493;ENSG00000136758;YME1L1;10;27399383;27444195;44812;0
1494;ENSG00000136770;DNAJC1;10;22045466;22292698;247232;0
1495;ENSG00000137474;MYO7A;11;76839310;76926284;86974;0
1496;ENSG00000137478;FCHSD2;11;72547790;72853306;305516;0
1497;ENSG00000137486;ARRB1;11;74975226;75062873;87647;0
1498;ENSG00000137492;PRKRIR;11;76061000;76092015;31015;0
1499;ENSG00000137494;ANKRD42;11;82904781;82971736;66955;0
1500;ENSG00000137496;IL18BP;11;71709587;71716761;7174;0
1501;ENSG00000137497;NUMA1;11;71713910;71791739;77829;0
1502;ENSG00000137500;CCDC90B;11;82970139;82997450;27311;0
1503;ENSG00000137501;SYTL2;11;85405267;85522184;116917;0
1504;ENSG00000137502;RAB30;11;82684175;82782965;98790;0
1505;ENSG00000137504;CREBZF;11;85370752;85393951;23199;0
1506;ENSG00000137507;LRRC32;11;76368568;76381791;13223;0
1507;ENSG00000137509;PRCP;11;82534544;82681626;147082;0
1508;ENSG00000137513;NARS2;11;78147007;78285919;138912;0
1509;ENSG00000137522;RNF121;11;71639747;71708643;68896;0
1510;ENSG00000137642;SORL1;11;121322912;121504402;181490;0
1511;ENSG00000137656;BUD13;11;116618886;116643704;24818;0
1512;ENSG00000137672;TRPC6;11;101322295;101743293;420998;0
1513;ENSG00000137691;C11orf70;11;101918174;101955291;37117;0
1514;ENSG00000137692;DCUN1D5;11;102932805;102962944;30139;0
1515;ENSG00000137693;YAP1;11;101981192;102104154;122962;0
1516;ENSG00000137700;SLC37A4;11;118894824;118901616;6792;0
1517;ENSG00000137710;RDX;11;110045605;110167447;121842;0
1518;ENSG00000137713;PPP2R1B;11;111597632;111637151;39519;0
1519;ENSG00000137714;FDX1;11;110300607;110335605;34998;0
1520;ENSG00000137720;C11orf1;11;111749659;111756699;7040;0
1521;ENSG00000137726;FXYD6;11;117707693;117748201;40508;0
1522;ENSG00000137727;ARHGAP20;11;110447766;110583912;136146;1
1523;ENSG00000137731;FXYD2;11;117671559;117699413;27854;0
1524;ENSG00000137760;ALKBH8;11;107373452;107436472;63020;0
1525;ENSG00000137936;BCAR3;1;94027347;94312706;285359;0
1526;ENSG00000137941;TTLL7;1;84330711;84464833;134122;0
1527;ENSG00000137942;FNBP1L;1;93913688;94020218;106530;0
1528;ENSG00000137944;CCBL2;1;89401456;89458636;57180;0
1529;ENSG00000137947;GTF2B;1;89318615;89357627;39012;0
1530;ENSG00000137955;RABGGTB;1;76251879;76260764;8885;0
1531;ENSG00000137959;IFI44L;1;79085607;79111830;26223;0
1532;ENSG00000137960;GIPC2;1;78445226;78604133;158907;0
1533;ENSG00000137962;ARHGAP29;1;94614544;94740624;126080;0
1534;ENSG00000137965;IFI44;1;79115481;79129763;14282;0
1535;ENSG00000137968;SLC44A5;1;75667816;76076801;408985;0
1536;ENSG00000137970;RPL7P9;1;97144430;97145176;746;0
1537;ENSG00000137976;DNASE2B;1;84864215;84880701;16486;0
1538;ENSG00000137992;DBT;1;100652475;100715390;62915;0
1539;ENSG00000137996;RTCA;1;100731763;100758325;26562;0
1540;ENSG00000138107;ACTR1A;10;104238986;104262482;23496;0
1541;ENSG00000138111;TMEM180;10;104221149;104236802;15653;0
1542;ENSG00000138119;MYOF;10;95066186;95242074;175888;0
1543;ENSG00000138134;STAMBPL1;10;90639491;90734910;95419;0
1544;ENSG00000138136;LBX1;10;102986733;102989551;2818;1
1545;ENSG00000138138;ATAD1;10;89511269;89601100;89831;0
1546;ENSG00000138160;KIF11;10;94353043;94415150;62107;1
1547;ENSG00000138161;CUZD1;10;124591665;124639146;47481;0
1548;ENSG00000138162;TACC2;10;123748689;124014060;265371;0
1549;ENSG00000138166;DUSP5;10;112257596;112271302;13706;0
1550;ENSG00000138175;ARL3;10;104433488;104474164;40676;0
1551;ENSG00000138180;CEP55;10;95256389;95288849;32460;1
1552;ENSG00000138182;KIF20B;10;91461367;91534700;73333;0
1553;ENSG00000138185;ENTPD1;10;97471536;97637023;165487;0
1554;ENSG00000138190;EXOC6;10;94590935;94819250;228315;0
1555;ENSG00000138193;PLCE1;10;95753746;96092580;338834;0
1556;ENSG00000138207;RBP4;10;95351444;95361501;10057;0
1557;ENSG00000138279;ANXA7;10;75134859;75173834;38975;0
1558;ENSG00000138286;FAM149B1;10;74927924;75004262;76338;0
1559;ENSG00000138293;NCOA4;10;51565108;51590734;25626;0
1560;ENSG00000138297;TIMM23;10;51592080;51623365;31285;0
1561;ENSG00000138303;ASCC1;10;73856278;73976892;120614;0
1562;ENSG00000138311;ZNF365;10;64133951;64431771;297820;0
1563;ENSG00000138315;OIT3;10;74653339;74692791;39452;0
1564;ENSG00000138316;ADAMTS14;10;72432559;72522197;89638;0
1565;ENSG00000138326;RPS24;10;79793518;79816570;23052;0
1566;ENSG00000138336;TET1;10;70320413;70454239;133826;0
1567;ENSG00000138346;DNA2;10;70173821;70231879;58058;0
1568;ENSG00000139044;B4GALNT3;12;569530;672675;103145;0
1569;ENSG00000139083;ETV6;12;11802788;12048336;245548;0
1570;ENSG00000139112;GABARAPL1;12;10365057;10375727;10670;0
1571;ENSG00000139116;KIF21A;12;39687030;39837192;150162;0
1572;ENSG00000139117;CPNE8;12;39040624;39301232;260608;0
1573;ENSG00000139131;YARS2;12;32880424;32908836;28412;0
1574;ENSG00000139132;FGD4;12;32552463;32798984;246521;0
1575;ENSG00000139133;ALG10;12;34175216;34182629;7413;0
1576;ENSG00000139146;FAM60A;12;31433518;31479992;46474;0
1577;ENSG00000139154;AEBP2;12;19556979;19873735;316756;0
1578;ENSG00000139155;SLCO1C1;12;20848289;20906320;58031;0
1579;ENSG00000139160;METTL20;12;31800094;31826048;25954;0
1580;ENSG00000139163;ETNK1;12;22778009;22843599;65590;0
1581;ENSG00000139168;ZCRB1;12;42705880;42719920;14040;0
1582;ENSG00000139173;TMEM117;12;44229770;44783545;553775;0
1583;ENSG00000139174;PRICKLE1;12;42852140;42984157;132017;0
1584;ENSG00000139178;C1RL;12;7242183;7261869;19686;0
1585;ENSG00000139180;NDUFA9;12;4758261;4798454;40193;0
1586;ENSG00000139182;CLSTN3;12;7282294;7311541;29247;0
1587;ENSG00000139187;KLRG1;12;9102640;9163356;60716;0
1588;ENSG00000139190;VAMP1;12;6571403;6580153;8750;0
1589;ENSG00000139194;RBP5;12;7276280;7281538;5258;0
1590;ENSG00000139197;PEX5;12;7341281;7371170;29889;0
1591;ENSG00000139200;PIANP;12;6802958;6809966;7008;0
1592;ENSG00000139209;SLC38A4;12;47158546;47226191;67645;1
1593;ENSG00000139211;AMIGO2;12;47469490;47473734;4244;1
1594;ENSG00000139218;SCAF11;12;46312914;46385903;72989;0
1595;ENSG00000139219;COL2A1;12;48366748;48398269;31521;1
1596;ENSG00000139220;PPFIA2;12;81652045;82153332;501287;0
1597;ENSG00000139233;LLPH;12;66516842;66524548;7706;0
1598;ENSG00000139239;RPL14P1;12;63359095;63359764;669;0
1599;ENSG00000139263;LRIG3;12;59265931;59314303;48372;0
1600;ENSG00000139266;09-Mar;12;58148881;58154190;5309;0
1601;ENSG00000139278;GLIPR1;12;75874460;75897633;23173;0
1602;ENSG00000139289;PHLDA1;12;76419227;76427712;8485;0
1603;ENSG00000139291;TMEM19;12;72079867;72097836;17969;0
1604;ENSG00000139292;LGR5;12;71833550;71980090;146540;0
1605;ENSG00000139304;PTPRQ;12;80799774;81072802;273028;0
1606;ENSG00000139318;DUSP6;12;89741009;89747048;6039;0
1607;ENSG00000139323;POC1B;12;89813495;89919801;106306;0
1608;ENSG00000139324;TMTC3;12;88536073;88593664;57591;0
1609;ENSG00000139329;LUM;12;91496406;91505608;9202;0
1610;ENSG00000139343;SNRPF;12;96252706;96297606;44900;0
1611;ENSG00000139350;NEDD1;12;97301001;97347129;46128;0
1612;ENSG00000139351;SYCP3;12;102122426;102133250;10824;0
1613;ENSG00000139352;ASCL1;12;103351464;103354294;2830;0
1614;ENSG00000139354;GAS2L3;12;100967461;101022064;54603;0
1615;ENSG00000139364;TMEM132B;12;125671382;126146917;475535;0
1616;ENSG00000139370;SLC15A4;12;129277739;129308528;30789;0
1617;ENSG00000139372;TDG;12;104359582;104382652;23070;0
1618;ENSG00000139405;RITA1;12;113623331;113630173;6842;0
1619;ENSG00000139410;SDSL;12;113860042;113876081;16039;0
1620;ENSG00000139428;MMAB;12;109991542;110011679;20137;0
1621;ENSG00000139433;GLTP;12;110288748;110318293;29545;0
1622;ENSG00000139436;GIT2;12;110367607;110434194;66587;0
1623;ENSG00000139437;TCHP;12;110338069;110421646;83577;0
1624;ENSG00000139438;FAM222A;12;110152033;110208312;56279;0
1625;ENSG00000139496;NUPL1;13;25875662;25923938;48276;0
1626;ENSG00000139505;MTMR6;13;25802307;25862147;59840;0
1627;ENSG00000139508;SLC46A3;13;29274201;29293107;18906;0
1628;ENSG00000139514;SLC7A1;13;30083547;30169825;86278;0
1629;ENSG00000139517;LNX2;13;28120050;28194541;74491;0
1630;ENSG00000139531;SUOX;12;56390964;56400425;9461;0
1631;ENSG00000139537;CCDC65;12;49297893;49325623;27730;0
1632;ENSG00000139546;TARBP2;12;53894705;53900215;5510;0
1633;ENSG00000139547;RDH16;12;57345219;57353158;7939;0
1634;ENSG00000139549;DHH;12;49483204;49488602;5398;0
1635;ENSG00000139579;NABP2;12;56615799;56623638;7839;0
1636;ENSG00000139597;N4BP2L1;13;32974861;33002315;27454;0
1637;ENSG00000139613;SMARCC2;12;56556767;56583351;26584;0
1638;ENSG00000139618;BRCA2;13;32889611;32973805;84194;1
1639;ENSG00000139620;KANSL2;12;49047184;49076021;28837;0
1640;ENSG00000139624;CERS5;12;50523575;50561288;37713;1
1641;ENSG00000139625;MAP3K12;12;53874274;53893847;19573;0
1642;ENSG00000139631;CSAD;12;53551447;53575135;23688;1
1643;ENSG00000139636;LMBR1L;12;49490919;49504683;13764;0
1644;ENSG00000139637;C12orf10;12;53693470;53700961;7491;0
1645;ENSG00000139641;ESYT1;12;56512034;56538455;26421;0
1646;ENSG00000139644;TMBIM6;12;50101508;50158717;57209;0
1647;ENSG00000139645;ANKRD52;12;56631591;56652175;20584;0
1648;ENSG00000139651;ZNF740;12;53574484;53584596;10112;0
1649;ENSG00000139668;WDFY2;13;52158644;52336171;177527;0
1650;ENSG00000139675;HNRNPA1L2;13;53191605;53217919;26314;0
1651;ENSG00000139679;LPAR6;13;48963707;49018840;55133;0
1652;ENSG00000139684;ESD;13;47345391;47371367;25976;0
1653;ENSG00000139687;RB1;13;48877887;49056122;178235;0
1654;ENSG00000139697;SBNO1;12;123773656;123849390;75734;0
1655;ENSG00000139714;MORN3;12;122089024;122110537;21513;0
1656;ENSG00000139718;SETD1B;12;122242086;122270562;28476;0
1657;ENSG00000139719;VPS33A;12;122714111;122751068;36957;0
1658;ENSG00000139722;VPS37B;12;123349882;123380991;31109;0
1659;ENSG00000139725;RHOF;12;122215664;122241309;25645;0
1660;ENSG00000139726;DENR;12;123237321;123255611;18290;0
1661;ENSG00000139767;SRRM4;12;119419300;119600856;181556;0
1662;ENSG00000142082;SIRT3;11;215458;236931;21473;0
1663;ENSG00000142089;IFITM3;11;319669;327537;7868;0
1664;ENSG00000142102;ATHL1;11;289135;296107;6972;0
1665;ENSG00000142186;SCYL1;11;65292548;65306175;13627;0
1666;ENSG00000142599;RERE;1;8412457;8877702;465245;0
1667;ENSG00000142611;PRDM16;1;2985732;3355185;369453;0
1668;ENSG00000142621;FHAD1;1;15573768;15726779;153011;0
1669;ENSG00000142627;EPHA2;1;16450832;16482582;31750;0
1670;ENSG00000142632;ARHGEF19;1;16524349;16539104;14755;0
1671;ENSG00000142634;EFHD2;1;15736391;15756839;20448;0
1672;ENSG00000142655;PEX14;1;10532345;10690815;158470;0
1673;ENSG00000142657;PGD;1;10458649;10480201;21552;0
1674;ENSG00000142669;SH3BGRL3;1;26605667;26608007;2340;0
1675;ENSG00000142675;CNKSR1;1;26503894;26516377;12483;0
1676;ENSG00000142676;RPL11;1;24018269;24022915;4646;0
1677;ENSG00000142684;ZNF593;1;26496362;26498551;2189;0
1678;ENSG00000142686;C1orf216;1;36179476;36185073;5597;0
1679;ENSG00000142687;KIAA0319L;1;35899091;36023551;124460;0
1680;ENSG00000142694;EVA1B;1;36787632;36789755;2123;0
1681;ENSG00000142733;MAP3K6;1;27681675;27693383;11708;0
1682;ENSG00000142751;GPN2;1;27202624;27216788;14164;0
1683;ENSG00000142765;SYTL1;1;27668513;27680421;11908;0
1684;ENSG00000142784;WDTC1;1;27561007;27635110;74103;0
1685;ENSG00000142794;NBPF3;1;21766621;21811498;44877;0
1686;ENSG00000142798;HSPG2;1;22148738;22263790;115052;0
1687;ENSG00000142856;ITGB3BP;1;63906441;64059392;152951;0
1688;ENSG00000142864;SERBP1;1;67873493;67896098;22605;0
1689;ENSG00000142867;BCL10;1;85731931;85742773;10842;0
1690;ENSG00000142871;CYR61;1;86046444;86049645;3201;0
1691;ENSG00000142875;PRKACB;1;84543745;84704181;160436;0
1692;ENSG00000142892;PIGK;1;77554675;77685115;130440;0
1693;ENSG00000142920;ADC;1;33546705;33586131;39426;0
1694;ENSG00000142937;RPS8;1;45240923;45244451;3528;0
1695;ENSG00000142945;KIF2C;1;45205490;45233439;27949;1
1696;ENSG00000142949;PTPRF;1;43990858;44089343;98485;0
1697;ENSG00000142959;BEST4;1;45249257;45253377;4120;0
1698;ENSG00000142961;MOB3C;1;47073387;47082563;9176;0
1699;ENSG00000143013;LMO4;1;87794151;87814606;20455;0
1700;ENSG00000143028;SYPL2;1;110009180;110024759;15579;0
1701;ENSG00000143032;BARHL2;1;91177096;91182794;5698;0
1702;ENSG00000143033;MTF2;1;93544792;93604638;59846;0
1703;ENSG00000143036;SLC44A3;1;95285898;95360802;74904;0
1704;ENSG00000143061;IGSF3;1;117117031;117210375;93344;0
1705;ENSG00000143067;ZNF697;1;120162045;120190396;28351;0
1706;ENSG00000143079;CTTNBP2NL;1;112938803;113006078;67275;0
1707;ENSG00000143093;STRIP1;1;110574199;110617263;43064;0
1708;ENSG00000143106;PSMA5;1;109941653;109969062;27409;0
1709;ENSG00000143107;FNDC7;1;109255279;109285365;30086;0
1710;ENSG00000143110;C1orf162;1;112016414;112021134;4720;0
1711;ENSG00000143126;CELSR2;1;109792641;109818372;25731;0
1712;ENSG00000143127;ITGA10;1;145524891;145543868;18977;1
1713;ENSG00000143147;GPR161;1;168053997;168106821;52824;0
1714;ENSG00000143149;ALDH9A1;1;165631453;165668100;36647;0
1715;ENSG00000143153;ATP1B1;1;169074935;169101960;27025;0
1716;ENSG00000143155;TIPRL;1;168148171;168169950;21779;0
1717;ENSG00000143156;NME7;1;169101769;169337205;235436;0
1718;ENSG00000143157;POGK;1;166808681;166825581;16900;0
1719;ENSG00000143158;MPC2;1;167885967;167906278;20311;0
1720;ENSG00000143162;CREG1;1;167498914;167523004;24090;1
1721;ENSG00000143164;DCAF6;1;167905021;168045081;140060;0
1722;ENSG00000143167;GPA33;1;167022073;167059868;37795;0
1723;ENSG00000143171;RXRG;1;165370159;165414433;44274;0
1724;ENSG00000143178;TBX19;1;168250278;168283664;33386;0
1725;ENSG00000143179;UCK2;1;165796768;165880855;84087;0
1726;ENSG00000143183;TMCO1;1;165696032;165796992;100960;0
1727;ENSG00000143190;POU2F1;1;167190066;167396582;206516;0
1728;ENSG00000143194;MAEL;1;166958346;166991451;33105;0
1729;ENSG00000143195;ILDR2;1;166882443;166944719;62276;0
1730;ENSG00000143198;MGST3;1;165600098;165631033;30935;0
1731;ENSG00000143199;ADCY10;1;167778625;167883453;104828;0
1732;ENSG00000143207;RFWD2;1;175913967;176176629;262662;0
1733;ENSG00000143222;UFC1;1;161122566;161128646;6080;0
1734;ENSG00000143224;PPOX;1;161136200;161147803;11603;0
1735;ENSG00000143228;NUF2;1;163236366;163325554;89188;1
1736;ENSG00000143248;RGS5;1;163080911;163291577;210666;1
1737;ENSG00000143252;SDHC;1;161284047;161332984;48937;0
1738;ENSG00000143256;PFDN2;1;161070346;161087901;17555;0
1739;ENSG00000143258;USP21;1;161129240;161135513;6273;0
1740;ENSG00000143294;PRCC;1;156720402;156770607;50205;0
1741;ENSG00000143303;RRNAD1;1;156698234;156706752;8518;0
1742;ENSG00000143314;MRPL24;1;156707095;156711382;4287;0
1743;ENSG00000143315;PIGM;1;159997462;160001783;4321;0
1744;ENSG00000143318;CASQ1;1;160160285;160171676;11391;0
1745;ENSG00000143319;ISG20L2;1;156691683;156698591;6908;0
1746;ENSG00000143320;CRABP2;1;156669398;156675608;6210;0
1747;ENSG00000143321;HDGF;1;156711899;156736717;24818;0
1748;ENSG00000143322;ABL2;1;179068462;179198819;130357;0
1749;ENSG00000143324;XPR1;1;180601140;180859387;258247;0
1750;ENSG00000143333;RGS16;1;182567758;182573543;5785;0
1751;ENSG00000143337;TOR1AIP1;1;179851177;179894135;42958;0
1752;ENSG00000143340;FAM163A;1;179712298;179785333;73035;0
1753;ENSG00000143341;HMCN1;1;185703683;186160085;456402;0
1754;ENSG00000143344;RGL1;1;183605220;183897665;292445;0
1755;ENSG00000143353;LYPLAL1;1;219347186;219386207;39021;0
1756;ENSG00000143355;LHX9;1;197881037;197904608;23571;0
1757;ENSG00000143363;PRUNE;1;150980896;151008189;27293;0
1758;ENSG00000143365;RORC;1;151778547;151804348;25801;0
1759;ENSG00000143367;TUFT1;1;151512781;151556059;43278;0
1760;ENSG00000143368;SF3B4;1;149895209;149900236;5027;0
1761;ENSG00000143369;ECM1;1;150480538;150486265;5727;0
1762;ENSG00000143373;ZNF687;1;151254094;151264656;10562;0
1763;ENSG00000143374;TARS2;1;150459887;150480078;20191;0
1764;ENSG00000143375;CGN;1;151482986;151511168;28182;0
1765;ENSG00000143376;SNX27;1;151584541;151671567;87026;0
1766;ENSG00000143379;SETDB1;1;150898739;150937213;38474;0
1767;ENSG00000143382;ADAMTSL4;1;150521884;150533413;11529;0
1768;ENSG00000143384;MCL1;1;150547032;150552066;5034;0
1769;ENSG00000143387;CTSK;1;150768684;150780799;12115;0
1770;ENSG00000143390;RFX5;1;151313116;151319833;6717;0
1771;ENSG00000143393;PI4KB;1;151264273;151300191;35918;0
1772;ENSG00000143398;PIP5K1A;1;151170425;151222012;51587;0
1773;ENSG00000143401;ANP32E;1;150190717;150208504;17787;0
1774;ENSG00000143409;FAM63A;1;150969025;150980851;11826;0
1775;ENSG00000143412;ANXA9;1;150954493;150968110;13617;0
1776;ENSG00000143416;SELENBP1;1;151336778;151345209;8431;0
1777;ENSG00000143418;CERS2;1;150933059;150947479;14420;0
1778;ENSG00000143420;ENSA;1;150573327;150602088;28761;0
1779;ENSG00000143434;SEMA6C;1;151104161;151119104;14943;0
1780;ENSG00000143436;MRPL9;1;151732119;151736040;3921;0
1781;ENSG00000143437;ARNT;1;150782181;150849244;67063;0
1782;ENSG00000143442;POGZ;1;151375200;151431941;56741;0
1783;ENSG00000143443;C1orf56;1;151020216;151024462;4246;0
1784;ENSG00000143450;OAZ3;1;151735445;151743808;8363;0
1785;ENSG00000143452;HORMAD1;1;150670536;150693364;22828;0
1786;ENSG00000143457;GOLPH3L;1;150618701;150669630;50929;0
1787;ENSG00000143458;GABPB2;1;151043054;151098018;54964;0
1788;ENSG00000143466;IKBKE;1;206643791;206670223;26432;0
1789;ENSG00000143469;SYT14;1;210111538;210337636;226098;0
1790;ENSG00000143473;KCNH1;1;210856555;211307457;450902;0
1791;ENSG00000143476;DTL;1;212208919;212280742;71823;1
1792;ENSG00000143479;DYRK3;1;206808881;206857764;48883;0
1793;ENSG00000143486;EIF2D;1;206744620;206785904;41284;1
1794;ENSG00000143493;INTS7;1;212113741;212208884;95143;0
1795;ENSG00000143494;VASH2;1;213123862;213165379;41517;0
1796;ENSG00000143498;TAF1A;1;222731244;222763275;32031;0
1797;ENSG00000143499;SMYD2;1;214454445;214510474;56029;0
1798;ENSG00000143502;SUSD4;1;223394161;223537544;143383;0
1799;ENSG00000143507;DUSP10;1;221874766;221915518;40752;0
1800;ENSG00000143512;HHIPL2;1;222695602;222721445;25843;0
1801;ENSG00000143514;TP53BP2;1;223967601;224033674;66073;0
1802;ENSG00000143515;ATP8B2;1;154298029;154323783;25754;0
1803;ENSG00000143537;ADAM15;1;155023042;155035252;12210;0
1804;ENSG00000143543;JTB;1;153946745;153950164;3419;0
1805;ENSG00000143545;RAB13;1;153954127;153958834;4707;0
1806;ENSG00000143549;TPM3;1;154127784;154167124;39340;0
1807;ENSG00000143553;SNAPIN;1;153631130;153634306;3176;0
1808;ENSG00000143554;SLC27A3;1;153746830;153752633;5803;0
1809;ENSG00000143569;UBAP2L;1;154192655;154243986;51331;0
1810;ENSG00000143570;SLC39A1;1;153931575;153940188;8613;0
1811;ENSG00000143575;HAX1;1;154244987;154248351;3364;0
1812;ENSG00000143578;CREB3L4;1;153940010;153946839;6829;0
1813;ENSG00000143590;EFNA3;1;155036224;155060014;23790;0
1814;ENSG00000143603;KCNN3;1;154669931;154842756;172825;1
1815;ENSG00000143612;C1orf43;1;154179182;154193104;13922;0
1816;ENSG00000143614;GATAD2B;1;153777201;153895451;118250;0
1817;ENSG00000143621;ILF2;1;153634512;153643524;9012;0
1818;ENSG00000143622;RIT1;1;155867599;155881195;13596;0
1819;ENSG00000143624;INTS3;1;153700543;153746555;46012;0
1820;ENSG00000143630;HCN3;1;155247374;155259639;12265;0
1821;ENSG00000143632;ACTA1;1;229566992;229569845;2853;0
1822;ENSG00000143633;C1orf131;1;231359509;231376933;17424;0
1823;ENSG00000143641;GALNT2;1;230193536;230417870;224334;0
1824;ENSG00000143643;TTC13;1;231041989;231114621;72632;0
1825;ENSG00000143653;SCCPDH;1;246887349;246931439;44090;0
1826;ENSG00000143669;LYST;1;235824341;236046940;222599;0
1827;ENSG00000143674;;1;233463514;233520894;57380;0
1828;ENSG00000143702;CEP170;1;243287730;243418650;130920;0
1829;ENSG00000143740;SNAP47;1;227916240;227968927;52687;0
1830;ENSG00000143742;SRP9;1;225965531;225978168;12637;0
1831;ENSG00000143748;NVL;1;224415036;224518089;103053;0
1832;ENSG00000143751;SDE2;1;226170403;226187032;16629;0
1833;ENSG00000143753;DEGS1;1;224363458;224381143;17685;0
1834;ENSG00000143756;FBXO28;1;224301789;224349749;47960;0
1835;ENSG00000143761;ARF1;1;228270361;228286912;16551;0
1836;ENSG00000143771;CNIH4;1;224544552;224567161;22609;0
1837;ENSG00000143772;ITPKB;1;226819391;226927024;107633;0
1838;ENSG00000143774;GUK1;1;228327663;228336685;9022;0
1839;ENSG00000143776;CDC42BPA;1;227177566;227506175;328609;0
1840;ENSG00000143786;CNIH3;1;224622362;224928251;305889;0
1841;ENSG00000143793;C1orf35;1;228288427;228293112;4685;0
1842;ENSG00000143799;PARP1;1;226548392;226595780;47388;0
1843;ENSG00000143801;PSEN2;1;227057885;227083806;25921;0
1844;ENSG00000143811;PYCR2;1;226107578;226111978;4400;0
1845;ENSG00000143815;LBR;1;225589204;225616627;27423;0
1846;ENSG00000143816;WNT9A;1;228106357;228135599;29242;0
1847;ENSG00000143819;EPHX1;1;225997794;226033260;35466;0
1848;ENSG00000143842;SOX13;1;204042243;204096863;54620;0
1849;ENSG00000143845;ETNK2;1;204100190;204121307;21117;0
1850;ENSG00000143847;PPFIA4;1;202995626;203047868;52242;0
1851;ENSG00000143850;PLEKHA6;1;204187979;204346793;158814;0
1852;ENSG00000143858;SYT2;1;202559724;202679545;119821;0
1853;ENSG00000143862;ARL8A;1;202102532;202113869;11337;0
1854;ENSG00000146463;ZMYM4;1;35734568;35887659;153091;0
1855;ENSG00000146670;CDCA5;11;64833772;64851636;17864;0
1856;ENSG00000148426;PROSER2;10;11865338;11914276;48938;0
1857;ENSG00000148429;USP6NL;10;11495945;11653753;157808;0
1858;ENSG00000148444;COMMD3;10;22604903;22609235;4332;0
1859;ENSG00000148450;MSRB2;10;23384435;23410942;26507;0
1860;ENSG00000148459;PDSS1;10;26986588;27035727;49139;0
1861;ENSG00000148468;FAM171A1;10;15253642;15413061;159419;0
1862;ENSG00000148481;FAM188A;10;15820169;15902519;82350;0
1863;ENSG00000148484;RSU1;10;16632610;16859527;226917;0
1864;ENSG00000148488;ST8SIA6;10;17360382;17496329;135947;0
1865;ENSG00000148498;PARD3;10;34398488;35104253;705765;0
1866;ENSG00000148516;ZEB1;10;31607424;31818742;211318;0
1867;ENSG00000148541;FAM13C;10;61005890;61122939;117049;0
1868;ENSG00000148572;NRBF2;10;64893050;64914783;21733;0
1869;ENSG00000148600;CDHR1;10;85954410;85979377;24967;1
1870;ENSG00000148606;POLR3A;10;79734907;79789303;54396;0
1871;ENSG00000148634;HERC4;10;69681665;69835105;153440;0
1872;ENSG00000148660;CAMK2G;10;75572259;75634343;62084;0
1873;ENSG00000148672;GLUD1;10;88810243;88854623;44380;0
1874;ENSG00000148680;HTR7;10;92500578;92617671;117093;0
1875;ENSG00000148688;RPP30;10;92631473;92668312;36839;0
1876;ENSG00000148690;FRA10AC1;10;95427640;95462329;34689;0
1877;ENSG00000148700;ADD3;10;111756126;111895323;139197;0
1878;ENSG00000148719;DNAJB12;10;74092588;74114988;22400;0
1879;ENSG00000148730;EIF4EBP2;10;72164135;72188374;24239;0
1880;ENSG00000148734;NPFFR1;10;72007085;72043432;36347;0
1881;ENSG00000148737;TCF7L2;10;114710009;114927437;217428;0
1882;ENSG00000148773;MKI67;10;129894923;129924649;29726;1
1883;ENSG00000148798;INA;10;105036920;105050108;13188;0
1884;ENSG00000148803;FUOM;10;135168658;135171529;2871;0
1885;ENSG00000148814;LRRC27;10;134145614;134195010;49396;0
1886;ENSG00000148824;MTG1;10;135207598;135234811;27213;0
1887;ENSG00000148832;PAOX;10;135192695;135205198;12503;0
1888;ENSG00000148834;GSTO1;10;105995114;106027217;32103;0
1889;ENSG00000148835;TAF5;10;105127724;105148822;21098;0
1890;ENSG00000148840;PPRC1;10;103892787;103910082;17295;0
1891;ENSG00000148841;ITPRIP;10;106071894;106098162;26268;0
1892;ENSG00000148842;CNNM2;10;104678050;104849978;171928;0
1893;ENSG00000148843;PDCD11;10;105156405;105206049;49644;0
1894;ENSG00000148848;ADAM12;10;127700950;128077024;376074;0
1895;ENSG00000148925;BTBD10;11;13409548;13484844;75296;0
1896;ENSG00000148926;ADM;11;10326227;10328944;2717;0
1897;ENSG00000148935;GAS2;11;22647188;22834601;187413;0
1898;ENSG00000148942;SLC5A12;11;26688566;26744974;56408;0
1899;ENSG00000148943;LIN7C;11;27516123;27528320;12197;0
1900;ENSG00000148948;LRRC4C;11;40135753;41481323;1345570;0
1901;ENSG00000148950;IMMP1L;11;31453948;31531192;77244;0
1902;ENSG00000148985;PGAP2;11;3818954;3847601;28647;0
1903;ENSG00000149016;TUT1;11;62342517;62359649;17132;0
1904;ENSG00000149050;ZNF214;11;7020549;7041599;21050;0
1905;ENSG00000149054;ZNF215;11;6947635;7005863;58228;0
1906;ENSG00000149084;HSD17B12;11;43577986;43878167;300181;0
1907;ENSG00000149089;APIP;11;34874641;34938046;63405;0
1908;ENSG00000149090;PAMR1;11;35453370;35551848;98478;0
1909;ENSG00000149091;DGKZ;11;46354455;46402104;47649;0
1910;ENSG00000149100;EIF3M;11;32605344;32627808;22464;0
1911;ENSG00000149115;TNKS1BP1;11;57067112;57092426;25314;0
1912;ENSG00000149131;SERPING1;11;57364860;57382326;17466;0
1913;ENSG00000149136;SSRP1;11;57093459;57103351;9892;0
1914;ENSG00000149150;SLC43A1;11;57252007;57283259;31252;0
1915;ENSG00000149177;PTPRJ;11;48002113;48189670;187557;0
1916;ENSG00000149179;C11orf49;11;46958240;47185936;227696;0
1917;ENSG00000149182;ARFGAP2;11;47185848;47198676;12828;0
1918;ENSG00000149187;CELF1;11;47487496;47587121;99625;0
1919;ENSG00000149196;C11orf73;11;86013253;86056969;43716;0
1920;ENSG00000149201;CCDC81;11;86085778;86134151;48373;0
1921;ENSG00000149212;SESN3;11;94898704;94965705;67001;0
1922;ENSG00000149218;ENDOD1;11;94822974;94865809;42835;0
1923;ENSG00000149231;CCDC82;11;96085933;96123087;37154;0
1924;ENSG00000149243;KLHL35;11;75133438;75141674;8236;0
1925;ENSG00000149256;TENM4;11;78363876;79151992;788116;0
1926;ENSG00000149257;SERPINH1;11;75273101;75283828;10727;1
1927;ENSG00000149260;CAPN5;11;76777979;76837201;59222;0
1928;ENSG00000149262;INTS4;11;77589766;77705724;115958;0
1929;ENSG00000149269;PAK1;11;77032752;77185680;152928;0
1930;ENSG00000149273;RPS3;11;75110530;75133324;22794;0
1931;ENSG00000149289;ZC3H12C;11;109964087;110042566;78479;0
1932;ENSG00000149292;TTC12;11;113185251;113254266;69015;0
1933;ENSG00000149294;NCAM1;11;112831997;113149158;317161;0
1934;ENSG00000149295;DRD2;11;113280318;113346413;66095;0
1935;ENSG00000149308;NPAT;11;108027942;108093369;65427;0
1936;ENSG00000149311;ATM;11;108093211;108239829;146618;0
1937;ENSG00000149313;AASDHPPT;11;105946228;105969437;23209;0
1938;ENSG00000149328;GLB1L2;11;134201768;134248235;46467;0
1939;ENSG00000149357;LAMTOR1;11;71796941;71814433;17492;0
1940;ENSG00000149380;P4HA3;11;73946846;74022702;75856;0
1941;ENSG00000149403;GRIK4;11;120382468;120859613;477145;0
1942;ENSG00000149428;HYOU1;11;118914900;118927913;13013;0
1943;ENSG00000149476;DAK;11;61100682;61120767;20085;0
1944;ENSG00000149480;MTA2;11;62360686;62369312;8626;0
1945;ENSG00000149483;TMEM138;11;61129473;61136981;7508;0
1946;ENSG00000149485;FADS1;11;61567099;61596790;29691;0
1947;ENSG00000149489;ROM1;11;62379194;62382592;3398;0
1948;ENSG00000149499;EML3;11;62369690;62380237;10547;0
1949;ENSG00000149503;INCENP;11;61891445;61920635;29190;0
1950;ENSG00000149506;ZP1;11;60635035;60643166;8131;0
1951;ENSG00000149516;MS4A3;11;59824060;59838601;14541;1
1952;ENSG00000149527;PLCH2;1;2357419;2436969;79550;0
1953;ENSG00000149532;CPSF7;11;61170121;61197503;27382;0
1954;ENSG00000149541;B3GAT3;11;62382768;62389647;6879;0
1955;ENSG00000149547;EI24;11;125439112;125454575;15463;0
1956;ENSG00000149548;CCDC15;11;124824017;124911385;87368;0
1957;ENSG00000149554;CHEK1;11;125495036;125546150;51114;1
1958;ENSG00000149557;FEZ1;11;125315646;125366213;50567;0
1959;ENSG00000149564;ESAM;11;124622026;124632186;10160;0
1960;ENSG00000149571;KIRREL3;11;126293254;126873355;580101;0
1961;ENSG00000149575;SCN2B;11;118032666;118047388;14722;0
1962;ENSG00000149577;SIDT2;11;117049449;117068160;18711;0
1963;ENSG00000149582;TMEM25;11;118401756;118417995;16239;0
1964;ENSG00000149591;TAGLN;11;117070037;117075498;5461;1
1965;ENSG00000149716;ORAOV1;11;69467844;69490184;22340;0
1966;ENSG00000149743;TRPT1;11;63991271;63993726;2455;0
1967;ENSG00000149761;NUDT22;11;63993413;63998158;4745;0
1968;ENSG00000149781;FERMT3;11;63974150;63991354;17204;0
1969;ENSG00000149782;PLCB3;11;64018995;64036622;17627;0
1970;ENSG00000149792;MRPL49;11;64889655;64894843;5188;0
1971;ENSG00000149798;CDC42EP2;11;65082289;65089900;7611;0
1972;ENSG00000149806;FAU;11;64888100;64889945;1845;0
1973;ENSG00000149809;TM7SF2;11;64879317;64883856;4539;0
1974;ENSG00000149823;VPS51;11;64856796;64879332;22536;0
1975;ENSG00000149948;HMGA2;12;66217911;66360075;142164;0
1976;ENSG00000149972;CNTN5;11;98891683;100229616;1337933;0
1977;ENSG00000150051;MKX;10;27961804;28034989;73185;0
1978;ENSG00000150054;MPP7;10;28339922;28623415;283493;0
1979;ENSG00000150076;;10;32832297;33171802;339505;0
1980;ENSG00000150093;ITGB1;10;33189247;33294720;105473;0
1981;ENSG00000150244;TRIM48;11;55029658;55038595;8937;0
1982;ENSG00000150275;PCDH15;10;55562531;57387702;1825171;1
1983;ENSG00000150316;CWC15;11;94695787;94706776;10989;0
1984;ENSG00000150347;ARID5B;10;63661059;63856703;195644;0
1985;ENSG00000150433;TMEM218;11;124966398;124981659;15261;1
1986;ENSG00000150455;TIRAP;11;126152960;126168740;15780;0
1987;ENSG00000150456;N6AMT2;13;21302870;21348097;45227;0
1988;ENSG00000150457;LATS2;13;21547171;21635686;88515;0
1989;ENSG00000150459;SAP18;13;21714653;21723221;8568;0
1990;ENSG00000150510;FAM124A;13;51796503;51858377;61874;0
1991;ENSG00000150593;PDCD4;10;112631565;112659764;28199;0
1992;ENSG00000150594;ADRA2A;10;112836790;112840658;3868;0
1993;ENSG00000150672;DLG2;11;83166055;85338966;2172911;0
1994;ENSG00000150687;PRSS23;11;86502101;86663952;161851;0
1995;ENSG00000150760;DOCK1;10;128593978;129250781;656803;0
1996;ENSG00000150764;DIXDC1;11;111797868;111893308;95440;0
1997;ENSG00000150768;DLAT;11;111895538;111935114;39576;0
1998;ENSG00000150773;PIH1D2;11;111934734;111944998;10264;0
1999;ENSG00000150776;C11orf57;11;111944810;111955874;11064;0
2000;ENSG00000150779;TIMM8B;11;111955524;111957522;1998;0
2001;ENSG00000150787;PTS;11;112097088;112140678;43590;0
2002;ENSG00000150867;PIP4K2A;10;22823778;23003484;179706;0
2003;ENSG00000150893;FREM2;13;39261266;39460074;198808;0
2004;ENSG00000150907;FOXO1;13;41129804;41240734;110930;0
2005;ENSG00000150967;ABCB9;12;123405498;123466196;60698;0
2006;ENSG00000150977;RILPL2;12;123899936;123921264;21328;0
2007;ENSG00000150990;DHX37;12;125431371;125473668;42297;0
2008;ENSG00000150991;UBC;12;125396150;125401914;5764;0
2009;ENSG00000151023;ENKUR;10;25270908;25305089;34181;0
2010;ENSG00000151025;GPR158;10;25463991;25891155;427164;0
2011;ENSG00000151065;DCP1B;12;2055220;2113701;58481;0
2012;ENSG00000151067;CACNA1C;12;2079952;2802108;722156;0
2013;ENSG00000151079;KCNA6;12;4918342;4960277;41935;0
2014;ENSG00000151116;UEVLD;11;18551156;18610294;59138;0
2015;ENSG00000151117;TMEM86A;11;18714669;18726332;11663;0
2016;ENSG00000151131;C12orf45;12;105380088;105443515;63427;0
2017;ENSG00000151135;C12orf23;12;107349497;107372556;23059;0
2018;ENSG00000151136;BTBD11;12;107712190;108053419;341229;0
2019;ENSG00000151148;UBE3B;12;109915207;109974507;59300;0
2020;ENSG00000151150;ANK3;10;61786056;62493248;707192;0
2021;ENSG00000151151;IPMK;10;59951278;60027694;76416;0
2022;ENSG00000151164;RAD9B;12;110939460;110969891;30431;0
2023;ENSG00000151176;PLBD2;12;113796371;113827203;30832;0
2024;ENSG00000151208;DLG5;10;79550549;79686378;135829;0
2025;ENSG00000151229;SLC2A13;12;40148823;40499891;351068;0
2026;ENSG00000151233;GXYLT1;12;42475647;42538681;63034;0
2027;ENSG00000151239;TWF1;12;44187526;44200178;12652;0
2028;ENSG00000151240;DIP2C;10;320130;735683;415553;0
2029;ENSG00000151348;EXT2;11;44117099;44266979;149880;0
2030;ENSG00000151364;KCTD14;11;77726761;77757237;30476;0
2031;ENSG00000151366;NDUFC2;11;77779350;77791265;11915;0
2032;ENSG00000151376;ME3;11;86152150;86383678;231528;0
2033;ENSG00000151414;NEK7;1;198126093;198291550;165457;0
2034;ENSG00000151461;UPF2;10;11962021;12085169;123148;0
2035;ENSG00000151465;CDC123;10;12237964;12292588;54624;0
2036;ENSG00000151468;CCDC3;10;12938627;13141652;203025;0
2037;ENSG00000151474;FRMD4A;10;13685706;14504141;818435;0
2038;ENSG00000151490;PTPRO;12;15475331;15750333;275002;0
2039;ENSG00000151491;EPS8;12;15773092;16035263;262171;0
2040;ENSG00000151498;ACAD8;11;134123389;134135749;12360;0
2041;ENSG00000151500;THYN1;11;134118173;134123264;5091;0
2042;ENSG00000151502;VPS26B;11;134094539;134117686;23147;0
2043;ENSG00000151503;NCAPD3;11;134020014;134095348;75334;0
2044;ENSG00000151532;VTI1A;10;114206756;114578503;371747;0
2045;ENSG00000151553;FAM160B1;10;116581503;116659591;78088;0
2046;ENSG00000151572;ANO4;12;101111304;101522419;411115;0
2047;ENSG00000151632;AKR1C2;10;5029967;5060223;30256;0
2048;ENSG00000151640;DPYSL4;10;134000404;134019280;18876;0
2049;ENSG00000151651;ADAM8;10;135075907;135090372;14465;0
2050;ENSG00000151657;KIN;10;7792925;7829990;37065;0
2051;ENSG00000151743;AMN1;12;31824071;31882108;58037;0
2052;ENSG00000151746;BICD1;12;32259769;32536567;276798;0
2053;ENSG00000151773;CCDC122;13;44398045;44453827;55782;0
2054;ENSG00000151778;SERP2;13;44947801;44971850;24049;0
2055;ENSG00000151835;SACS;13;23902965;24007841;104876;0
2056;ENSG00000151849;CENPJ;13;25457171;25497018;39847;0
2057;ENSG00000151892;GFRA1;10;117816444;118032979;216535;0
2058;ENSG00000151893;CACUL1;10;120433679;120514761;81082;0
2059;ENSG00000151923;TIAL1;10;121334199;121356541;22342;0
2060;ENSG00000151929;BAG3;10;121410882;121437331;26449;0
2061;ENSG00000152022;LIX1L;1;145477085;145501669;24584;0
2062;ENSG00000152042;NBPF11;1;146032647;146082765;50118;0
2063;ENSG00000152061;RABGAP1L;1;174128548;174964445;835897;0
2064;ENSG00000152078;TMEM56;1;95582894;95663163;80269;0
2065;ENSG00000152092;ASTN1;1;176826438;177134109;307671;0
2066;ENSG00000152104;PTPN14;1;214522039;214725792;203753;0
2067;ENSG00000152207;CYSLTR2;13;49280951;49283498;2547;1
2068;ENSG00000152219;ARL14EP;11;30344598;30359774;15176;0
2069;ENSG00000152268;SPON1;11;13983914;14289646;305732;1
2070;ENSG00000152270;PDE3B;11;14665269;14892350;227081;0
2071;ENSG00000152332;UHMK1;1;162467041;162499419;32378;0
2072;ENSG00000152382;TADA1;1;166825747;166845564;19817;0
2073;ENSG00000152402;GUCY1A2;11;106544738;106889250;344512;0
2074;ENSG00000152404;CWF19L2;11;107197071;107328572;131501;0
2075;ENSG00000152455;SUV39H2;10;14920819;14946314;25495;0
2076;ENSG00000152457;DCLRE1C;10;14939358;14996431;57073;0
2077;ENSG00000152464;RPP38;10;15139179;15181817;42638;0
2078;ENSG00000152465;NMT2;10;15144583;15210692;66109;0
2079;ENSG00000152484;USP12;13;27640293;27746033;105740;0
2080;ENSG00000152487;ARL5B-AS1;10;18940195;18948214;8019;0
2081;ENSG00000152520;PAN3;13;28712643;28869475;156832;0
2082;ENSG00000152556;PFKM;12;48498922;48540187;41265;0
2083;ENSG00000152558;TMEM123;11;102267063;102341115;74052;0
2084;ENSG00000152578;GRIA4;11;105480721;105852819;372098;0
2085;ENSG00000152726;FAM21B;10;47894023;47949412;55389;0
2086;ENSG00000152760;TCTEX1D1;1;67218142;67244470;26328;0
2087;ENSG00000152763;WDR78;1;67278568;67390570;112002;0
2088;ENSG00000152778;IFIT5;10;91174343;91180758;6415;0
2089;ENSG00000152782;PANK1;10;91342745;91405215;62470;0
2090;ENSG00000152904;GGPS1;1;235490665;235507847;17182;0
2091;ENSG00000152936;IFLTD1;12;25562241;25801513;239272;0
2092;ENSG00000152944;MED21;12;27175479;27219276;43797;0
2093;ENSG00000153179;RASSF3;12;65004293;65091347;87054;0
2094;ENSG00000153187;HNRNPU;1;245014468;245027844;13376;1
2095;ENSG00000153207;AHCTF1;1;247002400;247095280;92880;0
2096;ENSG00000153233;PTPRR;12;71031853;71314623;282770;0
2097;ENSG00000153363;LINC00467;1;211556145;211605878;49733;0
2098;ENSG00000153904;DDAH1;1;85784164;86043933;259769;0
2099;ENSG00000153936;HS2ST1;1;87380331;87602334;222003;0
2100;ENSG00000154027;AK5;1;77747736;78025651;277915;0
2101;ENSG00000154096;THY1;11;119288090;119295695;7605;0
2102;ENSG00000154114;TBCEL;11;120894781;120961484;66703;0
2103;ENSG00000154127;UBASH3B;11;122526383;122685181;158798;0
2104;ENSG00000154134;ROBO3;11;124735282;124751366;16084;0
2105;ENSG00000154144;TBRG1;11;124492732;124505287;12555;0
2106;ENSG00000154146;NRGN;11;124609742;124617106;7364;0
2107;ENSG00000154222;CC2D1B;1;52811395;52831865;20470;0
2108;ENSG00000154305;MIA3;1;222791428;222841354;49926;0
2109;ENSG00000154309;DISP1;1;222988406;223179337;190931;0
2110;ENSG00000154358;OBSCN;1;228395831;228566577;170746;0
2111;ENSG00000154370;TRIM11;1;228581374;228594541;13167;0
2112;ENSG00000154380;ENAH;1;225674537;225840844;166307;0
2113;ENSG00000154429;CCSAP;1;229456758;229479041;22283;0
2114;ENSG00000154473;BUB3;10;124913793;124924886;11093;0
2115;ENSG00000154478;GPR26;10;125425871;125454123;28252;1
2116;ENSG00000154485;MMP21;10;127455022;127464390;9368;0
2117;ENSG00000154511;FAM69A;1;93307724;93427057;119333;0
2118;ENSG00000155229;MMS19;10;99218081;99258551;40470;0
2119;ENSG00000155252;PI4K2A;10;99344131;99436191;92060;0
2120;ENSG00000155254;MARVELD1;10;99472930;99477907;4977;0
2121;ENSG00000155256;ZFYVE27;10;99496878;99520664;23786;0
2122;ENSG00000155265;GOLGA7B;10;99609996;99631337;21341;0
2123;ENSG00000155287;SLC25A28;10;101370282;101380366;10084;0
2124;ENSG00000155363;MOV10;1;113215763;113243368;27605;0
2125;ENSG00000155366;RHOC;1;113243728;113250056;6328;0
2126;ENSG00000155367;PPM1J;1;113252616;113258099;5483;0
2127;ENSG00000155380;SLC16A1;1;113454469;113499635;45166;0
2128;ENSG00000155629;PIK3AP1;10;98353069;98480271;127202;0
2129;ENSG00000155640;C10orf12;10;98741041;98745582;4541;0
2130;ENSG00000155761;SPAG17;1;118496484;118727846;231362;0
2131;ENSG00000155816;FMN2;1;240177648;240638489;460841;0
2132;ENSG00000155957;TMBIM4;12;66517709;66563852;46143;0
2133;ENSG00000155974;GRIP1;12;66741211;67197966;456755;0
2134;ENSG00000155980;KIF5A;12;57943781;57980415;36634;0
2135;ENSG00000156026;MCU;10;74451889;74647452;195563;0
2136;ENSG00000156042;TTC18;10;75013517;75118617;105100;1
2137;ENSG00000156097;GPR61;1;110082494;110091028;8534;0
2138;ENSG00000156110;ADK;10;75910960;76469061;558101;0
2139;ENSG00000156113;KCNMA1;10;78629359;79398353;768994;0
2140;ENSG00000156171;DRAM2;1;111659955;111682838;22883;0
2141;ENSG00000156374;PCGF6;10;105062553;105110891;48338;0
2142;ENSG00000156384;SFR1;10;105881816;105886143;4327;0
2143;ENSG00000156395;SORCS3;10;106400859;107024993;624134;1
2144;ENSG00000156398;SFXN2;10;104474295;104503249;28954;1
2145;ENSG00000156502;SUPV3L1;10;70939988;70968855;28867;0
2146;ENSG00000156510;HKDC1;10;70980059;71027315;47256;1
2147;ENSG00000156515;HK1;10;71029740;71161638;131898;0
2148;ENSG00000156521;TYSND1;10;71897737;71906432;8695;0
2149;ENSG00000156587;UBE2L6;11;57319129;57335757;16628;0
2150;ENSG00000156599;ZDHHC5;11;57435219;57468659;33440;0
2151;ENSG00000156603;MED19;11;57471186;57479693;8507;0
2152;ENSG00000156650;KAT6B;10;76585340;76792380;207040;0
2153;ENSG00000156671;SAMD8;10;76859344;76941881;82537;0
2154;ENSG00000156689;GLYATL2;11;58601542;58671688;70146;0
2155;ENSG00000156869;FRRS1;1;100174259;100232187;57928;0
2156;ENSG00000156875;HIAT1;1;100503653;100548933;45280;0
2157;ENSG00000156876;SASS6;1;100549119;100598511;49392;0
2158;ENSG00000157064;NMNAT2;1;183217372;183387737;170365;0
2159;ENSG00000157077;ZFYVE9;1;52608046;52812358;204312;0
2160;ENSG00000157181;C1orf27;1;186344890;186390510;45620;0
2161;ENSG00000157184;CPT2;1;53662101;53679869;17768;0
2162;ENSG00000157191;NECAP2;1;16767167;16786573;19406;0
2163;ENSG00000157193;LRP8;1;53711217;53793742;82525;0
2164;ENSG00000157216;SSBP3;1;54691105;54879152;188047;0
2165;ENSG00000157330;C1orf158;1;12806163;12823847;17684;0
2166;ENSG00000157570;TSPAN18;11;44748015;44953972;205957;0
2167;ENSG00000157613;CREB3L1;11;46299212;46342972;43760;0
2168;ENSG00000157782;CABP1;12;121078355;121105127;26772;0
2169;ENSG00000157837;SPPL3;12;121200313;121342174;141861;0
2170;ENSG00000157870;FAM213B;1;2517930;2522908;4978;0
2171;ENSG00000157873;TNFRSF14;1;2487078;2496821;9743;0
2172;ENSG00000157881;PANK4;1;2439972;2458039;18067;0
2173;ENSG00000157895;C12orf43;12;121440225;121454305;14080;0
2174;ENSG00000157911;PEX10;1;2336236;2345236;9000;0
2175;ENSG00000157916;RER1;1;2323267;2336883;13616;0
2176;ENSG00000157933;SKI;1;2160134;2241558;81424;0
2177;ENSG00000157978;LDLRAP1;1;25870071;25895377;25306;0
2178;ENSG00000158006;PAFAH2;1;26286258;26324648;38390;0
2179;ENSG00000158008;EXTL1;1;26346375;26362955;16580;0
2180;ENSG00000158023;WDR66;12;122355768;122441833;86065;0
2181;ENSG00000158042;MRPL17;11;6702013;6704632;2619;0
2182;ENSG00000158062;UBXN11;1;26607819;26644854;37035;0
2183;ENSG00000158077;NLRP14;11;7041677;7092539;50862;0
2184;ENSG00000158109;TPRG1L;1;3541566;3546691;5125;0
2185;ENSG00000158113;LRRC43;12;122652285;122688018;35733;0
2186;ENSG00000158156;XKR8;1;28285973;28294607;8634;0
2187;ENSG00000158161;EYA3;1;28296855;28415207;118352;0
2188;ENSG00000158195;WASF2;1;27730730;27816669;85939;0
2189;ENSG00000158246;FAM46B;1;27331511;27339327;7816;0
2190;ENSG00000158286;RNF207;1;6265535;6281359;15824;0
2191;ENSG00000158292;GPR153;1;6307406;6321035;13629;0
2192;ENSG00000158483;FAM86C1;11;71498556;71512282;13726;0
2193;ENSG00000158555;GDPD5;11;75145685;75236948;91263;0
2194;ENSG00000158615;PPP1R15B;1;204372515;204380919;8404;0
2195;ENSG00000158636;C11orf30;11;76155967;76264069;108102;0
2196;ENSG00000158710;TAGLN2;1;159887897;159895522;7625;1
2197;ENSG00000158711;ELK4;1;205577071;205601090;24019;0
2198;ENSG00000158715;SLC45A3;1;205626979;205649587;22608;0
2199;ENSG00000158747;NBL1;1;19967048;19984945;17897;0
2200;ENSG00000158769;F11R;1;160965001;160991138;26137;0
2201;ENSG00000158773;USF1;1;161009041;161015767;6726;0
2202;ENSG00000158793;NIT1;1;161087876;161095235;7359;0
2203;ENSG00000158796;DEDD;1;161090764;161102478;11714;0
2204;ENSG00000158816;VWA5B1;1;20617412;20681387;63975;1
2205;ENSG00000158828;PINK1;1;20959948;20978004;18056;0
2206;ENSG00000158850;B4GALT3;1;161141100;161147287;6187;0
2207;ENSG00000158859;ADAMTS4;1;161154098;161168846;14748;0
2208;ENSG00000158864;NDUFS2;1;161166894;161184185;17291;0
2209;ENSG00000158882;TOMM40L;1;161195793;161200408;4615;0
2210;ENSG00000158966;CACHD1;1;64936428;65158741;222313;0
2211;ENSG00000159023;EPB41;1;29213603;29446553;232950;0
2212;ENSG00000159063;ALG8;11;77811982;77850706;38724;0
2213;ENSG00000159164;SV2A;1;149874870;149889434;14564;0
2214;ENSG00000159173;TNNI1;1;201373625;201398994;25369;0
2215;ENSG00000159176;CSRP1;1;201452658;201478584;25926;1
2216;ENSG00000159208;C1orf51;1;150254953;150259505;4552;0
2217;ENSG00000159214;CCDC24;1;44457031;44462200;5169;0
2218;ENSG00000159335;PTMS;12;6874682;6880116;5434;0
2219;ENSG00000159346;ADIPOR1;1;202909951;202927700;17749;0
2220;ENSG00000159348;CYB5R1;1;202930997;202936408;5411;0
2221;ENSG00000159352;PSMD4;1;151227179;151239955;12776;0
2222;ENSG00000159363;ATP13A2;1;17312453;17338423;25970;0
2223;ENSG00000159377;PSMB4;1;151372010;151374420;2410;0
2224;ENSG00000159388;BTG2;1;203274619;203278730;4111;1
2225;ENSG00000159403;C1R;12;7187513;7245203;57690;0
2226;ENSG00000159409;CELF3;1;151674880;151689290;14410;0
2227;ENSG00000159423;ALDH4A1;1;19197926;19229275;31349;0
2228;ENSG00000159445;THEM4;1;151846060;151882284;36224;0
2229;ENSG00000159450;TCHH;1;152078793;152086556;7763;1
2230;ENSG00000159479;MED8;1;43849588;43855479;5891;0
2231;ENSG00000159588;CCDC17;1;46085716;46089729;4013;0
2232;ENSG00000159592;GPBP1L1;1;46092976;46153785;60809;0
2233;ENSG00000159596;TMEM69;1;46152886;46160115;7229;0
2234;ENSG00000159658;EFCAB14;1;47124366;47184824;60458;0
2235;ENSG00000160049;DFFA;1;10516579;10532583;16004;0
2236;ENSG00000160050;CCDC28B;1;32665987;32670988;5001;0
2237;ENSG00000160051;IQCC;1;32671236;32674288;3052;0
2238;ENSG00000160055;TMEM234;1;32680073;32687972;7899;0
2239;ENSG00000160058;BSDC1;1;32830704;32860332;29628;0
2240;ENSG00000160062;ZBTB8A;1;33005028;33071540;66512;0
2241;ENSG00000160072;ATAD3B;1;1407143;1433228;26085;0
2242;ENSG00000160075;SSU72;1;1477053;1510249;33196;0
2243;ENSG00000160087;UBE2J2;1;1189289;1209265;19976;0
2244;ENSG00000160094;ZNF362;1;33722146;33766320;44174;0
2245;ENSG00000160097;FNDC5;1;33327869;33338083;10214;0
2246;ENSG00000160172;FAM86C2P;11;67559119;67572807;13688;0
2247;ENSG00000160584;SIK3;11;116714118;116969153;255035;0
2248;ENSG00000160588;MPZL3;11;118097409;118123065;25656;0
2249;ENSG00000160613;PCSK7;11;117075053;117103241;28188;0
2250;ENSG00000160679;CHTOP;1;153606525;153618782;12257;0
2251;ENSG00000160685;ZBTB7B;1;154975127;154990998;15871;0
2252;ENSG00000160688;FLAD1;1;154955814;154965587;9773;0
2253;ENSG00000160691;SHC1;1;154934774;154946871;12097;0
2254;ENSG00000160695;VPS11;11;118938403;118952688;14285;0
2255;ENSG00000160703;NLRX1;11;119037277;119054725;17448;0
2256;ENSG00000160710;ADAR;1;154554538;154600475;45937;0
2257;ENSG00000160712;IL6R;1;154377669;154441926;64257;0
2258;ENSG00000160714;UBE2Q1;1;154521053;154531504;10451;0
2259;ENSG00000160716;CHRNB2;1;154540257;154552502;12245;0
2260;ENSG00000160741;CRTC2;1;153920145;153931101;10956;0
2261;ENSG00000160752;FDPS;1;155278539;155290457;11918;0
2262;ENSG00000160753;RUSC1;1;155290687;155300905;10218;0
2263;ENSG00000160766;GBAP1;1;155183616;155197214;13598;0
2264;ENSG00000160767;FAM189B;1;155216996;155225274;8278;0
2265;ENSG00000160781;PAQR6;1;156213206;156217881;4675;0
2266;ENSG00000160783;PMF1;1;156182784;156212874;30090;0
2267;ENSG00000160785;SLC25A44;1;156163880;156182587;18707;0
2268;ENSG00000160789;LMNA;1;156052364;156109880;57516;0
2269;ENSG00000160803;UBQLN4;1;156005092;156023585;18493;0
2270;ENSG00000160818;GPATCH4;1;156564279;156571288;7009;0
2271;ENSG00000161328;LRRC56;11;537527;554916;17389;0
2272;ENSG00000161638;ITGA5;12;54789045;54813244;24199;1
2273;ENSG00000161642;ZNF385A;12;54762917;54785082;22165;0
2274;ENSG00000161791;FMNL3;12;50031724;50101948;70224;0
2275;ENSG00000161800;RACGAP1;12;50370706;50426919;56213;0
2276;ENSG00000161813;LARP4;12;50786166;50873787;87621;0
2277;ENSG00000161835;GRASP;12;52400724;52409673;8949;0
2278;ENSG00000162105;SHANK2;11;70313961;70963623;649662;0
2279;ENSG00000162129;CLPB;11;72003469;72145692;142223;0
2280;ENSG00000162139;NEU3;11;74699179;74729938;30759;0
2281;ENSG00000162144;CYB561A3;11;61116217;61129771;13554;0
2282;ENSG00000162148;PPP1R32;11;61248592;61258403;9811;0
2283;ENSG00000162174;ASRGL1;11;62104920;62160882;55962;0
2284;ENSG00000162188;GNG3;11;62475130;62476673;1543;0
2285;ENSG00000162191;UBXN1;11;62443970;62446567;2597;0
2286;ENSG00000162194;C11orf48;11;62430287;62439727;9440;0
2287;ENSG00000162222;TTC9C;11;62495541;62507765;12224;0
2288;ENSG00000162227;TAF6L;11;62538775;62554814;16039;0
2289;ENSG00000162231;NXF1;11;62559595;62573774;14179;0
2290;ENSG00000162236;STX5;11;62574369;62599560;25191;0
2291;ENSG00000162241;SLC25A45;11;65142663;65151172;8509;0
2292;ENSG00000162298;SYVN1;11;64889252;64902004;12752;0
2293;ENSG00000162300;ZFPL1;11;64851695;64855870;4175;0
2294;ENSG00000162302;RPS6KA4;11;64126620;64139687;13067;0
2295;ENSG00000162337;LRP5;11;68080077;68216743;136666;0
2296;ENSG00000162341;TPCN2;11;68816365;68858072;41707;0
2297;ENSG00000162368;CMPK1;1;47799469;47844511;45042;0
2298;ENSG00000162373;BEND5;1;49193195;49242641;49446;0
2299;ENSG00000162374;ELAVL4;1;50513686;50669458;155772;0
2300;ENSG00000162377;COA7;1;53152508;53164038;11530;0
2301;ENSG00000162378;ZYG11B;1;53192126;53293014;100888;0
2302;ENSG00000162384;C1orf123;1;53679771;53686289;6518;0
2303;ENSG00000162385;MAGOH;1;53692564;53704282;11718;0
2304;ENSG00000162396;PARS2;1;55222571;55230187;7616;0
2305;ENSG00000162402;USP24;1;55532032;55680786;148754;0
2306;ENSG00000162407;PPAP2B;1;56960419;57110974;150555;0
2307;ENSG00000162408;NOL9;1;6581407;6614595;33188;0
2308;ENSG00000162409;PRKAA2;1;57110995;57181008;70013;0
2309;ENSG00000162413;KLHL21;1;6650784;6674667;23883;0
2310;ENSG00000162415;ZSWIM5;1;45482071;45771881;289810;0
2311;ENSG00000162419;GMEB1;1;28995244;29045865;50621;0
2312;ENSG00000162426;SLC45A1;1;8377886;8404227;26341;0
2313;ENSG00000162430;SEPN1;1;26126667;26144713;18046;0
2314;ENSG00000162433;AK4;1;65613232;65697828;84596;0
2315;ENSG00000162434;JAK1;1;65298912;65432187;133275;0
2316;ENSG00000162437;RAVER2;1;65210778;65298915;88137;0
2317;ENSG00000162441;LZIC;1;9982173;10003465;21292;0
2318;ENSG00000162456;KNCN;1;47011316;47017199;5883;0
2319;ENSG00000162458;FBLIM1;1;16083102;16113089;29987;0
2320;ENSG00000162461;SLC25A34;1;16062900;16067891;4991;0
2321;ENSG00000162482;AKR7A3;1;19609052;19615744;6692;0
2322;ENSG00000162490;DRAXIN;1;11751786;11785914;34128;0
2323;ENSG00000162493;PDPN;1;13909960;13944452;34492;1
2324;ENSG00000162496;DHRS3;1;12627939;12677737;49798;0
2325;ENSG00000162510;MATN1;1;31184124;31196434;12310;0
2326;ENSG00000162512;SDC3;1;31342314;31381608;39294;0
2327;ENSG00000162517;PEF1;1;32095463;32110497;15034;0
2328;ENSG00000162520;SYNC;1;33145507;33169197;23690;1
2329;ENSG00000162521;RBBP4;1;33116743;33151812;35069;0
2330;ENSG00000162522;KIAA1522;1;33207486;33240571;33085;0
2331;ENSG00000162526;TSSK3;1;32817122;32829913;12791;0
2332;ENSG00000162543;UBXN10;1;20512578;20522541;9963;0
2333;ENSG00000162545;CAMK2N1;1;20808884;20812713;3829;0
2334;ENSG00000162551;ALPL;1;21835858;21904905;69047;0
2335;ENSG00000162552;WNT4;1;22443798;22470462;26664;0
2336;ENSG00000162572;SCNN1D;1;1215816;1227409;11593;0
2337;ENSG00000162576;MXRA8;1;1288069;1297157;9088;0
2338;ENSG00000162585;C1orf86;1;2115903;2144159;28256;0
2339;ENSG00000162591;MEGF6;1;3406484;3528059;121575;0
2340;ENSG00000162595;DIRAS3;1;68511645;68517314;5669;0
2341;ENSG00000162599;NFIA;1;61330931;61928465;597534;0
2342;ENSG00000162600;OMA1;1;58881056;59012474;131418;0
2343;ENSG00000162601;MYSM1;1;59120411;59165764;45353;0
2344;ENSG00000162604;TM2D1;1;62146718;62191095;44377;0
2345;ENSG00000162607;USP1;1;62901968;62917475;15507;0
2346;ENSG00000162613;FUBP1;1;78409740;78444794;35054;0
2347;ENSG00000162614;NEXN;1;78354198;78409580;55382;0
2348;ENSG00000162616;DNAJB4;1;78444859;78483648;38789;0
2349;ENSG00000162620;LRRIQ3;1;74491699;74663871;172172;0
2350;ENSG00000162623;TYW3;1;75198836;75232362;33526;0
2351;ENSG00000162627;SNX7;1;99127236;99226056;98820;0
2352;ENSG00000162630;B3GALT2;1;193148175;193155784;7609;0
2353;ENSG00000162631;NTNG1;1;107682629;108026080;343451;0
2354;ENSG00000162636;FAM102B;1;109102711;109187522;84811;0
2355;ENSG00000162639;HENMT1;1;109190912;109204148;13236;0
2356;ENSG00000162641;AKNAD1;1;109358520;109506106;147586;0
2357;ENSG00000162642;C1orf52;1;85715639;85725355;9716;0
2358;ENSG00000162643;WDR63;1;85464830;85598821;133991;1
2359;ENSG00000162650;ATXN7L2;1;110026101;110035426;9325;0
2360;ENSG00000162664;ZNF326;1;90460671;90501090;40419;0
2361;ENSG00000162669;HFM1;1;91726323;91870426;144103;0
2362;ENSG00000162670;BRINP3;1;190066792;190446759;379967;0
2363;ENSG00000162676;GFI1;1;92940319;92952433;12114;0
2364;ENSG00000162687;KCNT2;1;196194909;196578355;383446;0
2365;ENSG00000162688;AGL;1;100315640;100389579;73939;0
2366;ENSG00000162692;VCAM1;1;101185298;101204601;19303;1
2367;ENSG00000162694;EXTL2;1;101337943;101361554;23611;0
2368;ENSG00000162695;SLC30A7;1;101361632;101447309;85677;0
2369;ENSG00000162702;ZNF281;1;200374068;200379184;5116;0
2370;ENSG00000162704;ARPC5;1;183592401;183604892;12491;0
2371;ENSG00000162706;CADM3;1;159141399;159173103;31704;0
2372;ENSG00000162711;NLRP3;1;247579458;247612410;32952;0
2373;ENSG00000162714;ZNF496;1;247460714;247495148;34434;0
2374;ENSG00000162722;TRIM58;1;248020501;248041507;21006;0
2375;ENSG00000162728;KCNJ9;1;160051360;160060353;8993;0
2376;ENSG00000162729;IGSF8;1;160061130;160068733;7603;0
2377;ENSG00000162733;DDR2;1;162601163;162757190;156027;1
2378;ENSG00000162734;PEA15;1;160175127;160185166;10039;0
2379;ENSG00000162735;PEX19;1;160246602;160256138;9536;0
2380;ENSG00000162736;NCSTN;1;160313062;160328742;15680;0
2381;ENSG00000162738;VANGL2;1;160370376;160398468;28092;0
2382;ENSG00000162745;OLFML2B;1;161952982;161993644;40662;1
2383;ENSG00000162746;FCRLB;1;161691353;161697933;6580;0
2384;ENSG00000162753;SLC9C2;1;173469603;173572233;102630;1
2385;ENSG00000162755;KLHDC9;1;161068151;161070136;1985;0
2386;ENSG00000162757;C1orf74;1;209955661;209957904;2243;0
2387;ENSG00000162769;FLVCR1;1;213031597;213072705;41108;0
2388;ENSG00000162772;ATF3;1;212738676;212794119;55443;1
2389;ENSG00000162775;RBM15;1;110881128;110889299;8171;0
2390;ENSG00000162783;IER5;1;181057638;181059977;2339;0
2391;ENSG00000162813;BPNT1;1;220230824;220263804;32980;0
2392;ENSG00000162814;SPATA17;1;217804666;218045038;240372;0
2393;ENSG00000162817;C1orf115;1;220863187;220872499;9312;0
2394;ENSG00000162819;BROX;1;222885895;222908538;22643;0
2395;ENSG00000162836;ACP6;1;147101453;147142618;41165;0
2396;ENSG00000162849;KIF26B;1;245318287;245872733;554446;0
2397;ENSG00000162851;TFB2M;1;246703862;246729626;25764;0
2398;ENSG00000162852;CNST;1;246729746;246831886;102140;0
2399;ENSG00000162873;KLHDC8A;1;205305220;205326218;20998;0
2400;ENSG00000162885;B3GALNT2;1;235613238;235667781;54543;0
2401;ENSG00000162889;MAPKAPK2;1;206858289;206907628;49339;0
2402;ENSG00000162909;CAPN2;1;223889295;223963720;74425;0
2403;ENSG00000162910;MRPL55;1;228294380;228297013;2633;0
2404;ENSG00000162913;C1orf145;1;228391207;228401365;10158;0
2405;ENSG00000162923;WDR26;1;224572845;224624735;51890;0
2406;ENSG00000162931;TRIM17;1;228595641;228604562;8921;0
2407;ENSG00000162946;DISC1;1;231762561;232177018;414457;1
2408;ENSG00000163041;H3F3A;1;226249552;226259702;10150;0
2409;ENSG00000163050;ADCK3;1;227085237;227175246;90009;0
2410;ENSG00000163113;OTUD7B;1;149909705;149982625;72920;0
2411;ENSG00000163125;RPRD2;1;150335567;150449042;113475;0
2412;ENSG00000163131;CTSS;1;150702672;150738433;35761;0
2413;ENSG00000163141;BNIPL;1;151009046;151020076;11030;0
2414;ENSG00000163155;LYSMD1;1;151132224;151138424;6200;0
2415;ENSG00000163156;SCNM1;1;151129140;151142773;13633;0
2416;ENSG00000163159;VPS72;1;151142463;151167797;25334;0
2417;ENSG00000163344;PMVK;1;154897210;154909467;12257;0
2418;ENSG00000163346;PBXIP1;1;154916552;154928599;12047;0
2419;ENSG00000163348;PYGO2;1;154929502;154936329;6827;0
2420;ENSG00000163349;HIPK1;1;114471814;114520426;48612;0
2421;ENSG00000163354;DCST2;1;154990996;155006257;15261;0
2422;ENSG00000163362;C1orf106;1;200860176;200884863;24687;0
2423;ENSG00000163374;YY1AP1;1;155629237;155658791;29554;0
2424;ENSG00000163382;APOA1BP;1;156561554;156564091;2537;0
2425;ENSG00000163386;NBPF10;1;145289772;145370303;80531;0
2426;ENSG00000163393;SLC22A15;1;116519119;116612675;93556;0
2427;ENSG00000163399;ATP1A1;1;116915290;116952883;37593;0
2428;ENSG00000163435;ELF3;1;201977073;201986316;9243;0
2429;ENSG00000163444;TMEM183A;1;202976514;202993976;17462;0
2430;ENSG00000163462;TRIM46;1;155145873;155157447;11574;0
2431;ENSG00000163463;KRTCAP2;1;155141884;155145951;4067;0
2432;ENSG00000163468;CCT3;1;156278759;156337664;58905;0
2433;ENSG00000163472;TMEM79;1;156252726;156262976;10250;0
2434;ENSG00000163479;SSR2;1;155978839;155990750;11911;0
2435;ENSG00000163485;ADORA1;1;203059782;203136533;76751;0
2436;ENSG00000163486;SRGAP2;1;206516200;206637783;121583;0
2437;ENSG00000163531;NFASC;1;204797779;204991950;194171;0
2438;ENSG00000163545;NUAK2;1;205271187;205290883;19696;0
2439;ENSG00000163565;IFI16;1;158969758;159024945;55187;1
2440;ENSG00000163568;AIM2;1;159032274;159116886;84612;0
2441;ENSG00000163866;SMIM12;1;35178338;35325417;147079;0
2442;ENSG00000163867;ZMYM6;1;35449523;35497569;48046;0
2443;ENSG00000163873;GRIK3;1;37261128;37499730;238602;0
2444;ENSG00000163874;ZC3H12A;1;37940153;37949980;9827;0
2445;ENSG00000163875;MEAF6;1;37958176;37980375;22199;0
2446;ENSG00000163877;SNIP1;1;38000050;38019903;19853;0
2447;ENSG00000163879;DNALI1;1;38022520;38032458;9938;0
2448;ENSG00000163909;HEYL;1;40089825;40105617;15792;0
2449;ENSG00000164002;EXO5;1;40974413;40982228;7815;0
2450;ENSG00000164008;C1orf50;1;43232940;43263968;31028;0
2451;ENSG00000164010;ERMAP;1;43282795;43310660;27865;0
2452;ENSG00000164011;ZNF691;1;43312280;43318148;5868;0
2453;ENSG00000164845;FAM86FP;12;8385108;8395544;10436;0
2454;ENSG00000165309;ARMC3;10;23216953;23326518;109565;0
2455;ENSG00000165312;OTUD1;10;23728198;23731308;3110;0
2456;ENSG00000165322;ARHGAP12;10;32094365;32217742;123377;0
2457;ENSG00000165323;FAT3;11;92085262;92629618;544356;0
2458;ENSG00000165338;HECTD2;10;93170096;93274586;104490;0
2459;ENSG00000165388;ZNF488;10;48355024;48373866;18842;1
2460;ENSG00000165406;08-Mar;10;45950035;46090354;140319;0
2461;ENSG00000165416;SUGT1;13;53226844;53275044;48200;0
2462;ENSG00000165424;ZCCHC24;10;81142081;81205383;63302;0
2463;ENSG00000165434;PGM2L1;11;74041363;74109518;68155;0
2464;ENSG00000165443;PHYHIPL;10;60936350;61007534;71184;0
2465;ENSG00000165449;SLC16A9;10;61410523;61495760;85237;1
2466;ENSG00000165458;INPPL1;11;71934745;71950149;15404;0
2467;ENSG00000165475;CRYL1;13;20977806;21099996;122190;0
2468;ENSG00000165476;REEP3;10;65281123;65384883;103760;0
2469;ENSG00000165478;HEPACAM;11;124789089;124806308;17219;0
2470;ENSG00000165480;SKA3;13;21727734;21750741;23007;1
2471;ENSG00000165487;MICU2;13;22066836;22178353;111517;0
2472;ENSG00000165490;C11orf82;11;82611017;82669319;58302;0
2473;ENSG00000165494;PCF11;11;82868030;82898493;30463;0
2474;ENSG00000165495;PKNOX2;11;125034583;125303285;268702;0
2475;ENSG00000165507;C10orf10;10;45466429;45474258;7829;0
2476;ENSG00000165511;C10orf25;10;45493146;45496336;3190;0
2477;ENSG00000165512;ZNF22;10;45495923;45500774;4851;0
2478;ENSG00000165526;RPUSD4;11;126071993;126081587;9594;0
2479;ENSG00000165566;AMER2;13;25735822;25746426;10604;0
2480;ENSG00000165568;AKR1E2;10;4828821;4890254;61433;0
2481;ENSG00000165572;KBTBD6;13;41701705;41706882;5177;0
2482;ENSG00000165609;NUDT5;10;12207324;12238143;30819;0
2483;ENSG00000165626;BEND7;10;13480484;13570974;90490;0
2484;ENSG00000165629;ATP5C1;10;7830092;7849778;19686;0
2485;ENSG00000165630;PRPF18;10;13628927;13672868;43941;0
2486;ENSG00000165632;TAF3;10;7860467;8058590;198123;0
2487;ENSG00000165633;VSTM4;10;50222290;50323554;101264;0
2488;ENSG00000165637;VDAC2;10;76969912;76991206;21294;0
2489;ENSG00000165644;COMTD1;10;76993727;76995788;2061;0
2490;ENSG00000165646;SLC18A2;10;119000604;119038941;38337;0
2491;ENSG00000165650;PDZD8;10;119040000;119134978;94978;0
2492;ENSG00000165655;ZNF503;10;77157588;77161664;4076;0
2493;ENSG00000165660;FAM175B;10;126490354;126525239;34885;0
2494;ENSG00000165669;FAM204A;10;120065401;120101840;36439;0
2495;ENSG00000165672;PRDX3;10;120927215;120938345;11130;0
2496;ENSG00000165678;GHITM;10;85899196;85913001;13805;0
2497;ENSG00000165714;LOH12CR1;12;12510013;12619840;109827;0
2498;ENSG00000165730;STOX1;10;70587298;70655188;67890;0
2499;ENSG00000165731;RET;10;43572475;43625799;53324;0
2500;ENSG00000165732;DDX21;10;70715884;70744829;28945;0
2501;ENSG00000165733;BMS1;10;43278249;43330385;52136;0
2502;ENSG00000165752;STK32C;10;134020996;134145351;124355;0
2503;ENSG00000165757;KIAA1462;10;30301729;30404423;102694;0
2504;ENSG00000165805;C12orf50;12;88373816;88427814;53998;1
2505;ENSG00000165806;CASP7;10;115438942;115490662;51720;1
2506;ENSG00000165813;C10orf118;10;115880621;115933979;53358;0
2507;ENSG00000165832;TRUB1;10;116697952;116737430;39478;0
2508;ENSG00000165868;HSPA12A;10;118430703;118502085;71382;0
2509;ENSG00000165879;FRAT1;10;99079022;99081672;2650;0
2510;ENSG00000165886;UBTD1;10;99258625;99330966;72341;0
2511;ENSG00000165891;E2F7;12;77415027;77459360;44333;1
2512;ENSG00000165895;ARHGAP42;11;100558384;100862668;304284;0
2513;ENSG00000165899;OTOGL;12;80603233;80772870;169637;1
2514;ENSG00000165912;PACSIN3;11;47199076;47207994;8918;0
2515;ENSG00000165915;SLC39A13;11;47428683;47438047;9364;0
2516;ENSG00000165916;PSMC3;11;47440320;47447993;7673;0
2517;ENSG00000165935;SMCO2;12;27619743;27655118;35375;0
2518;ENSG00000165966;PDZRN4;12;41582250;41968392;386142;0
2519;ENSG00000165970;SLC6A5;11;20620946;20680831;59885;1
2520;ENSG00000165973;NELL1;11;20691117;21597227;906110;1
2521;ENSG00000165983;PTER;10;16478942;16555736;76794;0
2522;ENSG00000165995;CACNB2;10;18429606;18830798;401192;0
2523;ENSG00000165996;PTPLA;10;17631958;17659376;27418;0
2524;ENSG00000165997;ARL5B;10;18948334;18970568;22234;0
2525;ENSG00000166002;SMCO4;11;93211638;93276674;65036;0
2526;ENSG00000166004;KIAA1731;11;93394805;93463522;68717;0
2527;ENSG00000166006;KCNC2;12;75433857;75603648;169791;0
2528;ENSG00000166012;TAF1D;11;93463114;93517557;54443;0
2529;ENSG00000166016;ABTB2;11;34172535;34379555;207020;0
2530;ENSG00000166024;R3HCC1L;10;99894387;100004654;110267;0
2531;ENSG00000166025;AMOTL1;11;94439597;94609918;170321;0
2532;ENSG00000166033;HTRA1;10;124221041;124274424;53383;1
2533;ENSG00000166037;CEP57;11;95523129;95565857;42728;0
2534;ENSG00000166046;TCP11L2;12;106695707;106740793;45086;0
2535;ENSG00000166086;JAM3;11;133938820;134021896;83076;0
2536;ENSG00000166105;GLB1L3;11;134144139;134189458;45319;0
2537;ENSG00000166106;ADAMTS15;11;130318869;130346532;27663;0
2538;ENSG00000166111;SVOP;12;109304658;109459045;154387;0
2539;ENSG00000166130;IKBIP;12;99007183;99038891;31708;0
2540;ENSG00000166135;HIF1AN;10;102288829;102319755;30926;0
2541;ENSG00000166136;NDUFB8;10;102267203;102289757;22554;0
2542;ENSG00000166153;DEPDC4;12;100597447;100660857;63410;0
2543;ENSG00000166159;LRTM2;12;1929433;1945918;16485;0
2544;ENSG00000166167;BTRC;10;103113820;103317078;203258;0
2545;ENSG00000166169;POLL;10;103338639;103348027;9388;0
2546;ENSG00000166171;DPCD;10;103330317;103369425;39108;0
2547;ENSG00000166181;API5;11;43333513;43366079;32566;0
2548;ENSG00000166189;HPS6;10;103825147;103827792;2645;0
2549;ENSG00000166197;NOLC1;10;103911933;103923627;11694;0
2550;ENSG00000166199;ALKBH3;11;43902361;43941816;39455;0
2551;ENSG00000166224;SGPL1;10;72575717;72640930;65213;0
2552;ENSG00000166225;FRS2;12;69864129;69973562;109433;0
2553;ENSG00000166226;CCT2;12;69979114;69995350;16236;0
2554;ENSG00000166228;PCBD1;10;72642037;72648541;6504;0
2555;ENSG00000166250;CLMP;11;122943035;123065989;122954;0
2556;ENSG00000166257;SCN3B;11;123499895;123525952;26057;0
2557;ENSG00000166261;ZNF202;11;123594885;123612383;17498;0
2558;ENSG00000166266;CUL5;11;107879459;107978503;99044;0
2559;ENSG00000166272;WBP1L;10;104503727;104576021;72294;0
2560;ENSG00000166275;C10orf32;10;104613980;104624718;10738;0
2561;ENSG00000166295;ANAPC16;10;73975787;73995618;19831;0
2562;ENSG00000166311;SMPD1;11;6411655;6416228;4573;0
2563;ENSG00000166313;APBB1;11;6416355;6440644;24289;0
2564;ENSG00000166321;NUDT13;10;74870217;74891586;21369;0
2565;ENSG00000166323;C11orf65;11;108179246;108338258;159012;0
2566;ENSG00000166326;TRIM44;11;35684353;35829775;145422;0
2567;ENSG00000166333;ILK;11;6624961;6632102;7141;0
2568;ENSG00000166337;TAF10;11;6627526;6633898;6372;0
2569;ENSG00000166340;TPP1;11;6634000;6640692;6692;0
2570;ENSG00000166341;DCHS1;11;6642556;6677085;34529;0
2571;ENSG00000166343;MSS51;10;75183339;75193319;9980;1
2572;ENSG00000166348;USP54;10;75257296;75385711;128415;0
2573;ENSG00000166349;RAG1;11;36532259;36614706;82447;0
2574;ENSG00000166352;C11orf74;11;36616051;36694823;78772;0
2575;ENSG00000166387;PPFIBP2;11;7534529;7678358;143829;0
2576;ENSG00000166402;TUB;11;8040791;8127659;86868;0
2577;ENSG00000166405;RIC3;11;8127597;8190602;63005;0
2578;ENSG00000166407;LMO1;11;8245851;8290263;44412;0
2579;ENSG00000166435;XRRA1;11;74518784;74660245;141461;0
2580;ENSG00000166436;TRIM66;11;8633584;8693413;59829;0
2581;ENSG00000166439;RNF169;11;74459913;74553458;93545;0
2582;ENSG00000166441;RPL27A;11;8703958;8736306;32348;0
2583;ENSG00000166444;ST5;11;8714898;8932498;217600;0
2584;ENSG00000166452;AKIP1;11;8932686;8941631;8945;0
2585;ENSG00000166471;TMEM41B;11;9302201;9336327;34126;0
2586;ENSG00000166478;ZNF143;11;9481866;9550071;68205;0
2587;ENSG00000166483;WEE1;11;9595228;9615004;19776;0
2588;ENSG00000166507;NDST2;10;75561669;75571589;9920;0
2589;ENSG00000166532;RIMKLB;12;8834196;8935691;101495;0
2590;ENSG00000166575;TMEM135;11;86748886;87034800;285914;0
2591;ENSG00000166578;IQCD;12;113633246;113658899;25653;0
2592;ENSG00000166598;HSP90B1;12;104323885;104347423;23538;0
2593;ENSG00000166670;MMP10;11;102641234;102651359;10125;0
2594;ENSG00000166682;TMPRSS5;11;113558272;113577095;18823;0
2595;ENSG00000166689;PLEKHA7;11;16799842;17035990;236148;0
2596;ENSG00000166788;SAAL1;11;18091482;18127638;36156;0
2597;ENSG00000166793;YPEL4;11;57412560;57417417;4857;0
2598;ENSG00000166801;FAM111A;11;58910221;58922512;12291;0
2599;ENSG00000166833;NAV2;11;19372271;20143144;770873;0
2600;ENSG00000166840;GLYATL1;11;58672871;58811000;138129;0
2601;ENSG00000166860;ZBTB39;12;57392618;57400230;7612;0
2602;ENSG00000166863;TAC3;12;57403784;57422667;18883;0
2603;ENSG00000166881;TMEM194A;12;57449426;57481846;32420;0
2604;ENSG00000166886;NAB2;12;57482677;57489259;6582;0
2605;ENSG00000166888;STAT6;12;57489191;57525922;36731;0
2606;ENSG00000166889;PATL1;11;59404189;59436453;32264;0
2607;ENSG00000166896;XRCC6BP1;12;58335324;58351052;15728;0
2608;ENSG00000166900;STX3;11;59480929;59573354;92425;0
2609;ENSG00000166902;MRPL16;11;59573608;59578345;4737;0
2610;ENSG00000166908;PIP4K2C;12;57984957;57997198;12241;0
2611;ENSG00000166986;MARS;12;57869228;57911352;42124;0
2612;ENSG00000166987;MBD6;12;57914493;57923931;9438;0
2613;ENSG00000167244;IGF2;11;2150342;2170833;20491;0
2614;ENSG00000167257;RNF214;11;117103341;117157161;53820;0
2615;ENSG00000167272;POP5;12;121016567;121019201;2634;0
2616;ENSG00000167283;ATP5L;11;118271869;118302211;30342;0
2617;ENSG00000167323;STIM1;11;3875757;4114439;238682;0
2618;ENSG00000167325;RRM1;11;4115937;4160106;44169;0
2619;ENSG00000167332;OR51E2;11;4701401;4719084;17683;0
2620;ENSG00000167333;TRIM68;11;4619902;4629489;9587;0
2621;ENSG00000167528;ZNF641;12;48733791;48745197;11406;0
2622;ENSG00000167535;CACNB3;12;49207577;49222724;15147;0
2623;ENSG00000167548;KMT2D;12;49412758;49453557;40799;0
2624;ENSG00000167550;RHEBL1;12;49458468;49463808;5340;0
2625;ENSG00000167552;TUBA1A;12;49578579;49583107;4528;0
2626;ENSG00000167553;TUBA1C;12;49582519;49667114;84595;0
2627;ENSG00000167566;NCKAP5L;12;50184929;50222533;37604;0
2628;ENSG00000167588;GPD1;12;50497602;50505102;7500;0
2629;ENSG00000167770;OTUB1;11;63753325;63769283;15958;0
2630;ENSG00000167771;RCOR2;11;63678693;63684316;5623;0
2631;ENSG00000167778;SPRYD3;12;53458388;53473204;14816;0
2632;ENSG00000167779;IGFBP6;12;53491220;53496129;4909;0
2633;ENSG00000167792;NDUFV1;11;67374323;67380006;5683;0
2634;ENSG00000167797;CDK2AP2;11;67273968;67276120;2152;0
2635;ENSG00000167799;NUDT8;11;67395409;67397401;1992;0
2636;ENSG00000167985;SDHAF2;11;61197514;61215001;17487;0
2637;ENSG00000167986;DDB1;11;61066923;61110068;43145;0
2638;ENSG00000167987;VPS37C;11;60897728;60929089;31361;0
2639;ENSG00000167992;VWCE;11;61025762;61062896;37134;0
2640;ENSG00000167994;RAB3IL1;11;61664773;61687741;22968;0
2641;ENSG00000167995;BEST1;11;61717293;61732987;15694;0
2642;ENSG00000167996;FTH1;11;61727190;61735132;7942;0
2643;ENSG00000168000;BSCL2;11;62457747;62477317;19570;0
2644;ENSG00000168002;POLR2G;11;62529016;62534182;5166;0
2645;ENSG00000168003;SLC3A2;11;62623518;62656352;32834;0
2646;ENSG00000168004;HRASLS5;11;63228876;63258666;29790;0
2647;ENSG00000168005;C11orf84;11;63580860;63595190;14330;0
2648;ENSG00000168010;ATG16L2;11;72525353;72554719;29366;0
2649;ENSG00000168014;C2CD3;11;73723763;73882255;158492;0
2650;ENSG00000168040;FADD;11;70049269;70053496;4227;0
2651;ENSG00000168056;LTBP3;11;65306276;65326401;20125;0
2652;ENSG00000168061;SAC3D1;11;64808373;64812300;3927;0
2653;ENSG00000168066;SF1;11;64532078;64546258;14180;0
2654;ENSG00000168067;MAP4K2;11;64556290;64570713;14423;0
2655;ENSG00000168071;CCDC88B;11;64107695;64125006;17311;0
2656;ENSG00000168092;PAFAH1B2;11;117014983;117047610;32627;0
2657;ENSG00000168118;RAB4A;1;229406822;229441641;34819;0
2658;ENSG00000168159;RNF187;1;228674762;228683467;8705;0
2659;ENSG00000168209;DDIT4;10;74033678;74035794;2116;0
2660;ENSG00000168243;GNG4;1;235710987;235814054;103067;0
2661;ENSG00000168264;IRF2BP2;1;234740015;234745271;5256;0
2662;ENSG00000168267;PTF1A;10;23481256;23483181;1925;0
2663;ENSG00000168275;COA6;1;234509202;234519795;10593;0
2664;ENSG00000168283;BMI1;10;22610140;22620413;10273;0
2665;ENSG00000168389;MFSD2A;1;40420802;40435638;14836;0
2666;ENSG00000168439;STIP1;11;63952744;63972015;19271;0
2667;ENSG00000168496;FEN1;11;61560109;61564716;4607;0
2668;ENSG00000168528;SERINC2;1;31882412;31907525;25113;0
2669;ENSG00000168569;TMEM223;11;62539101;62559493;20392;0
2670;ENSG00000168614;NBPF9;1;144811744;144830413;18669;0
2671;ENSG00000168653;NDUFS5;1;39491990;39500308;8318;0
2672;ENSG00000168679;SLC16A4;1;110905470;110933704;28234;0
2673;ENSG00000168710;AHCYL1;1;110527308;110566357;39049;0
2674;ENSG00000168765;GSTM4;1;110198703;110208118;9415;0
2675;ENSG00000168778;TCTN2;12;124155660;124192948;37288;0
2676;ENSG00000168852;TPTE2P5;13;41396432;41495890;99458;0
2677;ENSG00000168876;ANKRD49;11;94226795;94232749;5954;0
2678;ENSG00000168959;GRM5;11;88237744;88799113;561369;0
2679;ENSG00000169126;ARMC4;10;28064115;28287977;223862;0
2680;ENSG00000169129;AFAP1L2;10;116054583;116164515;109932;0
2681;ENSG00000169174;PCSK9;1;55505221;55530525;25304;0
2682;ENSG00000169213;RAB3B;1;52373628;52456436;82808;0
2683;ENSG00000169218;RSPO1;1;38076951;38100595;23644;1
2684;ENSG00000169231;THBS3;1;155165379;155178842;13463;0
2685;ENSG00000169241;SLC50A1;1;155107820;155111329;3509;0
2686;ENSG00000169242;EFNA1;1;155099936;155107333;7397;0
2687;ENSG00000169372;CRADD;12;94071151;94288616;217465;0
2688;ENSG00000169403;PTAFR;1;28473677;28520447;46770;0
2689;ENSG00000169418;NPR1;1;153651113;153666468;15355;0
2690;ENSG00000169504;CLIC4;1;25071848;25170815;98967;0
2691;ENSG00000169519;METTL15;11;28129795;28355054;225259;0
2692;ENSG00000169598;DFFB;1;3773845;3801993;28148;0
2693;ENSG00000169641;LUZP1;1;23410516;23504301;93785;0
2694;ENSG00000169740;ZNF32;10;44139307;44144304;4997;0
2695;ENSG00000169813;HNRNPF;10;43881065;43904614;23549;1
2696;ENSG00000169826;CSGALNACT2;10;43633934;43680756;46822;0
2697;ENSG00000169840;GSX1;13;28366780;28368905;2125;0
2698;ENSG00000169884;WNT10B;12;49359123;49365546;6423;0
2699;ENSG00000169905;TOR1AIP2;1;179809102;179846938;37836;0
2700;ENSG00000169914;OTUD3;1;20209006;20239438;30432;0
2701;ENSG00000169962;TAS1R3;1;1266694;1270686;3992;0
2702;ENSG00000169972;PUSL1;1;1243947;1247057;3110;0
2703;ENSG00000169991;IFFO2;1;19230775;19283180;52405;0
2704;ENSG00000170075;GPR37L1;1;202091986;202102720;10734;0
2705;ENSG00000170145;SIK2;11;111473115;111601577;128462;0
2706;ENSG00000170242;USP47;11;11862970;11980870;117900;0
2707;ENSG00000170312;CDK1;10;62538089;62554610;16521;1
2708;ENSG00000170322;NFRKB;11;129733531;129765485;31954;0
2709;ENSG00000170325;PRDM10;11;129769601;129872730;103129;0
2710;ENSG00000170382;LRRN2;1;204586298;204654861;68563;0
2711;ENSG00000170385;SLC30A1;1;211744910;211752084;7174;0
2712;ENSG00000170426;SDR9C7;12;57316938;57328189;11251;0
2713;ENSG00000170430;MGMT;10;131265448;131566271;300823;0
2714;ENSG00000170456;DENND5B;12;31535157;31744031;208874;0
2715;ENSG00000170473;WIBG;12;56295197;56326402;31205;0
2716;ENSG00000170515;PA2G4;12;56498103;56507691;9588;0
2717;ENSG00000170525;PFKFB3;10;6186881;6277495;90614;1
2718;ENSG00000170545;SMAGP;12;51638342;51664674;26332;0
2719;ENSG00000170581;STAT2;12;56735381;56753939;18558;0
2720;ENSG00000170633;RNF34;12;121837844;121868389;30545;0
2721;ENSG00000170647;TMEM133;11;100862811;100864663;1852;0
2722;ENSG00000170653;ATF7;12;53901640;54020199;118559;0
2723;ENSG00000170743;SYT9;11;7260009;7490273;230264;0
2724;ENSG00000170759;KIF5B;10;32297938;32345359;47421;0
2725;ENSG00000170855;TRIAP1;12;120881764;120884215;2451;0
2726;ENSG00000170903;MSANTD4;11;105866350;105893130;26780;0
2727;ENSG00000170919;TPT1-AS1;13;45915480;45965872;50392;0
2728;ENSG00000170946;DNAJC24;11;31391387;31453396;62009;0
2729;ENSG00000170959;DCDC1;11;30851916;31391357;539441;0
2730;ENSG00000170962;PDGFD;11;103777914;104035107;257193;0
2731;ENSG00000170989;S1PR1;1;101702444;101707074;4630;0
2732;ENSG00000171067;C11orf24;11;68028803;68039469;10666;0
2733;ENSG00000171160;MORN4;10;99374310;99393344;19034;0
2734;ENSG00000171161;ZNF672;1;249132409;249143716;11307;0
2735;ENSG00000171163;ZNF692;1;249144205;249153343;9138;0
2736;ENSG00000171202;TMEM126A;11;85359011;85367591;8580;0
2737;ENSG00000171204;TMEM126B;11;85339629;85347580;7951;0
2738;ENSG00000171206;TRIM8;10;104404253;104418164;13911;0
2739;ENSG00000171219;CDC42BPG;11;64590859;64612041;21182;0
2740;ENSG00000171224;C10orf35;10;71390007;71393352;3345;0
2741;ENSG00000171307;ZDHHC16;10;99205927;99217127;11200;0
2742;ENSG00000171310;CHST11;12;104849073;105155792;306719;0
2743;ENSG00000171311;EXOSC1;10;99195899;99205774;9875;0
2744;ENSG00000171314;PGAM1;10;99185917;99193198;7281;0
2745;ENSG00000171357;LURAP1;1;46669006;46686933;17927;0
2746;ENSG00000171385;KCND3;1;112313284;112531777;218493;0
2747;ENSG00000171435;KSR2;12;117890817;118406788;515971;0
2748;ENSG00000171471;MAP1LC3B2;12;116997186;117014425;17239;0
2749;ENSG00000171488;LRRC8C;1;90098631;90235462;136831;0
2750;ENSG00000171492;LRRC8D;1;90286573;90402170;115597;0
2751;ENSG00000171502;COL24A1;1;86194916;86622626;427710;1
2752;ENSG00000171533;MAP6;11;75297963;75380165;82202;0
2753;ENSG00000171603;CLSTN1;1;9789084;9884584;95500;0
2754;ENSG00000171608;PIK3CD;1;9711790;9789172;77382;0
2755;ENSG00000171612;SLC25A33;1;9599541;9645237;45696;1
2756;ENSG00000171621;SPSB1;1;9352939;9429591;76652;0
2757;ENSG00000171680;PLEKHG5;1;6526152;6580121;53969;0
2758;ENSG00000171681;ATF7IP;12;14518610;14651697;133087;0
2759;ENSG00000171714;ANO5;11;22214722;22304903;90181;0
2760;ENSG00000171729;TMEM51;1;15479028;15546976;67948;0
2761;ENSG00000171735;CAMTA1;1;6845384;7829766;984382;0
2762;ENSG00000171759;PAH;12;103230663;103352188;121525;0
2763;ENSG00000171786;NHLH1;1;160336857;160342638;5781;0
2764;ENSG00000171790;SLFNL1;1;41481269;41488909;7640;0
2765;ENSG00000171792;RHNO1;12;2985424;2998626;13202;0
2766;ENSG00000171793;CTPS1;1;41445007;41478235;33228;1
2767;ENSG00000171798;KNDC1;10;134973951;135039916;65965;0
2768;ENSG00000171806;METTL18;1;169761670;169764107;2437;0
2769;ENSG00000171811;TTC40;10;134621896;134756327;134431;0
2770;ENSG00000171812;COL8A2;1;36560837;36590821;29984;0
2771;ENSG00000171813;PWWP2B;10;134210672;134231367;20695;0
2772;ENSG00000171823;FBXL14;12;1675159;1703331;28172;0
2773;ENSG00000171824;EXOSC10;1;11126675;11159938;33263;0
2774;ENSG00000171862;PTEN;10;89622870;89731687;108817;0
2775;ENSG00000171943;SRGAP2C;1;121107124;121129949;22825;0
2776;ENSG00000171960;PPIH;1;43124096;43142429;18333;0
2777;ENSG00000171988;JMJD1C;10;64926981;65225722;298741;0
2778;ENSG00000172031;EPHX4;1;92495539;92529093;33554;0
2779;ENSG00000172247;C1QTNF4;11;47611216;47616211;4995;0
2780;ENSG00000172260;NEGR1;1;71861623;72748417;886794;0
2781;ENSG00000172269;DPAGT1;11;118967213;118979041;11828;0
2782;ENSG00000172273;HINFP;11;118992297;119006752;14455;0
2783;ENSG00000172339;ALG14;1;95439963;95538501;98538;0
2784;ENSG00000172350;ABCG4;11;119019722;119033360;13638;0
2785;ENSG00000172375;C2CD2L;11;118972908;118989252;16344;0
2786;ENSG00000172380;GNG12;1;68167149;68299150;132001;0
2787;ENSG00000172409;CLP1;11;57416465;57429340;12875;0
2788;ENSG00000172410;INSL5;1;67263424;67266939;3515;0
2789;ENSG00000172456;FGGY;1;59762310;60233347;471037;0
2790;ENSG00000172458;IL17D;13;21276266;21297237;20971;0
2791;ENSG00000172500;FIBP;11;65651212;65656010;4798;0
2792;ENSG00000172508;CARNS1;11;67182439;67193078;10639;0
2793;ENSG00000172531;PPP1CA;11;67165654;67188654;23000;0
2794;ENSG00000172572;PDE3A;12;20522179;20837315;315136;0
2795;ENSG00000172586;CHCHD1;10;75541805;75543410;1605;0
2796;ENSG00000172602;RND1;12;49250928;49259681;8753;0
2797;ENSG00000172613;RAD9A;11;67159176;67165881;6705;0
2798;ENSG00000172638;EFEMP2;11;65633912;65641063;7151;0
2799;ENSG00000172661;FAM21C;10;46222648;46288409;65761;0
2800;ENSG00000172663;TMEM134;11;67231824;67236743;4919;0
2801;ENSG00000172671;ZFAND4;10;46111043;46168228;57185;0
2802;ENSG00000172725;CORO1B;11;67205519;67211292;5773;0
2803;ENSG00000172731;LRRC20;10;72058729;72142382;83653;0
2804;ENSG00000172732;MUS81;11;65624597;65635124;10527;0
2805;ENSG00000172757;CFL1;11;65590493;65629497;39004;0
2806;ENSG00000172766;NAA16;13;41885341;41951166;65825;0
2807;ENSG00000172803;SNX32;11;65601112;65624367;23255;1
2808;ENSG00000172819;RARG;12;53604354;53626764;22410;0
2809;ENSG00000172830;SSH3;11;67070919;67080078;9159;0
2810;ENSG00000172890;NADSYN1;11;71164155;71235153;70998;0
2811;ENSG00000172893;DHCR7;11;71139239;71163914;24675;0
2812;ENSG00000172915;NBEA;13;35516424;36247159;730735;0
2813;ENSG00000172922;RNASEH2C;11;65482367;65488418;6051;0
2814;ENSG00000172932;ANKRD13D;11;67056018;67069956;13938;0
2815;ENSG00000172977;KAT5;11;65479467;65487075;7608;0
2816;ENSG00000173020;ADRBK1;11;67033881;67054027;20146;0
2817;ENSG00000173039;RELA;11;65421067;65430565;9498;0
2818;ENSG00000173064;HECTD4;12;112597992;112819896;221904;0
2819;ENSG00000173088;C10orf131;10;97667360;97698480;31120;0
2820;ENSG00000173110;HSPA6;1;161494036;161496681;2645;1
2821;ENSG00000173113;TRMT112;11;64083932;64085556;1624;0
2822;ENSG00000173120;KDM2A;11;66886740;67025558;138818;0
2823;ENSG00000173141;MRP63;13;21750784;21753223;2439;0
2824;ENSG00000173145;NOC3L;10;96075004;96122716;47712;0
2825;ENSG00000173153;ESRRA;11;64073044;64084215;11171;0
2826;ENSG00000173157;ADAMTS20;12;43747669;43945724;198055;0
2827;ENSG00000173171;MTX1;1;155178490;155183615;5125;0
2828;ENSG00000173207;CKS1B;1;154947129;154951725;4596;0
2829;ENSG00000173208;ABCD2;12;39943835;40013553;69718;0
2830;ENSG00000173212;MAB21L3;1;116654376;116677861;23485;0
2831;ENSG00000173218;VANGL1;1;116184574;116240845;56271;0
2832;ENSG00000173227;SYT12;11;66774249;66818334;44085;0
2833;ENSG00000173264;GPR137;11;64037534;64056972;19438;0
2834;ENSG00000173267;SNCG;10;88718375;88723017;4642;0
2835;ENSG00000173269;MMRN2;10;88695297;88729238;33941;1
2836;ENSG00000173327;MAP3K11;11;65365226;65382853;17627;0
2837;ENSG00000173338;KCNK7;11;65360326;65363467;3141;0
2838;ENSG00000173406;DAB1;1;57460451;59012406;1551955;0
2839;ENSG00000173409;ARV1;1;231114727;231136341;21614;0
2840;ENSG00000173436;MINOS1;1;19923477;19956314;32837;0
2841;ENSG00000173442;EHBP1L1;11;65343509;65360121;16612;0
2842;ENSG00000173451;THAP2;12;72056789;72074419;17630;0
2843;ENSG00000173456;RNF26;11;119205237;119208023;2786;0
2844;ENSG00000173457;PPP1R14B;11;64011956;64014413;2457;0
2845;ENSG00000173465;SSSCA1;11;65337901;65341413;3512;0
2846;ENSG00000173486;FKBP2;11;64008475;64011604;3129;0
2847;ENSG00000173511;VEGFB;11;64002010;64006259;4249;0
2848;ENSG00000173588;CCDC41;12;94700225;94853764;153539;0
2849;ENSG00000173598;NUDT4;12;93771659;93797024;25365;0
2850;ENSG00000173599;PC;11;66615704;66725847;110143;0
2851;ENSG00000173614;NMNAT1;1;10003486;10045559;42073;0
2852;ENSG00000173621;LRFN4;11;66624118;66627946;3828;0
2853;ENSG00000173653;RCE1;11;66610306;66614017;3711;0
2854;ENSG00000173660;UQCRH;1;46769303;46782448;13145;0
2855;ENSG00000173673;HES3;1;6304252;6305638;1386;0
2856;ENSG00000173715;C11orf80;11;66511922;66610987;99065;0
2857;ENSG00000173726;TOMM20;1;235272651;235292251;19600;0
2858;ENSG00000173825;TIGD3;11;65122238;65125084;2846;0
2859;ENSG00000173846;PLK3;1;45265897;45271662;5765;0
2860;ENSG00000173848;NET1;10;5454514;5500426;45912;1
2861;ENSG00000173876;TUBB8;10;92828;120103;27275;0
2862;ENSG00000173898;SPTBN2;11;66452719;66496697;43978;0
2863;ENSG00000173914;RBM4B;11;66432469;66445392;12923;0
2864;ENSG00000173915;USMG5;10;105148798;105156223;7425;0
2865;ENSG00000173933;RBM4;11;66384097;66434153;50056;0
2866;ENSG00000173947;PIFO;1;111888910;111895635;6725;0
2867;ENSG00000173988;LRRC63;13;46786083;46851501;65418;0
2868;ENSG00000173992;CCS;11;66360292;66373490;13198;0
2869;ENSG00000174021;GNG5;1;84964008;84972248;8240;0
2870;ENSG00000174032;SLC25A30;13;45967451;45992590;25139;0
2871;ENSG00000174080;CTSF;11;66330934;66336312;5378;0
2872;ENSG00000174099;MSRB3;12;65672423;65882024;209601;0
2873;ENSG00000174106;LEMD3;12;65563351;65642107;78756;0
2874;ENSG00000174151;CYB561D1;1;110036674;110045554;8880;0
2875;ENSG00000174165;ZDHHC24;11;66288108;66313709;25601;0
2876;ENSG00000174194;AGAP8;10;51224681;51371321;146640;0
2877;ENSG00000174206;C12orf66;12;64580096;64616076;35980;0
2878;ENSG00000174233;ADCY6;12;49159975;49182820;22845;0
2879;ENSG00000174236;REP15;12;27849428;27850566;1138;0
2880;ENSG00000174243;DDX23;12;49223547;49246625;23078;0
2881;ENSG00000174276;ZNHIT2;11;64883875;64885170;1295;0
2882;ENSG00000174307;PHLDA3;1;201434620;201438365;3745;0
2883;ENSG00000174332;GLIS1;1;53971910;54199877;227967;0
2884;ENSG00000174348;PODN;1;53527854;53551174;23320;0
2885;ENSG00000174370;C11orf45;11;128769460;128775930;6470;0
2886;ENSG00000174371;EXO1;1;242011269;242058450;47181;1
2887;ENSG00000174437;ATP2A2;12;110718561;110788898;70337;0
2888;ENSG00000174456;C12orf76;12;110465872;110511491;45619;0
2889;ENSG00000174483;BBS1;11;66278077;66301098;23021;0
2890;ENSG00000174502;SLC26A9;1;205882176;205912588;30412;0
2891;ENSG00000174514;MFSD4;1;205538013;205572046;34033;0
2892;ENSG00000174516;PELI3;11;66234216;66244808;10592;0
2893;ENSG00000174529;TMEM81;1;205052258;205053645;1387;0
2894;ENSG00000174547;MRPL11;11;66202546;66234209;31663;0
2895;ENSG00000174567;GOLT1A;1;204167288;204183220;15932;0
2896;ENSG00000174574;AKIRIN1;1;39456895;39471731;14836;0
2897;ENSG00000174576;NPAS4;11;66188475;66194178;5703;1
2898;ENSG00000174606;ANGEL2;1;213165524;213189168;23644;0
2899;ENSG00000174669;SLC29A2;11;66129992;66139685;9693;0
2900;ENSG00000174672;BRSK2;11;1411129;1483919;72790;0
2901;ENSG00000174684;B3GNT1;11;66112843;66115163;2320;0
2902;ENSG00000174718;KIAA1551;12;32112304;32146039;33735;0
2903;ENSG00000174721;FGFBP3;10;93666346;93669240;2894;0
2904;ENSG00000174744;BRMS1;11;66104804;66112596;7792;0
2905;ENSG00000174775;HRAS;11;532242;537287;5045;0
2906;ENSG00000174791;RIN1;11;66097713;66104311;6598;0
2907;ENSG00000174804;FZD4;11;86656721;86666433;9712;1
2908;ENSG00000174827;PDZK1;1;145726918;145764074;37156;0
2909;ENSG00000174842;GLMN;1;92711959;92764544;52585;0
2910;ENSG00000174851;YIF1A;11;66052051;66056641;4590;0
2911;ENSG00000174871;CNIH2;11;66045661;66052772;7111;0
2912;ENSG00000174903;RAB1B;11;66036004;66044963;8959;0
2913;ENSG00000174915;PTDSS2;11;448268;491393;43125;0
2914;ENSG00000174989;FBXW8;12;117348761;117468953;120192;0
2915;ENSG00000174996;KLC2;11;66024765;66035331;10566;0
2916;ENSG00000175029;CTBP2;10;126676421;126849739;173318;0
2917;ENSG00000175087;PDIK1L;1;26437664;26452034;14370;0
2918;ENSG00000175104;TRAF6;11;36508577;36531822;23245;0
2919;ENSG00000175115;PACS1;11;65837834;66012218;174384;0
2920;ENSG00000175130;MARCKSL1;1;32799433;32801980;2547;0
2921;ENSG00000175137;SH3BP5L;1;249104648;249120832;16184;0
2922;ENSG00000175147;TMEM51-AS1;1;15442448;15478960;36512;0
2923;ENSG00000175183;CSRP2;12;77252495;77272840;20345;1
2924;ENSG00000175189;INHBC;12;57828543;57844611;16068;0
2925;ENSG00000175197;DDIT3;12;57910371;57914300;3929;0
2926;ENSG00000175203;DCTN2;12;57923885;57941114;17229;0
2927;ENSG00000175206;NPPA;1;11905766;11908402;2636;0
2928;ENSG00000175213;ZNF408;11;46722368;46727462;5094;0
2929;ENSG00000175215;CTDSP2;12;58213710;58240522;26812;0
2930;ENSG00000175216;CKAP5;11;46764598;46867847;103249;0
2931;ENSG00000175220;ARHGAP1;11;46698630;46722165;23535;0
2932;ENSG00000175224;ATG13;11;46638826;46696368;57542;0
2933;ENSG00000175229;GAL3ST3;11;65809423;65816651;7228;0
2934;ENSG00000175264;CHST1;11;45670427;45687172;16745;0
2935;ENSG00000175274;TP53I11;11;44907454;44972840;65386;0
2936;ENSG00000175279;APITD1;1;10490159;10512210;22051;0
2937;ENSG00000175334;BANF1;11;65769550;65771620;2070;0
2938;ENSG00000175348;TMEM9B;11;8968841;8986558;17717;0
2939;ENSG00000175352;NRIP3;11;9002123;9025596;23473;0
2940;ENSG00000175356;SCUBE2;11;9041071;9159661;118590;0
2941;ENSG00000175376;EIF1AD;11;65764016;65769647;5631;0
2942;ENSG00000175390;EIF3F;11;7991798;8023409;31611;0
2943;ENSG00000175395;ZNF25;10;38238500;38265561;27061;0
2944;ENSG00000175467;SART1;11;65729160;65747299;18139;0
2945;ENSG00000175470;PPP2R2D;10;133747955;133773331;25376;0
2946;ENSG00000175482;POLD4;11;67118248;67124443;6195;0
2947;ENSG00000175505;CLCF1;11;67131639;67141648;10009;0
2948;ENSG00000175513;TSGA10IP;11;65712916;65727434;14518;0
2949;ENSG00000175518;UBQLNL;11;5535623;5537935;2312;0
2950;ENSG00000175536;LIPT2;11;74202757;74204778;2021;0
2951;ENSG00000175548;ALG10B;12;38710380;38717784;7404;0
2952;ENSG00000175550;DRAP1;11;65686728;65689032;2304;0
2953;ENSG00000175564;UCP3;11;73711326;73720480;9154;0
2954;ENSG00000175567;UCP2;11;73685712;73694352;8640;0
2955;ENSG00000175573;C11orf68;11;65684279;65686588;2309;0
2956;ENSG00000175575;PAAF1;11;73587744;73638790;51046;0
2957;ENSG00000175581;MRPL48;11;73498361;73576178;77817;0
2958;ENSG00000175582;RAB6A;11;73386683;73472182;85499;0
2959;ENSG00000175602;CCDC85B;11;65657875;65659105;1230;0
2960;ENSG00000175634;RPS6KB2;11;67195931;67202872;6941;0
2961;ENSG00000175727;MLXIP;12;122516628;122631894;115266;0
2962;ENSG00000175756;AURKAIP1;1;1309110;1310875;1765;0
2963;ENSG00000175782;SLC35E3;12;69139886;69187508;47622;0
2964;ENSG00000175868;CALCB;11;14926543;15103888;177345;0
2965;ENSG00000175899;A2M;12;9220260;9268825;48565;1
2966;ENSG00000175970;UNC119B;12;121148238;121161443;13205;0
2967;ENSG00000175984;DENND2C;1;115125469;115213043;87574;0
2968;ENSG00000176022;B3GALT6;1;1167629;1170421;2792;0
2969;ENSG00000176092;AIM1L;1;26648350;26680621;32271;0
2970;ENSG00000176102;CSTF3;11;33098734;33183917;85183;0
2971;ENSG00000176124;DLEU1;13;50656307;51297372;641065;0
2972;ENSG00000176148;TCP11L1;11;33060963;33127489;66526;0
2973;ENSG00000176171;BNIP3;10;133781578;133795435;13857;0
2974;ENSG00000176236;C10orf111;10;15137384;15139318;1934;0
2975;ENSG00000176244;ACBD7;10;15119522;15130775;11253;0
2976;ENSG00000176261;ZBTB8OS;1;33065773;33116504;50731;0
2977;ENSG00000176268;CYCSP34;13;41437735;41438038;303;0
2978;ENSG00000176273;SLC35G1;10;95653730;95715819;62089;0
2979;ENSG00000176340;COX8A;11;63742079;63744015;1936;0
2980;ENSG00000176383;B3GNT4;12;122688090;122693499;5409;0
2981;ENSG00000176393;RNPEP;1;201951500;201975275;23775;0
2982;ENSG00000176422;SPRYD4;12;56862301;56864763;2462;0
2983;ENSG00000176444;CLK2;1;155232659;155248282;15623;0
2984;ENSG00000176485;PLA2G16;11;63340667;63384355;43688;0
2985;ENSG00000176697;BDNF;11;27676440;27743605;67165;0
2986;ENSG00000176834;VSIG10;12;118501398;118573831;72433;0
2987;ENSG00000176871;WSB2;12;118470712;118500235;29523;0
2988;ENSG00000176894;PXMP2;12;133264192;133297276;33084;0
2989;ENSG00000176915;ANKLE2;12;133302254;133338474;36220;0
2990;ENSG00000176971;FIBIN;11;27015628;27018630;3002;0
2991;ENSG00000176973;FAM89B;11;65339820;65341669;1849;0
2992;ENSG00000176986;SEC24C;10;75504120;75531919;27799;0
2993;ENSG00000177000;MTHFR;1;11845780;11866977;21197;0
2994;ENSG00000177030;DEAF1;11;644233;706715;62482;0
2995;ENSG00000177042;TMEM80;11;695428;705028;9600;0
2996;ENSG00000177054;ZDHHC13;11;19138646;19197969;59323;0
2997;ENSG00000177084;POLE;12;133200348;133263951;63603;0
2998;ENSG00000177098;SCN4B;11;118004092;118023603;19511;1
2999;ENSG00000177103;DSCAML1;11;117298489;117688240;389751;0
3000;ENSG00000177105;RHOG;11;3848208;3862213;14005;0
3001;ENSG00000177106;EPS8L2;11;694438;727727;33289;0
3002;ENSG00000177112;MRVI1-AS1;11;10562819;10621479;58660;0
3003;ENSG00000177119;ANO6;12;45609770;45834187;224417;0
3004;ENSG00000177133;LINC00982;1;2976179;2985001;8822;1
3005;ENSG00000177156;TALDO1;11;747329;765024;17695;0
3006;ENSG00000177169;ULK1;12;132379196;132407712;28516;0
3007;ENSG00000177181;RIMKLA;1;42846466;42888249;41783;0
3008;ENSG00000177192;PUS1;12;132413745;132428406;14661;0
3009;ENSG00000177225;PDDC1;11;767220;777488;10268;0
3010;ENSG00000177236;;11;780117;780755;638;0
3011;ENSG00000177272;KCNA3;1;111214310;111217655;3345;0
3012;ENSG00000177283;FZD8;10;35927177;35930362;3185;0
3013;ENSG00000177301;KCNA2;1;111136202;111174096;37894;0
3014;ENSG00000177359;;12;31264586;31359088;94502;0
3015;ENSG00000177363;LRRN4CL;11;62453874;62457371;3497;0
3016;ENSG00000177406;;12;740057;772872;32815;0
3017;ENSG00000177425;PAWR;12;79968759;80084877;116118;0
3018;ENSG00000177542;SLC25A22;11;790475;798316;7841;0
3019;ENSG00000177551;NHLH2;1;116378998;116386538;7540;0
3020;ENSG00000177575;CD163;12;7623409;7656489;33080;0
3021;ENSG00000177595;PIDD;11;799179;809753;10574;0
3022;ENSG00000177600;RPLP2;11;809647;812880;3233;0
3023;ENSG00000177606;JUN;1;59246465;59249785;3320;1
3024;ENSG00000177613;CSTF2T;10;53455247;53459355;4108;0
3025;ENSG00000177614;PGBD5;1;230457392;230561475;104083;0
3026;ENSG00000177628;GBA;1;155204243;155214490;10247;1
3027;ENSG00000177640;CASC2;10;119805790;119969663;163873;0
3028;ENSG00000177666;PNPLA2;11;818902;825573;6671;0
3029;ENSG00000177674;AGTRAP;1;11796141;11814859;18718;0
3030;ENSG00000177675;CD163L1;12;7499281;7632493;133212;0
3031;ENSG00000177697;CD151;11;832843;839831;6988;0
3032;ENSG00000177700;POLR2L;11;837356;842545;5189;0
3033;ENSG00000177788;;1;229394028;229406775;12747;0
3034;ENSG00000177807;KCNJ10;1;160007257;160040038;32781;0
3035;ENSG00000177830;CHID1;11;867357;915058;47701;0
3036;ENSG00000177853;ZNF518A;10;97889472;97965044;75572;0
3037;ENSG00000177868;CCDC23;1;43272723;43282954;10231;0
3038;ENSG00000177875;C12orf68;12;48577366;48579709;2343;0
3039;ENSG00000177888;ZBTB41;1;197122810;197169672;46862;0
3040;ENSG00000177889;UBE2N;12;93799449;93836038;36589;0
3041;ENSG00000177951;BET1L;11;167784;207428;39644;0
3042;ENSG00000177954;RPS27;1;153963235;153964626;1391;0
3043;ENSG00000177963;RIC8A;11;207511;215113;7602;0
3044;ENSG00000177981;ASB8;12;48541571;48574996;33425;0
3045;ENSG00000177990;DPY19L2;12;63952693;64062719;110026;1
3046;ENSG00000178028;DMAP1;1;44679127;44686353;7226;0
3047;ENSG00000178096;BOLA1;1;149859440;149872351;12911;0
3048;ENSG00000178104;PDE4DIP;1;144836157;145076186;240029;0
3049;ENSG00000178105;DDX10;11;108535752;108811657;275905;0
3050;ENSG00000178202;KDELC2;11;108342832;108369159;26327;1
3051;ENSG00000178217;SH2D4B;10;82297658;82406316;108658;1
3052;ENSG00000178301;AQP11;11;77300436;77321400;20964;0
3053;ENSG00000178401;DNAJC22;12;49740700;49751309;10609;0
3054;ENSG00000178440;LINC00843;10;51732523;51741813;9290;0
3055;ENSG00000178449;COX14;12;50505762;50514240;8478;0
3056;ENSG00000178498;DTX3;12;57998405;58003587;5182;0
3057;ENSG00000178585;CTNNBIP1;1;9908334;9970394;62060;0
3058;ENSG00000178821;TMEM52;1;1849029;1850712;1683;0
3059;ENSG00000178878;APOLD1;12;12878851;12982909;104058;0
3060;ENSG00000178882;FAM101A;12;124457788;124800570;342782;0
3061;ENSG00000178922;HYI;1;43916824;43919660;2836;0
3062;ENSG00000178965;C1orf173;1;75033795;75139422;105627;0
3063;ENSG00000179051;RCC2;1;17733256;17766220;32964;0
3064;ENSG00000179057;IGSF22;11;18725852;18747777;21925;0
3065;ENSG00000179085;DPM3;1;155112367;155113071;704;0
3066;ENSG00000179104;TMTC2;12;83080659;83528649;447990;0
3067;ENSG00000179119;SPTY2D1;11;18627948;18656338;28390;0
3068;ENSG00000179133;C10orf67;10;23556124;23633774;77650;0
3069;ENSG00000179163;FUCA1;1;24171567;24194784;23217;0
3070;ENSG00000179195;ZNF664;12;124456392;124499986;43594;0
3071;ENSG00000179240;;11;76092357;76125663;33306;0
3072;ENSG00000179241;LDLRAD3;11;35965531;36253686;288155;0
3073;ENSG00000179292;TMEM151A;11;66059341;66064135;4794;0
3074;ENSG00000179295;PTPN11;12;112856155;112947717;91562;0
3075;ENSG00000179296;CTGLF12P;10;49217898;49239729;21831;0
3076;ENSG00000179331;RAB39A;11;107799229;107834208;34979;0
3077;ENSG00000179397;C1orf101;1;244617679;244804479;186800;0
3078;ENSG00000179403;VWA1;1;1370241;1378262;8021;0
3079;ENSG00000179431;FJX1;11;35639735;35642419;2684;0
3080;ENSG00000179456;ZBTB18;1;244214585;244220778;6193;0
3081;ENSG00000179520;SLC17A8;12;100750857;100815837;64980;1
3082;ENSG00000179532;DNHD1;11;6518490;6614988;96498;0
3083;ENSG00000179546;HTR1D;1;23516993;23521222;4229;0
3084;ENSG00000179611;DGKZP1;13;44542560;44545335;2775;0
3085;ENSG00000179630;LACC1;13;44453420;44468068;14648;0
3086;ENSG00000179715;PCED1B;12;47473386;47630443;157057;0
3087;ENSG00000179743;;1;16160560;16174642;14082;0
3088;ENSG00000179774;ATOH7;10;69990386;69991871;1485;0
3089;ENSG00000179813;FAM216B;13;43355686;43365683;9997;0
3090;ENSG00000179862;CITED4;1;41326729;41328018;1289;0
3091;ENSG00000179899;PHC1P1;12;55804263;55808633;4370;0
3092;ENSG00000179902;C1orf194;1;109648573;109656479;7906;0
3093;ENSG00000179912;R3HDM2;12;57643392;57824788;181396;0
3094;ENSG00000179941;BBS10;12;76738254;76742222;3968;0
3095;ENSG00000179988;PSTK;10;124713897;124757029;43132;0
3096;ENSG00000180098;TRNAU1AP;1;28879597;28905051;25454;0
3097;ENSG00000180139;ACTA2-AS1;10;90692400;90700368;7968;0
3098;ENSG00000180176;TH;11;2185159;2193107;7948;0
3099;ENSG00000180198;RCC1;1;28832455;28865812;33357;0
3100;ENSG00000180210;F2;11;46740730;46761056;20326;1
3101;ENSG00000180263;FGD6;12;95470525;95611258;140733;0
3102;ENSG00000180287;PLD5;1;242246288;242687998;441710;1
3103;ENSG00000180318;ALX1;12;85673885;85695562;21677;0
3104;ENSG00000180332;KCTD4;13;45766988;45775175;8187;0
3105;ENSG00000180423;HARBI1;11;46624411;46639459;15048;0
3106;ENSG00000180425;C11orf71;11;114262165;114271139;8974;0
3107;ENSG00000180440;SERTM1;13;37248049;37271976;23927;1
3108;ENSG00000180481;GLIPR1L2;12;75784850;75826468;41618;0
3109;ENSG00000180488;FAM73A;1;78245309;78344106;98797;0
3110;ENSG00000180581;SRP9P1;10;93565803;93567253;1450;0
3111;ENSG00000180592;SKIDA1;10;21802407;21814611;12204;0
3112;ENSG00000180628;PCGF5;10;92979908;93044088;64180;0
3113;ENSG00000180660;MAB21L1;13;36047926;36050832;2906;0
3114;ENSG00000180667;YOD1;1;207217194;207226325;9131;0
3115;ENSG00000180720;CHRM4;11;46406640;46408107;1467;0
3116;ENSG00000180730;SHISA2;13;26618735;26625169;6434;1
3117;ENSG00000180758;GPR157;1;9160364;9189229;28865;0
3118;ENSG00000180764;PIPSL;10;95717948;95721297;3349;0
3119;ENSG00000180771;SRSF8;11;94800056;94804388;4332;0
3120;ENSG00000180773;SLC36A4;11;92877341;92931130;53789;0
3121;ENSG00000180776;ZDHHC20;13;21950263;22033509;83246;0
3122;ENSG00000180817;PPA1;10;71962586;71993667;31081;0
3123;ENSG00000180867;PDIA3P1;1;146649692;146651206;1514;0
3124;ENSG00000180875;GREM2;1;240652873;240775449;122576;0
3125;ENSG00000180881;CAPS2;12;75669759;75784708;114949;0
3126;ENSG00000181039;ANKRD34A;1;145470508;145475646;5138;0
3127;ENSG00000181192;DHTKD1;10;12110971;12165224;54253;0
3128;ENSG00000181218;HIST3H2A;1;228645065;228645560;495;0
3129;ENSG00000181264;TMEM136;11;120195838;120204391;8553;0
3130;ENSG00000181274;FRAT2;10;99092255;99094458;2203;0
3131;ENSG00000181418;DDN;12;49388932;49393092;4160;0
3132;ENSG00000181450;ZNF678;1;227751244;227865144;113900;0
3133;ENSG00000181656;GPR88;1;101003693;101007574;3881;0
3134;ENSG00000181754;AMIGO1;1;110046797;110052360;5563;0
3135;ENSG00000181773;GPR3;1;27719148;27722318;3170;0
3136;ENSG00000181817;LSM10;1;36856839;36863493;6654;0
3137;ENSG00000181830;SLC35C1;11;45825623;45834566;8943;0
3138;ENSG00000181852;RNF41;12;56598285;56615717;17432;0
3139;ENSG00000181873;IBA57;1;228353516;228369958;16442;0
3140;ENSG00000181908;;11;64216546;64219126;2580;0
3141;ENSG00000181915;ADO;10;64564516;64568238;3722;0
3142;ENSG00000181924;COA4;11;73583712;73588033;4321;0
3143;ENSG00000181929;PRKAG1;12;49396057;49412980;16923;0
3144;ENSG00000182004;SNRPE;1;203830731;203839678;8947;0
3145;ENSG00000182010;RTKN2;10;63942794;64028466;85672;0
3146;ENSG00000182022;CHST15;10;125767184;125853206;86022;1
3147;ENSG00000182050;MGAT4C;12;86372516;87232681;860165;0
3148;ENSG00000182053;TRIM49B;11;49050504;49059579;9075;0
3149;ENSG00000182103;FAM181B;11;82443053;82444906;1853;0
3150;ENSG00000182109;;1;39987952;40011859;23907;0
3151;ENSG00000182118;FAM89A;1;231154704;231175992;21288;0
3152;ENSG00000182134;TDRKH;1;151742583;151763892;21309;0
3153;ENSG00000182180;MRPS16;10;75006510;75012451;5941;0
3154;ENSG00000182183;FAM159A;1;53099016;53135355;36339;0
3155;ENSG00000182196;ARL6IP4;12;123464607;123467456;2849;0
3156;ENSG00000182199;SHMT2;12;57623110;57628718;5608;0
3157;ENSG00000182208;MOB2;11;1490687;1522477;31790;0
3158;ENSG00000182255;KCNA4;11;30031288;30038570;7282;0
3159;ENSG00000182272;B4GALNT4;11;369796;382116;12320;0
3160;ENSG00000182326;C1S;12;7096351;7178336;81985;1
3161;ENSG00000182359;KBTBD3;11;105921825;105948492;26667;0
3162;ENSG00000182379;NXPH4;12;57610578;57620232;9654;0
3163;ENSG00000182500;ORAI1;12;122064455;122080583;16128;0
3164;ENSG00000182544;MFSD5;12;53645035;53648189;3154;0
3165;ENSG00000182632;CCNYL2;10;42903616;42967688;64072;1
3166;ENSG00000182667;NTM;11;131240373;132206716;966343;0
3167;ENSG00000182704;TSKU;11;76493295;76509198;15903;0
3168;ENSG00000182749;PAQR7;1;26187701;26197744;10043;0
3169;ENSG00000182771;GRID1;10;87359312;88126250;766938;0
3170;ENSG00000182791;CCDC87;11;66357640;66360554;2914;0
3171;ENSG00000182796;TMEM198B;12;56223529;56230030;6501;0
3172;ENSG00000182827;ACBD3;1;226332380;226374431;42051;0
3173;ENSG00000182870;GALNT9;12;132680924;132905935;225011;0
3174;ENSG00000182873;;1;2113233;2115828;2595;0
3175;ENSG00000182901;RGS7;1;240931554;241520530;588976;0
3176;ENSG00000182919;C11orf54;11;93474757;93497915;23158;0
3177;ENSG00000182934;SRPR;11;126132814;126139039;6225;0
3178;ENSG00000182957;SPATA13;13;24553944;24881212;327268;0
3179;ENSG00000182985;CADM1;11;115039938;115375675;335737;0
3180;ENSG00000182993;C12orf60;12;14956506;15059520;103014;0
3181;ENSG00000183020;AP2A2;11;924894;1012239;87345;0
3182;ENSG00000183049;CAMK1D;10;12391481;12877545;486064;0
3183;ENSG00000183114;FAM43B;1;20878932;20881512;2580;0
3184;ENSG00000183134;PTGDR2;11;60618413;60623444;5031;0
3185;ENSG00000183150;GPR19;12;12813825;12849141;35316;0
3186;ENSG00000183155;RABIF;1;202848085;202858263;10178;0
3187;ENSG00000183161;FANCF;11;22644079;22647387;3308;0
3188;ENSG00000183230;CTNNA3;10;67672276;69455927;1783651;0
3189;ENSG00000183283;DAZAP2;12;51632076;51665146;33070;0
3190;ENSG00000183291;;1;87328132;87380107;51975;0
3191;ENSG00000183298;;1;102251892;102254059;2167;0
3192;ENSG00000183317;EPHA10;1;38179552;38230805;51253;0
3193;ENSG00000183340;JRKL;11;96123153;96240738;117585;0
3194;ENSG00000183346;C10orf107;10;63422719;63526524;103805;0
3195;ENSG00000183386;FHL3;1;38462442;38471278;8836;0
3196;ENSG00000183431;SF3A3;1;38422647;38456593;33946;0
3197;ENSG00000183495;EP400;12;132434508;132565005;130497;0
3198;ENSG00000183508;FAM46C;1;118148556;118170994;22438;0
3199;ENSG00000183520;UTP11L;1;38474930;38490496;15566;0
3200;ENSG00000183605;SFXN4;10;120900279;120925179;24900;0
3201;ENSG00000183615;FAM167B;1;32712834;32714457;1623;0
3202;ENSG00000183621;ZNF438;10;31109136;31320866;211730;0
3203;ENSG00000183715;OPCML;11;132284871;133402414;1117543;0
3204;ENSG00000183722;LHFP;13;39917029;40177665;260636;0
3205;ENSG00000183726;TMEM50A;1;25664408;25688852;24444;0
3206;ENSG00000183735;TBK1;12;64845660;64895888;50228;0
3207;ENSG00000183780;SLC35F3;1;234040679;234460262;419583;0
3208;ENSG00000183814;LIN9;1;226418850;226497570;78720;0
3209;ENSG00000183831;ANKRD45;1;173578700;173639001;60301;0
3210;ENSG00000183853;KIRREL;1;157963063;158070052;106989;0
3211;ENSG00000183856;IQGAP3;1;156495197;156542396;47199;1
3212;ENSG00000183908;LRRC55;11;56949221;56959191;9970;0
3213;ENSG00000183929;DUSP5P1;1;228744885;228788150;43265;1
3214;ENSG00000183935;HTR7P1;12;13152812;13155768;2956;0
3215;ENSG00000183955;SETD8;12;123868320;123893905;25585;0
3216;ENSG00000184005;ST6GALNAC3;1;76540404;77100286;559882;0
3217;ENSG00000184007;PTP4A2;1;32372022;32410457;38435;0
3218;ENSG00000184014;DENND5A;11;9160372;9286937;126565;0
3219;ENSG00000184047;DIABLO;12;122692210;122712081;19871;0
3220;ENSG00000184144;CNTN2;1;205012325;205047627;35302;0
3221;ENSG00000184154;LRTOMT;11;71791382;71821828;30446;0
3222;ENSG00000184209;SNRNP35;12;123942188;123957701;15513;0
3223;ENSG00000184232;OAF;11;120081475;120101041;19566;0
3224;ENSG00000184271;POU6F1;12;51580719;51611477;30758;0
3225;ENSG00000184281;TSSC4;11;2421718;2425106;3388;0
3226;ENSG00000184363;PKP3;11;392614;404908;12294;0
3227;ENSG00000184371;CSF1;1;110452864;110473614;20750;0
3228;ENSG00000184384;MAML2;11;95709762;96076344;366582;0
3229;ENSG00000184445;KNTC1;12;123011793;123110943;99150;0
3230;ENSG00000184524;CEND1;11;787104;790123;3019;0
3231;ENSG00000184545;DUSP8;11;1575274;1593150;17876;0
3232;ENSG00000184575;XPOT;12;64798130;64844907;46777;0
3233;ENSG00000184588;PDE4B;1;66258197;66840259;582062;0
3234;ENSG00000184613;NELL2;12;44902058;45315631;413573;0
3235;ENSG00000184669;OR7E14P;11;17035545;17074583;39038;0
3236;ENSG00000184677;ZBTB40;1;22778344;22857650;79306;0
3237;ENSG00000184678;HIST2H2BE;1;149856010;149858232;2222;0
3238;ENSG00000184719;RNLS;10;90033621;90344287;310666;0
3239;ENSG00000184743;ATL3;11;63391559;63439393;47834;0
3240;ENSG00000184752;NDUFA12;12;95290831;95397546;106715;0
3241;ENSG00000184923;NUTM2A;10;88985205;88996665;11460;0
3242;ENSG00000184967;NOC4L;12;132628993;132637013;8020;0
3243;ENSG00000184992;BRI3BP;12;125478246;125515777;37531;0
3244;ENSG00000185009;AP3M1;10;75881524;75910821;29297;0
3245;ENSG00000185046;ANKS1B;12;99120235;100378432;1258197;0
3246;ENSG00000185085;INTS5;11;62414320;62420774;6454;0
3247;ENSG00000185090;MANEAL;1;38259474;38266809;7335;0
3248;ENSG00000185104;FAF1;1;50905150;51425935;520785;0
3249;ENSG00000185163;DDX51;12;132621139;132628880;7741;0
3250;ENSG00000185187;SIGIRR;11;405716;417455;11739;0
3251;ENSG00000185201;IFITM2;11;307631;315272;7641;1
3252;ENSG00000185220;PGBD2;1;249200395;249214145;13750;0
3253;ENSG00000185238;PRMT3;11;20409076;20530840;121764;0
3254;ENSG00000185267;CDNF;10;14861249;14880574;19325;0
3255;ENSG00000185278;ZBTB37;1;173837220;173872687;35467;0
3256;ENSG00000185344;ATP6V0A2;12;124196865;124246302;49437;0
3257;ENSG00000185420;SMYD3;1;245912642;246670614;757972;0
3258;ENSG00000185432;METTL7A;12;51317255;51326300;9045;0
3259;ENSG00000185436;IFNLR1;1;24480647;24514449;33802;0
3260;ENSG00000185475;TMEM179B;11;62554887;62557877;2990;0
3261;ENSG00000185480;PARPBP;12;102513956;102591298;77342;0
3262;ENSG00000185482;STAC3;12;57637236;57644976;7740;0
3263;ENSG00000185483;ROR1;1;64239693;64647181;407488;0
3264;ENSG00000185495;;1;224183659;224198309;14650;0
3265;ENSG00000185499;MUC1;1;155158300;155162707;4407;0
3266;ENSG00000185507;IRF7;11;612553;615999;3446;0
3267;ENSG00000185519;FAM131C;1;16384264;16400127;15863;0
3268;ENSG00000185532;PRKG1;10;52750945;54058110;1307165;0
3269;ENSG00000185591;SP1;12;53773960;53810230;36270;0
3270;ENSG00000185627;PSMD13;11;236546;252983;16437;0
3271;ENSG00000185630;PBX1;1;164524821;164868533;343712;0
3272;ENSG00000185633;NDUFA4L2;12;57628686;57634498;5812;0
3273;ENSG00000185652;NTF3;12;5541278;5630702;89424;0
3274;ENSG00000185664;PMEL;12;56347889;56367101;19212;0
3275;ENSG00000185668;POU3F1;1;38509523;38512450;2927;0
3276;ENSG00000185670;ZBTB3;11;62515791;62521660;5869;0
3277;ENSG00000185684;EP400NL;12;132568828;132613029;44201;0
3278;ENSG00000185736;ADARB2;10;1228073;1779670;551597;1
3279;ENSG00000185737;NRG3;10;83635070;84746935;1111865;0
3280;ENSG00000185742;C11orf87;11;109292846;109299840;6994;0
3281;ENSG00000185745;IFIT1;10;91152303;91163745;11442;0
3282;ENSG00000185842;DNAH14;1;225083964;225586996;503032;0
3283;ENSG00000185875;THNSL1;10;25305587;25315593;10006;0
3284;ENSG00000185904;LINC00839;10;42970991;42990784;19793;0
3285;ENSG00000185946;RNPC3;1;104068313;104097861;29548;0
3286;ENSG00000186007;LEMD1;1;205350506;205425082;74576;0
3287;ENSG00000186047;DLEU7;13;51285144;51418075;132931;0
3288;ENSG00000186056;MATN1-AS1;1;31191351;31199674;8323;0
3289;ENSG00000186063;AIDA;1;222841355;222886552;45197;0
3290;ENSG00000186076;;12;94034598;94035362;764;0
3291;ENSG00000186094;AGBL4;1;48998527;50489585;1491058;0
3292;ENSG00000186104;CYP2R1;11;14899553;14913798;14245;0
3293;ENSG00000186118;TEX38;1;47134527;47139266;4739;0
3294;ENSG00000186141;POLR3C;1;145592605;145611025;18420;0
3295;ENSG00000186166;CCDC84;11;118868852;118886501;17649;0
3296;ENSG00000186174;BCL9L;11;118764584;118796317;31733;0
3297;ENSG00000186184;POLR1D;13;28194903;28241548;46645;0
3298;ENSG00000186188;FFAR4;10;95326422;95364237;37815;0
3299;ENSG00000186205;01-Mar;1;220960101;220987735;27634;0
3300;ENSG00000186275;NBPF12;1;146373546;146467744;94198;0
3301;ENSG00000186280;KDM4D;11;94706845;94732682;25837;0
3302;ENSG00000186283;TOR3A;1;179050512;179067158;16646;0
3303;ENSG00000186298;PPP1CC;12;111157485;111180744;23259;0
3304;ENSG00000186301;MST1P2;1;16972069;16976914;4845;0
3305;ENSG00000186318;BACE1;11;117156402;117186975;30573;0
3306;ENSG00000186364;NUDT17;1;145586115;145589439;3324;0
3307;ENSG00000186377;CYP4X1;1;47427036;47516423;89387;0
3308;ENSG00000186409;CCDC30;1;42929001;43120335;191334;0
3309;ENSG00000186501;TMEM222;1;27648651;27662891;14240;0
3310;ENSG00000186635;ARAP1;11;72396114;72504644;108530;0
3311;ENSG00000186642;PDE2A;11;72287185;72385635;98450;0
3312;ENSG00000186660;ZFP91;11;58346584;58388515;41931;0
3313;ENSG00000186666;BCDIN3D;12;50231573;50236912;5339;0
3314;ENSG00000186715;MST1L;1;17081405;17096732;15327;0
3315;ENSG00000186815;TPCN1;12;113658855;113736390;77535;1
3316;ENSG00000186862;PDZD7;10;102767440;102790890;23450;0
3317;ENSG00000186897;C1QL4;12;49726200;49730971;4771;0
3318;ENSG00000186907;RTN4RL2;11;57228022;57245007;16985;0
3319;ENSG00000186908;ZDHHC17;12;77157368;77247476;90108;0
3320;ENSG00000186973;FAM183A;1;43610824;43622067;11243;0
3321;ENSG00000187017;ESPN;1;6484848;6521430;36582;0
3322;ENSG00000187049;TMEM216;11;61159159;61166335;7176;0
3323;ENSG00000187079;TEAD1;11;12695969;12966298;270329;0
3324;ENSG00000187109;NAP1L1;12;76438670;76478813;40143;0
3325;ENSG00000187122;SLIT1;10;98757795;98945677;187882;0
3326;ENSG00000187134;AKR1C1;10;4934796;5025475;90679;0
3327;ENSG00000187140;FOXD3;1;63788730;63790797;2067;0
3328;ENSG00000187145;MRPS21;1;150266289;150281414;15125;0
3329;ENSG00000187147;RNF220;1;44870866;45117396;246530;0
3330;ENSG00000187151;ANGPTL5;11;101761405;101787253;25848;0
3331;ENSG00000187164;KIAA1598;10;118643742;118886097;242355;0
3332;ENSG00000187240;DYNC2H1;11;102980160;103350591;370431;0
3333;ENSG00000187398;LUZP2;11;24518516;25104150;585634;0
3334;ENSG00000187479;C11orf96;11;43946892;43965888;18996;0
3335;ENSG00000187486;KCNJ11;11;17407406;17410878;3472;0
3336;ENSG00000187522;HSPA14;10;14880163;14913740;33577;0
3337;ENSG00000187554;TLR5;1;223282748;223316624;33876;0
3338;ENSG00000187583;PLEKHN1;1;901877;911245;9368;0
3339;ENSG00000187608;ISG15;1;948803;949920;1117;0
3340;ENSG00000187634;SAMD11;1;860260;879955;19695;0
3341;ENSG00000187676;B3GALTL;13;31774073;31906413;132340;0
3342;ENSG00000187686;KRT18P59;11;124983057;124996677;13620;0
3343;ENSG00000187714;SLC18A3;10;50818347;50820765;2418;0
3344;ENSG00000187726;DNAJB13;11;73661364;73681411;20047;0
3345;ENSG00000187778;MCRS1;12;49950327;49961936;11609;0
3346;ENSG00000187801;ZFP69B;1;40915774;40929390;13616;0
3347;ENSG00000187815;ZFP69;1;40942887;40962015;19128;0
3348;ENSG00000187908;DMBT1;10;124320181;124403252;83071;0
3349;ENSG00000187950;OVCH1;12;29565407;29650619;85212;0
3350;ENSG00000187961;KLHL17;1;895967;901095;5128;0
3351;ENSG00000188004;C1orf204;1;159804264;159825137;20873;0
3352;ENSG00000188026;RILPL1;12;123955925;124018265;62340;0
3353;ENSG00000188070;C11orf95;11;63527364;63536113;8749;0
3354;ENSG00000188092;GPR89B;1;147400506;147465753;65247;0
3355;ENSG00000188124;OR2AG2;11;6789218;6790286;1068;0
3356;ENSG00000188157;AGRN;1;955503;991496;35993;0
3357;ENSG00000188199;NUTM2B;10;81462983;81474437;11454;0
3358;ENSG00000188206;HNRNPU-AS1;1;245003940;245018799;14859;1
3359;ENSG00000188211;NCR3LG1;11;17373273;17398888;25615;0
3360;ENSG00000188234;AGAP4;10;46321042;46349323;28281;0
3361;ENSG00000188290;HES4;1;934342;935552;1210;0
3362;ENSG00000188295;ZNF669;1;247263264;247267674;4410;0
3363;ENSG00000188316;ENO4;10;118609023;118671299;62276;0
3364;ENSG00000188342;GTF2F2;13;45694650;45858237;163587;0
3365;ENSG00000188385;JAKMIP3;10;133918175;133998313;80138;0
3366;ENSG00000188486;H2AFX;11;118964564;118966177;1613;0
3367;ENSG00000188487;INSC;11;15133970;15268754;134784;0
3368;ENSG00000188529;SRSF10;1;24291294;24307417;16123;0
3369;ENSG00000188596;C12orf55;12;96883349;97269333;385984;0
3370;ENSG00000188610;FAM72B;1;120837756;120855681;17925;0
3371;ENSG00000188611;ASAH2;10;51942538;52008370;65832;0
3372;ENSG00000188613;NANOS1;10;120789228;120793854;4626;0
3373;ENSG00000188641;DPYD;1;97543299;98386605;843306;0
3374;ENSG00000188643;S100A16;1;153579362;153585621;6259;0
3375;ENSG00000188690;UROS;10;127477146;127511817;34671;0
3376;ENSG00000188735;TMEM120B;12;122150658;122220907;70249;0
3377;ENSG00000188739;RBM34;1;235294498;235324772;30274;0
3378;ENSG00000188761;BCL2L15;1;114420790;114430169;9379;0
3379;ENSG00000188783;PRELP;1;203444956;203460480;15524;0
3380;ENSG00000188786;MTF1;1;38275239;38325292;50053;0
3381;ENSG00000188807;TMEM201;1;9648932;9674935;26003;0
3382;ENSG00000188811;NHLRC3;13;39612443;39624246;11803;0
3383;ENSG00000188859;FAM78B;1;166026674;166136206;109532;0
3384;ENSG00000188906;LRRK2;12;40590546;40763087;172541;0
3385;ENSG00000188916;FAM196A;10;128933694;128994422;60728;0
3386;ENSG00000188931;C1orf192;1;161334521;161337664;3143;0
3387;ENSG00000188976;NOC2L;1;879584;894689;15105;0
3388;ENSG00000188997;KCTD21;11;77882295;77899868;17573;0
3389;ENSG00000189014;FAM35DP;10;47379727;47420712;40985;0
3390;ENSG00000189030;VHLL;1;156268415;156269428;1013;0
3391;ENSG00000189046;ALKBH2;12;109525996;109531436;5440;0
3392;ENSG00000189057;FAM111B;11;58874658;58894883;20225;0
3393;ENSG00000189079;ARID2;12;46123448;46301823;178375;0
3394;ENSG00000189171;S100A13;1;153591263;153606568;15305;0
3395;ENSG00000189180;ZNF33A;10;38299578;38354016;54438;0
3396;ENSG00000189195;BTBD8;1;92545862;92613393;67531;0
3397;ENSG00000189266;PNRC2;1;24285599;24289952;4353;0
3398;ENSG00000189319;FAM53B;10;126307861;126432838;124977;0
3399;ENSG00000189337;KAZN;1;14925200;15444539;519339;0
3400;ENSG00000189339;SLC35E2B;1;1592939;1624167;31228;0
3401;ENSG00000189403;HMGB1;13;31032884;31191734;158850;0
3402;ENSG00000189410;SH2D5;1;21046225;21059330;13105;0
3403;ENSG00000189431;RASSF10;11;13030696;13032647;1951;0
3404;ENSG00000196071;OR2L13;1;248100493;248264224;163731;0
3405;ENSG00000196072;BLOC1S2;10;102033713;102046469;12756;0
3406;ENSG00000196139;AKR1C3;10;5077546;5149878;72332;0
3407;ENSG00000196177;ACADSB;10;124768495;124817827;49332;0
3408;ENSG00000196182;STK40;1;36805225;36851497;46272;0
3409;ENSG00000196187;TMEM63A;1;226033237;226070069;36832;0
3410;ENSG00000196189;SEMA4A;1;156117157;156147543;30386;1
3411;ENSG00000196199;MPHOSPH8;13;20207788;20247599;39811;0
3412;ENSG00000196233;LCOR;10;98592017;98740800;148783;0
3413;ENSG00000196323;ZBTB44;11;130096572;130184581;88009;0
3414;ENSG00000196369;SRGAP2B;1;143913615;144094424;180809;0
3415;ENSG00000196371;FUT4;11;94277017;94283063;6046;0
3416;ENSG00000196372;ASB13;10;5680830;5708558;27728;0
3417;ENSG00000196387;ZNF140;12;133656424;133684130;27706;0
3418;ENSG00000196403;OR10D1P;11;124029128;124030063;935;0
3419;ENSG00000196418;ZNF124;1;247285277;247335318;50041;0
3420;ENSG00000196449;YRDC;1;38268616;38273857;5241;0
3421;ENSG00000196458;ZNF605;12;133498019;133532892;34873;0
3422;ENSG00000196465;MYL6B;12;56546040;56553431;7391;0
3423;ENSG00000196482;ESRRG;1;216676588;217311097;634509;0
3424;ENSG00000196498;NCOR2;12;124808961;125052135;243174;0
3425;ENSG00000196505;GDAP2;1;118406107;118472253;66146;0
3426;ENSG00000196510;ANAPC7;12;110810705;110841535;30830;0
3427;ENSG00000196517;SLC6A9;1;44457172;44497139;39967;0
3428;ENSG00000196531;NACA;12;57106212;57125412;19200;0
3429;ENSG00000196550;FAM72A;1;206136916;206155151;18235;0
3430;ENSG00000196559;LINC00610;11;36290834;36294909;4075;0
3431;ENSG00000196581;AJAP1;1;4714792;4852594;137802;1
3432;ENSG00000196593;ANKRD20A19P;13;24513696;24520921;7225;0
3433;ENSG00000196655;TRAPPC4;11;118889142;118896164;7022;0
3434;ENSG00000196660;SLC30A10;1;219858769;220131989;273220;0
3435;ENSG00000196668;LINC00173;12;116971227;116974323;3096;0
3436;ENSG00000196693;ZNF33B;10;43084555;43133992;49437;0
3437;ENSG00000196793;ZNF239;10;44051792;44070066;18274;0
3438;ENSG00000196844;PATE2;11;125646008;125648714;2706;0
3439;ENSG00000196850;PPTC7;12;110969120;111021125;52005;0
3440;ENSG00000196865;NHLRC2;10;115614420;115676953;62533;0
3441;ENSG00000196876;SCN8A;12;51984050;52206648;222598;0
3442;ENSG00000196878;LAMB3;1;209788215;209825811;37596;0
3443;ENSG00000196890;HIST3H2BB;1;228645808;228646259;451;0
3444;ENSG00000196914;ARHGEF12;11;120207787;120360645;152858;0
3445;ENSG00000196932;TMEM26;10;63166401;63213208;46807;0
3446;ENSG00000196935;SRGAP1;12;64238073;64541613;303540;0
3447;ENSG00000196968;FUT11;10;75532049;75540009;7960;0
3448;ENSG00000197056;ZMYM1;1;35525387;35581460;56073;0
3449;ENSG00000197106;SLC6A17;1;110693108;110744824;51716;0
3450;ENSG00000197111;PCBP2;12;53835525;53874946;39421;0
3451;ENSG00000197136;PCNXL3;11;65383244;65404910;21666;0
3452;ENSG00000197147;LRRC8B;1;89990395;90063423;73028;0
3453;ENSG00000197168;NEK5;13;52611093;52703214;92121;0
3454;ENSG00000197177;GPR123;10;134884433;134945179;60746;1
3455;ENSG00000197245;FAM110D;1;26485511;26489119;3608;0
3456;ENSG00000197312;DDI2;1;15943995;15995539;51544;0
3457;ENSG00000197321;SVIL;10;29746267;30025710;279443;0
3458;ENSG00000197323;TRIM33;1;114935399;115053781;118382;0
3459;ENSG00000197345;MRPL21;11;68658744;68671303;12559;0
3460;ENSG00000197429;IPP;1;46159996;46216322;56326;0
3461;ENSG00000197444;OGDHL;10;50942689;50970425;27736;0
3462;ENSG00000197467;COL13A1;10;71561644;71724031;162387;1
3463;ENSG00000197472;ZNF695;1;247108849;247171395;62546;0
3464;ENSG00000197530;MIB2;1;1550795;1565990;15195;0
3465;ENSG00000197568;HHLA3;1;70820488;70851022;30534;0
3466;ENSG00000197580;BCO2;11;112046190;112095422;49232;0
3467;ENSG00000197587;DMBX1;1;46972668;46979898;7230;0
3468;ENSG00000197601;FAR1;11;13690217;13753893;63676;0
3469;ENSG00000197604;;10;72194585;72196314;1729;0
3470;ENSG00000197622;CDC42SE1;1;151023447;151042801;19354;0
3471;ENSG00000197653;DNAH10;12;124247042;124420753;173711;0
3472;ENSG00000197702;PARVA;11;12398732;12552348;153616;0
3473;ENSG00000197728;RPS26;12;56435637;56438116;2479;0
3474;ENSG00000197746;PSAP;10;73576055;73611126;35071;0
3475;ENSG00000197747;S100A10;1;151955391;151966866;11475;0
3476;ENSG00000197748;WDR96;10;105889646;105992120;102474;0
3477;ENSG00000197769;MAP1LC3C;1;242158792;242162375;3583;0
3478;ENSG00000197771;MCMBP;10;121588972;121652068;63096;0
3479;ENSG00000197780;TAF13;1;109605108;109618624;13516;0
3480;ENSG00000197785;ATAD3A;1;1447531;1470067;22536;0
3481;ENSG00000197798;FAM118B;11;126081309;126132881;51572;0
3482;ENSG00000197837;HIST4H4;12;14920933;14924065;3132;0
3483;ENSG00000197847;SLC22A20;11;64981311;65010228;28917;0
3484;ENSG00000197852;FAM212B;1;112223252;112298446;75194;0
3485;ENSG00000197889;MEIG1;10;15001438;15030049;28611;0
3486;ENSG00000197905;TEAD4;12;3068496;3149839;81343;0
3487;ENSG00000197921;HES5;1;2460184;2461684;1500;0
3488;ENSG00000197956;S100A6;1;153507075;153508720;1645;0
3489;ENSG00000197959;DNM3;1;171810621;172387606;576985;0
3490;ENSG00000197965;MPZL1;1;167690429;167761156;70727;0
3491;ENSG00000197982;C1orf122;1;38272651;38275126;2475;0
3492;ENSG00000197989;SNHG12;1;28905050;28909495;4445;0
3493;ENSG00000198001;IRAK4;12;44152747;44183346;30599;0
3494;ENSG00000198015;MRPL42;12;93861264;93897545;36281;0
3495;ENSG00000198018;ENTPD7;10;101419263;101465997;46734;0
3496;ENSG00000198035;AGAP9;10;48189612;48237508;47896;0
3497;ENSG00000198040;ZNF84;12;133613878;133639885;26007;0
3498;ENSG00000198056;PRIM1;12;57125380;57146157;20777;0
3499;ENSG00000198060;05-Mar;10;94050920;94113721;62801;0
3500;ENSG00000198105;ZNF248;10;38091751;38147034;55283;0
3501;ENSG00000198160;MIER1;1;67390578;67454302;63724;0
3502;ENSG00000198162;MAN1A2;1;117910071;118071494;161423;0
3503;ENSG00000198168;SVIP;11;22835345;22851845;16500;0
3504;ENSG00000198198;SZT2;1;43855553;43918321;62768;0
3505;ENSG00000198216;CACNA1E;1;181382238;181777219;394981;0
3506;ENSG00000198246;SLC29A3;10;73079015;73123142;44127;0
3507;ENSG00000198270;TMEM116;12;112369086;112450970;81884;0
3508;ENSG00000198298;ZNF485;10;44101855;44113351;11496;0
3509;ENSG00000198324;FAM109A;12;111798455;111806925;8470;0
3510;ENSG00000198331;HYLS1;11;125753509;125770543;17034;0
3511;ENSG00000198382;UVRAG;11;75526212;75854239;328027;0
3512;ENSG00000198384;TPTE2P3;13;53063128;53161222;98094;0
3513;ENSG00000198393;ZNF26;12;133562951;133589154;26203;0
3514;ENSG00000198400;NTRK1;1;156785432;156851642;66210;0
3515;ENSG00000198408;MGEA5;10;103544200;103578696;34496;0
3516;ENSG00000198431;TXNRD1;12;104609557;104744061;134504;0
3517;ENSG00000198468;FLVCR1-AS1;1;213025450;213031430;5980;0
3518;ENSG00000198483;ANKRD35;1;145549230;145568526;19296;0
3519;ENSG00000198492;YTHDF2;1;29063133;29096287;33154;0
3520;ENSG00000198520;C1orf228;1;45140364;45191263;50899;1
3521;ENSG00000198546;ZNF511;10;135121979;135166033;44054;0
3522;ENSG00000198553;KCNRG;13;50589390;50595058;5668;0
3523;ENSG00000198561;CTNND1;11;57520715;57587018;66303;0
3524;ENSG00000198598;MMP17;12;132312938;132336328;23390;0
3525;ENSG00000198625;MDM4;1;204485511;204542871;57360;0
3526;ENSG00000198626;RYR2;1;237205505;237997288;791783;0
3527;ENSG00000198673;FAM19A2;12;62102040;62672931;570891;0
3528;ENSG00000198682;PAPSS2;10;89419370;89507462;88092;0
3529;ENSG00000198700;IPO9;1;201798269;201853422;55153;0
3530;ENSG00000198707;CEP290;12;88442793;88535993;93200;0
3531;ENSG00000198715;C1orf85;1;156259880;156265463;5583;1
3532;ENSG00000198728;LDB1;10;103867317;103880210;12893;0
3533;ENSG00000198730;CTR9;11;10772534;10801290;28756;0
3534;ENSG00000198739;LRRTM3;10;68685764;68859588;173824;0
3535;ENSG00000198744;;1;569756;570302;546;0
3536;ENSG00000198746;GPATCH3;1;27216979;27226957;9978;0
3537;ENSG00000198756;COLGALT2;1;183898796;184006863;108067;0
3538;ENSG00000198793;MTOR;1;11166592;11322564;155972;0
3539;ENSG00000198797;BRINP2;1;177140633;177251558;110925;0
3540;ENSG00000198799;LRIG2;1;113615831;113674882;59051;0
3541;ENSG00000198815;FOXJ3;1;42642210;42801548;159338;0
3542;ENSG00000198821;CD247;1;167399877;167487847;87970;0
3543;ENSG00000198825;INPP5F;10;121485609;121588652;103043;0
3544;ENSG00000198830;HMGN2;1;26798941;26802463;3522;0
3545;ENSG00000198835;GJC2;1;228337553;228347527;9974;0
3546;ENSG00000198837;DENND4B;1;153901977;153919172;17195;0
3547;ENSG00000198841;KTI12;1;52497775;52499488;1713;0
3548;ENSG00000198842;DUSP27;1;167063282;167098402;35120;0
3549;ENSG00000198855;FICD;12;108908962;108919614;10652;0
3550;ENSG00000198860;TSEN15;1;184020811;184043346;22535;0
3551;ENSG00000198873;GRK5;10;120967101;121215131;248030;0
3552;ENSG00000198879;SFMBT2;10;7200586;7453450;252864;0
3553;ENSG00000198890;PRMT6;1;107599267;107601916;2649;0
3554;ENSG00000198892;SHISA4;1;201857808;201861434;3626;0
3555;ENSG00000198912;C1orf174;1;3805689;3816857;11168;0
3556;ENSG00000198915;RASGEF1A;10;43689983;43762367;72384;0
3557;ENSG00000198924;DCLRE1A;10;115594488;115614142;19654;0
3558;ENSG00000198929;NOS1AP;1;162039564;162353321;313757;0
3559;ENSG00000198952;SMG5;1;156219015;156252620;33605;0
3560;ENSG00000198954;KIAA1279;10;70748487;70776738;28251;0
3561;ENSG00000198964;SGMS1;10;52065360;52384923;319563;0
3562;ENSG00000199059;MIR135B;1;205417430;205417526;96;0
3563;ENSG00000199172;MIR331;12;95702196;95702289;93;0
3564;ENSG00000199562;RNU6-37P;1;10359024;10359130;106;0
3565;ENSG00000199740;;12;51333710;51333809;99;0
3566;ENSG00000200090;;11;47748446;47748544;98;0
3567;ENSG00000200170;;10;73980510;73980610;100;0
3568;ENSG00000200274;RNU4-32P;12;110005780;110005920;140;1
3569;ENSG00000200674;RN7SKP160;1;173760686;173761025;339;0
3570;ENSG00000200737;;10;99180952;99181064;112;0
3571;ENSG00000201457;SNORA55;1;40033046;40033180;134;0
3572;ENSG00000201678;;12;49321722;49321816;94;0
3573;ENSG00000203257;;1;230451438;230451976;538;0
3574;ENSG00000203268;;10;134899473;134900137;664;0
3575;ENSG00000203276;;1;54498816;54500553;1737;0
3576;ENSG00000203288;;1;151763280;151766878;3598;0
3577;ENSG00000203356;;1;51660767;51700768;40001;0
3578;ENSG00000203497;PDCD4-AS1;10;112629626;112631991;2365;0
3579;ENSG00000203602;;13;28008286;28008752;466;1
3580;ENSG00000203614;;13;21286570;21288285;1715;0
3581;ENSG00000203666;EFCAB2;1;245133007;245290466;157459;0
3582;ENSG00000203667;COX20;1;244998624;245008359;9735;0
3583;ENSG00000203668;CHML;1;241792155;241799232;7077;0
3584;ENSG00000203684;IBA57-AS1;1;228351787;228353213;1426;0
3585;ENSG00000203685;C1orf95;1;226736501;226796915;60414;0
3586;ENSG00000203705;TATDN3;1;212965170;212989968;24798;0
3587;ENSG00000203706;SERTAD4-AS1;1;210404801;210407392;2591;0
3588;ENSG00000203709;C1orf132;1;207974863;208042495;67632;0
3589;ENSG00000203724;C1orf53;1;197871777;197876497;4720;0
3590;ENSG00000203737;GPR52;1;174417212;174418683;1471;0
3591;ENSG00000203739;;1;173386932;173430501;43569;0
3592;ENSG00000203740;METTL11B;1;170115142;170136931;21789;0
3593;ENSG00000203761;MSTO2P;1;155581011;155720105;139094;0
3594;ENSG00000203772;SPRN;10;135234170;135382916;148746;0
3595;ENSG00000203780;FANK1;10;127585108;127698161;113053;0
3596;ENSG00000203791;METTL10;10;126436718;126480439;43721;0
3597;ENSG00000203814;HIST2H2BF;1;149754245;149783928;29683;0
3598;ENSG00000203815;FAM231D;1;149675978;149676609;631;0
3599;ENSG00000203817;FAM72C;1;149438750;149459549;20799;0
3600;ENSG00000203819;HIST2H2BC;1;149821760;149822339;579;0
3601;ENSG00000203827;NBPF16;1;148739443;148758311;18868;0
3602;ENSG00000203832;NBPF20;1;148250249;148347506;97257;0
3603;ENSG00000203836;NBPF24;1;147574428;147634886;60458;0
3604;ENSG00000203849;;1;142620645;142729967;109322;0
3605;ENSG00000203865;ATP1A1OS;1;116934869;116961244;26375;1
3606;ENSG00000203867;RBM20;10;112404155;112599227;195072;0
3607;ENSG00000203876;;10;111701029;111713649;12620;0
3608;ENSG00000203886;CYP17A1-AS1;10;104592478;104594273;1795;0
3609;ENSG00000203943;SAMD13;1;84764049;84855640;91591;1
3610;ENSG00000203965;EFCAB7;1;63989043;64038364;49321;0
3611;ENSG00000203995;ZYG11A;1;53308183;53360670;52487;0
3612;ENSG00000204060;FOXO6;1;41827594;41849262;21668;0
3613;ENSG00000204084;INPP5B;1;38326369;38412729;86360;0
3614;ENSG00000204130;RUFY2;10;70100864;70167051;66187;0
3615;ENSG00000204138;PHACTR4;1;28696114;28826881;130767;0
3616;ENSG00000204147;ASAH2B;10;52499078;52576255;77177;0
3617;ENSG00000204149;AGAP6;10;51748078;51770259;22181;0
3618;ENSG00000204152;TIMM23B;10;51371390;51387768;16378;0
3619;ENSG00000204160;ZDHHC18;1;27153201;27184093;30892;0
3620;ENSG00000204164;BMS1P5;10;48901102;48950972;49870;0
3621;ENSG00000204169;AGAP7;10;51464162;51486327;22165;0
3622;ENSG00000204175;GPRIN2;10;46994087;47005643;11556;0
3623;ENSG00000204177;BMS1P1;10;46737612;46761205;23593;0
3624;ENSG00000204178;TMEM57;1;25757388;25826700;69312;0
3625;ENSG00000204219;TCEA3;1;23707554;23751233;43679;0
3626;ENSG00000204241;;11;133902167;133916744;14577;0
3627;ENSG00000204370;SDHD;11;111957497;111990353;32856;0
3628;ENSG00000204377;C1orf134;1;16555368;16556038;670;0
3629;ENSG00000204381;LAYN;11;111411005;111432264;21259;0
3630;ENSG00000204624;PTCHD2;1;11539223;11597641;58418;0
3631;ENSG00000204682;CASC10;10;21781587;21786191;4604;1
3632;ENSG00000204842;ATXN2;12;111890018;112037480;147462;0
3633;ENSG00000204852;TCTN1;12;111051832;111087235;35403;0
3634;ENSG00000204856;FAM216A;12;110906169;110928190;22021;0
3635;ENSG00000204859;ZBTB48;1;6640061;6649340;9279;0
3636;ENSG00000204922;C11orf83;11;62437745;62441159;3414;0
3637;ENSG00000204950;LRRC10B;11;61276272;61278482;2210;0
3638;ENSG00000204954;C12orf73;12;104343980;104359486;15506;0
3639;ENSG00000204977;TRIM13;13;50570024;50594617;24593;0
3640;ENSG00000205056;;12;92860227;92885867;25640;0
3641;ENSG00000205090;TMEM240;1;1470554;1475833;5279;0
3642;ENSG00000205213;LGR4;11;27387508;27494322;106814;0
3643;ENSG00000205323;SARNP;12;56146247;56211540;65293;0
3644;ENSG00000205339;IPO7;11;9406169;9469673;63504;0
3645;ENSG00000205352;PRR13;12;53835389;53840429;5040;0
3646;ENSG00000205488;CALML3-AS1;10;5556207;5568209;12002;0
3647;ENSG00000205531;NAP1L4;11;2965667;3013607;47940;0
3648;ENSG00000205592;MUC19;12;40787197;40964632;177435;0
3649;ENSG00000205693;MANSC4;12;27915671;27924209;8538;0
3650;ENSG00000205707;LYRM5;12;25348150;25362579;14429;0
3651;ENSG00000205740;;10;1017097;1034281;17184;0
3652;ENSG00000205791;LOH12CR2;12;12508342;12510001;1659;0
3653;ENSG00000205861;C1QTNF9B-AS1;13;24463028;24471402;8374;0
3654;ENSG00000206612;SNORA2A;12;49050431;49050565;134;0
3655;ENSG00000206878;;1;228788183;228788307;124;0
3656;ENSG00000207234;RNU6-125P;1;89282462;89282568;106;0
3657;ENSG00000207586;MIR135A2;12;97957590;97957689;99;0
3658;ENSG00000207652;MIR621;13;41384902;41384997;95;0
3659;ENSG00000207721;MIR186;1;71533314;71533399;85;0
3660;ENSG00000207971;MIR125B1;11;121970465;121970552;87;0
3661;ENSG00000211450;C11orf31;11;57508825;57510986;2161;0
3662;ENSG00000211451;GNRHR2;1;145509752;145516076;6324;0
3663;ENSG00000211454;AKR7L;1;19592476;19600688;8212;0
3664;ENSG00000211455;STK38L;12;27396901;27478892;81991;0
3665;ENSG00000211491;MIR320D1;13;41301964;41302011;47;0
3666;ENSG00000211575;MIR760;1;94312388;94312467;79;0
3667;ENSG00000211584;SLC48A1;12;48147699;48176536;28837;0
3668;ENSG00000212124;TAS2R19;12;11174218;11175219;1001;0
3669;ENSG00000212125;TAS2R15;12;11117024;11117951;927;0
3670;ENSG00000212127;TAS2R14;12;11090005;11324172;234167;0
3671;ENSG00000212464;SNORA12;10;101996913;101997059;146;0
3672;ENSG00000212670;;1;54569968;54571750;1782;0
3673;ENSG00000212694;;12;122233173;122241812;8639;0
3674;ENSG00000212916;MAP10;1;232940643;232946092;5449;0
3675;ENSG00000213047;DENND1B;1;197473878;197744826;270948;0
3676;ENSG00000213057;C1orf220;1;178511887;178518024;6137;0
3677;ENSG00000213058;;1;178380751;178381107;356;0
3678;ENSG00000213061;PFN1P11;10;104597768;104605230;7462;0
3679;ENSG00000213062;;1;169455380;169456846;1466;0
3680;ENSG00000213064;SFT2D2;1;168195176;168222263;27087;0
3681;ENSG00000213080;;1;160864770;160865866;1096;0
3682;ENSG00000213085;CCDC19;1;159842154;159869953;27799;1
3683;ENSG00000213088;DARC;1;159173097;159176290;3193;1
3684;ENSG00000213185;FAM24B;10;124608594;124639157;30563;0
3685;ENSG00000213190;MLLT11;1;151030234;151040970;10736;0
3686;ENSG00000213240;NOTCH2NL;1;145209119;145291972;82853;1
3687;ENSG00000213281;NRAS;1;115247090;115259515;12425;0
3688;ENSG00000213341;CHUK;10;101948055;101989376;41321;0
3689;ENSG00000213366;GSTM2;1;110210644;110252171;41527;0
3690;ENSG00000213390;ARHGAP19;10;98978996;99052413;73417;0
3691;ENSG00000213402;PTPRCAP;11;67202981;67205538;2557;0
3692;ENSG00000213411;RBM22P2;13;31113734;31117598;3864;0
3693;ENSG00000213442;RPL18AP3;12;104659056;104659669;613;0
3694;ENSG00000213443;;12;9847980;9848823;843;0
3695;ENSG00000213445;SIPA1;11;65405568;65418401;12833;0
3696;ENSG00000213465;ARL2;11;64781585;64789656;8071;0
3697;ENSG00000213513;;10;79540095;79541634;1539;0
3698;ENSG00000213516;RBMXL1;1;89445139;89458643;13504;0
3699;ENSG00000213551;DNAJC9;10;74943120;75008620;65500;0
3700;ENSG00000213593;TMX2;11;57480072;57508445;28373;0
3701;ENSG00000213609;;10;65662211;65663005;794;0
3702;ENSG00000213613;;10;89705259;89705781;522;0
3703;ENSG00000213619;NDUFS3;11;47586888;47606114;19226;0
3704;ENSG00000213625;LEPROT;1;65886270;65901690;15420;0
3705;ENSG00000213693;SEC14L1P1;11;43919006;43921186;2180;0
3706;ENSG00000213700;RPL17P50;10;74765591;74766353;762;0
3707;ENSG00000213782;DDX47;12;12966250;12982915;16665;0
3708;ENSG00000214026;MRPL23;11;1968508;2005752;37244;0
3709;ENSG00000214029;ZNF891;12;133694740;133707059;12319;0
3710;ENSG00000214063;TSPAN4;11;842808;867116;24308;0
3711;ENSG00000214114;MYCBP;1;39328636;39347289;18653;0
3712;ENSG00000214193;SH3D21;1;36771988;36790484;18496;0
3713;ENSG00000214198;;12;104237527;104323989;86462;0
3714;ENSG00000214279;;10;135267432;135337062;69630;1
3715;ENSG00000214290;COLCA2;11;111169565;111179460;9895;0
3716;ENSG00000214391;;11;90015728;90017340;1612;0
3717;ENSG00000214413;BBIP1;10;112658488;112679032;20544;0
3718;ENSG00000214455;RCN1P2;13;45964486;45965402;916;0
3719;ENSG00000214517;PPME1;11;73882144;73965748;83604;0
3720;ENSG00000214530;STARD10;11;72465774;72504726;38952;0
3721;ENSG00000214534;ZNF705E;11;71525091;71532594;7503;0
3722;ENSG00000214562;NUTM2D;10;89117425;89130452;13027;0
3723;ENSG00000214655;ZSWIM8;10;75545340;75561551;16211;0
3724;ENSG00000214753;HNRNPUL2;11;62480102;62494821;14719;0
3725;ENSG00000214756;METTL12;11;62432781;62435968;3187;0
3726;ENSG00000214776;;12;9620148;9728864;108716;0
3727;ENSG00000214796;;1;202820956;202830748;9792;0
3728;ENSG00000214826;DDX12P;12;9570309;9600825;30516;0
3729;ENSG00000214875;MED28P1;10;70750893;70751463;570;0
3730;ENSG00000214982;PARGP1;10;51623417;51732824;109407;0
3731;ENSG00000215014;;1;1510355;1511373;1018;1
3732;ENSG00000215021;PHB2;12;7074490;7079988;5498;0
3733;ENSG00000215039;CD27-AS1;12;6548167;6560733;12566;0
3734;ENSG00000215146;;10;42827314;42863422;36108;0
3735;ENSG00000215159;;12;65153301;65173098;19797;0
3736;ENSG00000215241;;12;8388011;8395160;7149;0
3737;ENSG00000215244;;10;6319650;6377944;58294;0
3738;ENSG00000215475;SIAH3;13;46354405;46425871;71466;0
3739;ENSG00000215717;TMEM167B;1;109632425;109639556;7131;0
3740;ENSG00000215784;FAM72D;1;143896452;143913143;16691;0
3741;ENSG00000215788;TNFRSF25;1;6521211;6526255;5044;0
3742;ENSG00000215790;SLC35E2;1;1656277;1677431;21154;0
3743;ENSG00000215808;LINC01139;1;238643684;238649323;5639;0
3744;ENSG00000215812;ZNF847P;1;227884593;227894412;9819;0
3745;ENSG00000215861;;1;144676874;144679969;3095;0
3746;ENSG00000215863;LINC01138;1;147835127;147931933;96806;0
3747;ENSG00000215883;CYB5RL;1;54638009;54665709;27700;0
3748;ENSG00000215902;;1;28527013;28527152;139;0
3749;ENSG00000215908;CROCCP2;1;16944751;16971178;26427;0
3750;ENSG00000215912;TTC34;1;2567415;2718286;150871;0
3751;ENSG00000216937;CCDC7;10;32735068;32863492;128424;0
3752;ENSG00000217801;;1;995114;1004735;9621;0
3753;ENSG00000218109;KIRREL3-AS3;11;126872805;126875953;3148;0
3754;ENSG00000218283;MORF4L1P1;1;220426912;220427878;966;0
3755;ENSG00000218510;LINC00339;1;22351681;22357716;6035;0
3756;ENSG00000219481;NBPF1;1;16888814;16940057;51243;0
3757;ENSG00000220323;HIST2H2BD;1;149814608;149815100;492;0
3758;ENSG00000220749;RPL21P28;1;212224829;212225371;542;0
3759;ENSG00000220785;MTMR9LP;1;32697259;32707221;9962;0
3760;ENSG00000220842;;10;122114177;122114718;541;0
3761;ENSG00000221164;;10;74885838;74885965;127;0
3762;ENSG00000221184;MIR1254-1;10;70519075;70519171;96;0
3763;ENSG00000221246;;12;111070409;111070498;89;0
3764;ENSG00000221479;MIR1251;12;97885678;97885761;83;0
3765;ENSG00000221571;RNU6ATAC35P;1;220998962;220999389;427;0
3766;ENSG00000221625;;12;98999652;98999738;86;0
3767;ENSG00000221643;SNORA77;1;203698709;203698833;124;0
3768;ENSG00000221817;;10;75255283;75279828;24545;0
3769;ENSG00000221953;C1orf229;1;247273462;247275719;2257;0
3770;ENSG00000221968;FADS3;11;61640991;61659523;18532;0
3771;ENSG00000221978;CCNL2;1;1321091;1334708;13617;0
3772;ENSG00000221986;MYBPHL;1;109834987;109849663;14676;1
3773;ENSG00000222009;BTBD19;1;45274154;45281257;7103;0
3774;ENSG00000222112;RN7SKP16;1;33802167;33802465;298;0
3775;ENSG00000222255;RNU6-101P;12;102159184;102159287;103;0
3776;ENSG00000222552;RNA5SP60;1;159148263;159148349;86;0
3777;ENSG00000222726;RNU2-7P;13;21186300;21186477;177;0
3778;ENSG00000222890;RNU6-1068P;12;101805135;101805237;102;0
3779;ENSG00000223345;HIST2H2BA;1;120906028;120915073;9045;0
3780;ENSG00000223356;;1;156682004;156682966;962;0
3781;ENSG00000223380;SEC22B;1;145096220;145116922;20702;0
3782;ENSG00000223382;;1;31297075;31307131;10056;0
3783;ENSG00000223393;;1;231010592;231014761;4169;0
3784;ENSG00000223396;RPS10P7;1;201487831;201499602;11771;0
3785;ENSG00000223474;;1;26145212;26147288;2076;0
3786;ENSG00000223479;;1;74100899;74180897;79998;0
3787;ENSG00000223482;NUTM2A-AS1;10;88963632;89102369;138737;0
3788;ENSG00000223685;LINC00571;13;38624954;38717369;92415;0
3789;ENSG00000223745;;1;93727743;93811582;83839;0
3790;ENSG00000223756;TSSC2;11;3402191;3430208;28017;0
3791;ENSG00000223764;;1;852245;856396;4151;0
3792;ENSG00000223774;;1;201862970;201869106;6136;0
3793;ENSG00000223779;;1;149239531;149265510;25979;0
3794;ENSG00000223804;;1;143647638;143745417;97779;0
3795;ENSG00000223820;CFL1P1;10;89577685;89605369;27684;0
3796;ENSG00000223963;PRKRIRP8;1;240932720;240934834;2114;0
3797;ENSG00000224005;;10;75473354;75473609;255;0
3798;ENSG00000224023;;10;127389005;127408135;19130;0
3799;ENSG00000224051;GLTPD1;1;1260136;1264277;4141;0
3800;ENSG00000224066;;1;32670370;32672415;2045;0
3801;ENSG00000224081;LINC01057;1;95104017;95285837;181820;0
3802;ENSG00000224093;;1;94057756;94071130;13374;0
3803;ENSG00000224114;;1;206869182;206869614;432;0
3804;ENSG00000224167;;1;113392650;113420493;27843;0
3805;ENSG00000224174;;1;16847189;16848291;1102;0
3806;ENSG00000224215;;10;23632886;23634110;1224;0
3807;ENSG00000224238;WARS2-IT1;1;119590028;119607408;17380;0
3808;ENSG00000224251;;10;5037680;5039572;1892;0
3809;ENSG00000224261;;1;160236130;160237015;885;0
3810;ENSG00000224358;;1;165738166;165744413;6247;0
3811;ENSG00000224382;LINC00703;10;4426438;4452804;26366;0
3812;ENSG00000224411;;11;27910385;27912580;2195;0
3813;ENSG00000224429;;13;21877654;21922860;45206;0
3814;ENSG00000224474;;10;99179228;99185831;6603;0
3815;ENSG00000224511;LINC00365;13;30677315;30683012;5697;0
3816;ENSG00000224525;;1;242366857;242374129;7272;0
3817;ENSG00000224592;;1;38512986;38584697;71711;0
3818;ENSG00000224596;ZMIZ1-AS1;10;80703085;80827652;124567;0
3819;ENSG00000224597;PTCHD3P1;10;29698331;29776674;78343;0
3820;ENSG00000224616;;1;100729565;100731676;2111;0
3821;ENSG00000224680;PLA2G12AP1;1;52834349;52834916;567;0
3822;ENSG00000224687;RASAL2-AS1;1;178060643;178063119;2476;0
3823;ENSG00000224699;LAMTOR5-AS1;1;110925441;110974982;49541;0
3824;ENSG00000224717;;1;205425057;205438152;13095;0
3825;ENSG00000224812;TMEM72-AS1;10;45306472;45455137;148665;0
3826;ENSG00000224818;;1;201433511;201434274;763;0
3827;ENSG00000224870;;1;1334902;1337426;2524;0
3828;ENSG00000224886;BEND3P3;10;81444250;81444739;489;0
3829;ENSG00000224892;RPS4XP16;13;52028300;52035451;7151;1
3830;ENSG00000224914;LINC00863;10;89102493;89117639;15146;0
3831;ENSG00000224934;;10;101190948;101197874;6926;0
3832;ENSG00000224950;;1;117035645;117041834;6189;0
3833;ENSG00000224956;;1;661611;663527;1916;0
3834;ENSG00000224969;;1;947377;948573;1196;0
3835;ENSG00000224986;PPP1R8P1;1;48790752;48791795;1043;0
3836;ENSG00000225015;SNX18P15;1;142660017;142660749;732;0
3837;ENSG00000225030;;1;53757463;53757810;347;0
3838;ENSG00000225113;;1;110138847;110140403;1556;0
3839;ENSG00000225119;LINC00999;10;38717074;38736820;19746;0
3840;ENSG00000225137;DYNC1I2P1;10;52024738;52026575;1837;0
3841;ENSG00000225171;DUTP6;1;166837985;166838446;461;0
3842;ENSG00000225206;MIR137HG;1;98453556;98515419;61863;0
3843;ENSG00000225213;;10;16763351;16790376;27025;0
3844;ENSG00000225241;;1;144593363;144621656;28293;0
3845;ENSG00000225251;RPL5P25;10;13099902;13100676;774;0
3846;ENSG00000225265;;1;222763167;222766374;3207;0
3847;ENSG00000225302;;10;118592512;118609716;17204;0
3848;ENSG00000225446;;1;91317316;91319843;2527;0
3849;ENSG00000225447;RPS15AP10;1;46111488;46111869;381;0
3850;ENSG00000225484;;10;81563813;81586350;22537;0
3851;ENSG00000225527;;10;18820778;18822265;1487;0
3852;ENSG00000225554;;1;241587592;241596792;9200;0
3853;ENSG00000225630;MTND2P28;1;565020;566063;1043;0
3854;ENSG00000225670;;1;159165775;159177763;11988;0
3855;ENSG00000225675;;1;53793905;53802181;8276;0
3856;ENSG00000225784;;10;51287081;51371070;83989;0
3857;ENSG00000225828;FAM229A;1;32826871;32829879;3008;0
3858;ENSG00000225830;ERCC6;10;50663414;50747584;84170;0
3859;ENSG00000225855;RUSC1-AS1;1;155286654;155293967;7313;1
3860;ENSG00000225857;;1;180875787;180878302;2515;0
3861;ENSG00000225880;LINC00115;1;761586;762902;1316;0
3862;ENSG00000225891;;1;26789247;26793773;4526;0
3863;ENSG00000225938;;1;101701239;101702084;845;0
3864;ENSG00000225986;UBXN10-AS1;1;20510735;20512979;2244;0
3865;ENSG00000226009;KCNIP2-AS1;10;103578835;103588536;9701;0
3866;ENSG00000226015;CCT8P1;1;146674857;146676513;1656;0
3867;ENSG00000226029;;1;16787443;16794976;7533;0
3868;ENSG00000226053;;1;98676303;98738214;61911;0
3869;ENSG00000226067;LINC00869;1;149284645;149286975;2330;0
3870;ENSG00000226084;;1;77594768;77595384;616;0
3871;ENSG00000226091;LINC00937;12;8448582;8549399;100817;0
3872;ENSG00000226200;;10;52384711;52401211;16500;0
3873;ENSG00000226210;;12;73725;91218;17493;0
3874;ENSG00000226318;;10;69720459;69721221;762;0
3875;ENSG00000226381;;10;81422844;81526085;103241;0
3876;ENSG00000226396;RPS14P3;1;19934608;19935062;454;0
3877;ENSG00000226415;TPI1P1;1;77165474;77166223;749;0
3878;ENSG00000226419;SLC16A1-AS1;1;113499037;113542118;43081;0
3879;ENSG00000226472;;12;31149973;31158938;8965;0
3880;ENSG00000226476;;1;61005921;61106163;100242;0
3881;ENSG00000226499;;1;45309593;45309754;161;0
3882;ENSG00000226578;;10;38064299;38073059;8760;0
3883;ENSG00000226688;ENTPD1-AS1;10;97512963;97849995;337032;0
3884;ENSG00000226711;FAM66C;12;8332805;8368747;35942;0
3885;ENSG00000226754;;1;53704282;53708455;4173;1
3886;ENSG00000226828;;1;244080704;244210619;129915;0
3887;ENSG00000226849;;1;11128528;11133154;4626;0
3888;ENSG00000226862;;1;202573396;202574421;1025;0
3889;ENSG00000226864;ATE1-AS1;10;123687827;123711480;23653;0
3890;ENSG00000226891;;1;65437908;65468159;30251;0
3891;ENSG00000226920;;1;229576031;229576767;736;0
3892;ENSG00000226944;;1;6264900;6265840;940;0
3893;ENSG00000227001;NBPF2P;1;21751118;21754460;3342;0
3894;ENSG00000227081;;12;3320775;3321096;321;0
3895;ENSG00000227082;;1;121138614;121204983;66369;0
3896;ENSG00000227097;;11;82400571;82400944;373;0
3897;ENSG00000227128;LBX1-AS1;10;102989351;103029905;40554;1
3898;ENSG00000227165;WDR11-AS1;10;122521324;122610721;89397;0
3899;ENSG00000227232;WASH7P;1;14363;29806;15443;0
3900;ENSG00000227242;NBPF13P;1;146490895;146596107;105212;0
3901;ENSG00000227244;LINC00845;10;62776033;62786178;10145;0
3902;ENSG00000227258;SMIM2-AS1;13;44716682;44813010;96328;0
3903;ENSG00000227268;KLLN;10;89618918;89623194;4276;0
3904;ENSG00000227345;PARG;10;51026325;51130715;104390;0
3905;ENSG00000227372;TP73-AS1;1;3652548;3663900;11352;0
3906;ENSG00000227376;FTH1P16;11;77445520;77446071;551;0
3907;ENSG00000227487;NCAM1-AS1;11;113140254;113144623;4369;0
3908;ENSG00000227496;;1;225888306;225939945;51639;0
3909;ENSG00000227533;SLC2A1-AS1;1;43424720;43449029;24309;0
3910;ENSG00000227540;;10;75012549;75014107;1558;0
3911;ENSG00000227579;;1;177362423;177566844;204421;0
3912;ENSG00000227583;;10;70434113;70434857;744;0
3913;ENSG00000227615;;11;74456761;74457159;398;0
3914;ENSG00000227671;MIR3916;1;247353153;247374158;21005;0
3915;ENSG00000227726;;11;70323382;70323697;315;0
3916;ENSG00000227740;;1;175873898;175889649;15751;1
3917;ENSG00000227781;GLUD1P2;10;48952491;48980269;27778;0
3918;ENSG00000227811;FAM212B-AS1;1;112282463;112290420;7957;0
3919;ENSG00000227825;SLC9A7P1;12;98847613;98850923;3310;0
3920;ENSG00000227848;SUCLA2-AS1;13;48575525;48576688;1163;0
3921;ENSG00000227896;;10;88281702;88284858;3156;0
3922;ENSG00000227953;;1;246939315;246955687;16372;0
3923;ENSG00000227963;;1;110828997;110881793;52796;0
3924;ENSG00000228063;;1;219259944;219347303;87359;0
3925;ENSG00000228065;;10;67330096;67526299;196203;1
3926;ENSG00000228084;;1;100433939;100435420;1481;0
3927;ENSG00000228106;;1;222988364;223010726;22362;0
3928;ENSG00000228110;ST13P19;1;210438981;210440587;1606;0
3929;ENSG00000228126;LINC00568;1;150488233;150490508;2275;0
3930;ENSG00000228140;;1;15729475;15735929;6454;0
3931;ENSG00000228172;;1;26143240;26146263;3023;0
3932;ENSG00000228175;GEMIN8P4;1;90459152;90459880;728;0
3933;ENSG00000228192;;1;43300352;43312093;11741;0
3934;ENSG00000228238;;1;186547411;186548431;1020;0
3935;ENSG00000228288;PCAT6;1;202780082;202781284;1202;0
3936;ENSG00000228327;;1;700237;714006;13769;0
3937;ENSG00000228436;;1;39325672;39385068;59396;0
3938;ENSG00000228463;;1;227615;267253;39638;0
3939;ENSG00000228477;;1;40428352;40429076;724;0
3940;ENSG00000228502;EEF1A1P11;1;96912486;96913874;1388;0
3941;ENSG00000228549;;1;17197440;17200587;3147;0
3942;ENSG00000228589;SPCS2P4;1;28421582;28422933;1351;0
3943;ENSG00000228594;C1orf233;1;1533392;1535476;2084;0
3944;ENSG00000228606;;1;160231534;160232568;1034;0
3945;ENSG00000228701;TNKS2-AS1;10;93542596;93558048;15452;0
3946;ENSG00000228702;;10;46221142;46221486;344;0
3947;ENSG00000228741;;13;24553949;24609166;55217;0
3948;ENSG00000228794;LINC01128;1;762988;794826;31838;0
3949;ENSG00000228828;;10;38107534;38109910;2376;0
3950;ENSG00000229081;LINC01165;10;134334331;134335953;1622;0
3951;ENSG00000229097;CALM2P2;10;71923441;71923880;439;0
3952;ENSG00000229117;RPL41;12;56510370;56511727;1357;0
3953;ENSG00000229124;VIM-AS1;10;17256238;17271984;15746;0
3954;ENSG00000229186;ADAM1A;12;112337067;112340042;2975;0
3955;ENSG00000229191;;1;200993077;200997920;4843;0
3956;ENSG00000229294;;1;65745139;65772204;27065;0
3957;ENSG00000229344;;1;568137;568818;681;0
3958;ENSG00000229348;HYI-AS1;1;43919598;43922666;3068;0
3959;ENSG00000229368;;11;3875842;3876629;787;0
3960;ENSG00000229404;LINC00858;10;86039736;86054415;14679;0
3961;ENSG00000229427;ANKRD26P4;13;31885426;31887058;1632;0
3962;ENSG00000229447;;1;31736092;31736528;436;0
3963;ENSG00000229656;;10;33247773;33371030;123257;0
3964;ENSG00000229659;;10;75182017;75182454;437;0
3965;ENSG00000229715;EEF1DP3;13;32420978;32527609;106631;0
3966;ENSG00000229739;;1;186420213;186420881;668;0
3967;ENSG00000229808;;1;161860623;161861986;1363;0
3968;ENSG00000229874;;1;206135293;206137984;2691;0
3969;ENSG00000229932;YWHAZP3;10;23425852;23426590;738;0
3970;ENSG00000229956;ZRANB2-AS2;1;71547007;71955652;408645;0
3971;ENSG00000229989;MIR181A1HG;1;198776622;198906558;129936;0
3972;ENSG00000230026;;1;235524468;235525855;1387;0
3973;ENSG00000230068;CDC42-IT1;1;22385690;22390692;5002;0
3974;ENSG00000230091;TMEM254-AS1;10;81806616;81838668;32052;0
3975;ENSG00000230092;;1;736259;745541;9282;0
3976;ENSG00000230124;;1;180238788;180245359;6571;0
3977;ENSG00000230325;;1;236703394;236713580;10186;0
3978;ENSG00000230415;;1;1210603;1215800;5197;0
3979;ENSG00000230417;LINC00856;10;80008505;80434724;426219;0
3980;ENSG00000230424;;1;19536995;19567198;30203;0
3981;ENSG00000230439;;1;94218480;94241000;22520;0
3982;ENSG00000230445;LRRC37A6P;10;27535279;27548384;13105;0
3983;ENSG00000230461;PROX1-AS1;1;213991094;214160973;169879;0
3984;ENSG00000230498;;1;77533605;77544167;10562;1
3985;ENSG00000230615;;1;44501798;44570647;68849;0
3986;ENSG00000230633;;13;32872291;32872849;558;0
3987;ENSG00000230699;;1;846815;850328;3513;0
3988;ENSG00000230724;LINC01001;11;127115;139612;12497;0
3989;ENSG00000230793;SMARCE1P5;13;45168994;45170218;1224;0
3990;ENSG00000230850;;1;143119061;143233417;114356;0
3991;ENSG00000230880;;1;142618769;142729975;111206;0
3992;ENSG00000230896;;1;46160356;46162747;2391;0
3993;ENSG00000231025;;10;98752207;98755716;3509;0
3994;ENSG00000231050;;1;1822910;1824097;1187;1
3995;ENSG00000231064;;1;155166659;155175286;8627;0
3996;ENSG00000231121;;12;77718421;77966055;247634;0
3997;ENSG00000231181;;1;9636485;9637043;558;0
3998;ENSG00000231187;;10;46951472;46966835;15363;0
3999;ENSG00000231196;;1;147762996;147767966;4970;0
4000;ENSG00000231209;GLUD1P6;10;48169665;48175810;6145;0
4001;ENSG00000231252;;1;61125303;61291256;165953;0
4002;ENSG00000231365;;1;119683019;119818596;135577;0
4003;ENSG00000231407;;1;170429594;170501788;72194;0
4004;ENSG00000231429;;1;121154579;121171134;16555;0
4005;ENSG00000231437;;1;112532392;112541464;9072;0
4006;ENSG00000231473;LINC00441;13;48870649;48877797;7148;1
4007;ENSG00000231503;PTMAP4;12;9392582;9392927;345;0
4008;ENSG00000231563;;1;228595082;228597395;2313;0
4009;ENSG00000231607;DLEU2;13;50601269;50699856;98587;0
4010;ENSG00000231611;;11;116645826;116646592;766;0
4011;ENSG00000231663;;1;234508553;234509339;786;0
4012;ENSG00000231665;OGFOD1P1;13;49784558;49786430;1872;0
4013;ENSG00000231734;;1;143687097;143720401;33304;0
4014;ENSG00000231738;TSPAN19;12;85408094;85430055;21961;0
4015;ENSG00000231752;EMBP1;1;121261143;121310591;49448;0
4016;ENSG00000231767;MIR4426;1;192685313;192685783;470;0
4017;ENSG00000231768;;1;234663637;234667525;3888;0
4018;ENSG00000231793;DOC2GP;11;67380124;67383728;3604;0
4019;ENSG00000231827;;1;153767649;153774567;6918;0
4020;ENSG00000231856;;13;52378433;52387356;8923;1
4021;ENSG00000231865;SIK3-IT1;11;116756762;116761437;4675;0
4022;ENSG00000231871;IPO9-AS1;1;201657387;201798687;141300;0
4023;ENSG00000231920;NEBL-AS1;10;21462943;21463977;1034;0
4024;ENSG00000231999;;1;90048800;90098453;49653;0
4025;ENSG00000232093;;1;155017667;155018594;927;0
4026;ENSG00000232110;;10;91043522;91051882;8360;0
4027;ENSG00000232117;LINC00384;13;30726023;30733758;7735;0
4028;ENSG00000232224;LINC00202-1;10;27220135;27230930;10795;1
4029;ENSG00000232229;LINC00865;10;91589267;91600618;11351;0
4030;ENSG00000232274;;1;143118704;143211070;92366;0
4031;ENSG00000232284;GNG12-AS1;1;68297986;68668670;370684;0
4032;ENSG00000232372;;1;224170456;224175856;5400;0
4033;ENSG00000232450;;1;114241506;114242253;747;0
4034;ENSG00000232489;MFAP1P1;13;31115780;31117034;1254;0
4035;ENSG00000232499;;1;113992322;113993350;1028;0
4036;ENSG00000232527;;1;148928322;148951595;23273;0
4037;ENSG00000232586;;1;180918835;180924023;5188;0
4038;ENSG00000232637;;1;146032648;146253110;220462;0
4039;ENSG00000232656;IDI2-AS1;10;1068606;1090138;21532;0
4040;ENSG00000232721;;1;149230716;149232554;1838;0
4041;ENSG00000232825;;1;99469832;99614408;144576;0
4042;ENSG00000232860;SMG7-AS1;1;183430009;183440881;10872;1
4043;ENSG00000232862;;1;36545667;36547923;2256;0
4044;ENSG00000232872;CTAGE3P;13;52482354;52484757;2403;0
4045;ENSG00000232903;LINC01166;10;134757471;134778793;21322;0
4046;ENSG00000232977;LINC00327;13;24040710;24061603;20893;0
4047;ENSG00000232995;;1;163214295;163291684;77389;0
4048;ENSG00000233012;HDAC1P2;1;220799082;220801398;2316;0
4049;ENSG00000233029;;1;120925634;120933000;7366;0
4050;ENSG00000233030;;1;149757215;149764576;7361;0
4051;ENSG00000233084;;1;249230780;249231242;462;0
4052;ENSG00000233184;;1;101491434;101552821;61387;0
4053;ENSG00000233218;SNX18P16;1;142688379;142688925;546;0
4054;ENSG00000233304;;1;4000673;4015322;14649;0
4055;ENSG00000233325;MIPEPP3;13;21872278;21880512;8234;0
4056;ENSG00000233368;;1;149576594;149577296;702;0
4057;ENSG00000233396;;1;145373054;145382434;9380;0
4058;ENSG00000233421;;1;16860381;16862144;1763;0
4059;ENSG00000233435;AGGF1P2;10;135455590;135456398;808;1
4060;ENSG00000233461;;1;231658134;231664302;6168;0
4061;ENSG00000233469;ST6GALNAC4P1;13;20392261;20392759;498;0
4062;ENSG00000233473;RAD1P2;1;159050923;159051585;662;0
4063;ENSG00000233593;;1;91248543;91317207;68664;0
4064;ENSG00000233602;ERI3-IT1;1;44709080;44709945;865;0
4065;ENSG00000233610;LINC00462;13;49151110;49152224;1114;0
4066;ENSG00000233642;GPR158-AS1;10;25447001;25465205;18204;0
4067;ENSG00000233690;EBAG9P1;10;101457164;101457706;542;0
4068;ENSG00000233871;DLG5-AS1;10;79687130;79689582;2452;0
4069;ENSG00000233930;KRTAP5-AS1;11;1592583;1620414;27831;1
4070;ENSG00000233954;;1;16133679;16134194;515;0
4071;ENSG00000233968;;10;19999257;20017479;18222;1
4072;ENSG00000234043;;10;92912362;92913106;744;0
4073;ENSG00000234134;;10;127407340;127407934;594;0
4074;ENSG00000234144;COX6CP13;1;65764438;65764663;225;0
4075;ENSG00000234225;;1;146473490;146475177;1687;0
4076;ENSG00000234233;KCNH1-IT1;1;211305930;211306716;786;0
4077;ENSG00000234329;;1;46116711;46117498;787;0
4078;ENSG00000234383;CTBP2P8;1;68627444;68628773;1329;0
4079;ENSG00000234420;ZNF37BP;10;43008958;43048270;39312;0
4080;ENSG00000234481;;1;37238741;37241369;2628;0
4081;ENSG00000234518;PTGES3P1;1;89569968;89570450;482;0
4082;ENSG00000234546;;1;9242263;9252148;9885;0
4083;ENSG00000234571;;1;149372292;149379646;7354;0
4084;ENSG00000234608;MAPKAPK5-AS1;12;112277571;112280706;3135;0
4085;ENSG00000234614;;1;151814353;151822861;8508;0
4086;ENSG00000234685;NUS1P2;13;23489790;23490662;872;0
4087;ENSG00000234741;GAS5;1;173833038;173838020;4982;0
4088;ENSG00000234776;C11orf94;11;45928085;45928833;748;1
4089;ENSG00000234807;LINC01135;1;59250823;59365384;114561;0
4090;ENSG00000234835;PHBP13;13;35825207;35825966;759;0
4091;ENSG00000234917;;1;43144406;43147325;2919;0
4092;ENSG00000234964;FABP5P7;11;59548786;59549195;409;0
4093;ENSG00000234975;FTH1P2;1;228823162;228823574;412;0
4094;ENSG00000234996;;1;202830882;202844369;13487;0
4095;ENSG00000235010;;10;133994729;133999466;4737;0
4096;ENSG00000235049;LINC00940;12;2038368;2045740;7372;0
4097;ENSG00000235098;ANKRD65;1;1353800;1357149;3349;0
4098;ENSG00000235100;;10;91426938;91459428;32490;0
4099;ENSG00000235162;C12orf75;12;105629068;105789875;160807;0
4100;ENSG00000235245;;10;135108691;135109481;790;0
4101;ENSG00000235316;DUSP8P5;10;75491582;75493396;1814;0
4102;ENSG00000235363;SNRPGP10;1;205320375;205320599;224;0
4103;ENSG00000235373;;1;677193;685396;8203;0
4104;ENSG00000235398;LINC00623;1;144275918;144341756;65838;0
4105;ENSG00000235423;;12;123736577;123746030;9453;0
4106;ENSG00000235449;;1;202736357;202736546;189;0
4107;ENSG00000235477;;1;161337812;161341754;3942;0
4108;ENSG00000235501;;1;95393122;95428826;35704;0
4109;ENSG00000235527;;1;114466622;114472114;5492;0
4110;ENSG00000235545;;1;63154153;63176365;22212;0
4111;ENSG00000235565;;1;95086707;95089740;3033;0
4112;ENSG00000235618;;10;51780942;51827563;46621;0
4113;ENSG00000235823;LINC00263;10;102133372;102143125;9753;0
4114;ENSG00000235903;CPB2-AS1;13;46626941;46687467;60526;0
4115;ENSG00000235919;ASH1L-AS1;1;155531821;155533775;1954;0
4116;ENSG00000235999;;1;149287451;149291743;4292;0
4117;ENSG00000236021;;1;176176784;176198466;21682;0
4118;ENSG00000236066;;1;113550876;113589677;38801;0
4119;ENSG00000236114;;10;44018704;44020665;1961;0
4120;ENSG00000236200;KDM4A-AS1;1;44165436;44173809;8373;0
4121;ENSG00000236263;;1;155180942;155183610;2668;1
4122;ENSG00000236264;RPL26P30;11;2356362;2357006;644;0
4123;ENSG00000236287;ZBED5;11;10833621;10880343;46722;0
4124;ENSG00000236290;EEF1GP7;1;53038786;53039488;702;0
4125;ENSG00000236333;TRHDE-AS1;12;72647288;72668687;21399;1
4126;ENSG00000236358;;1;234492752;234501574;8822;0
4127;ENSG00000236423;LINC01134;1;3816936;3833789;16853;0
4128;ENSG00000236514;;10;38146668;38148038;1370;0
4129;ENSG00000236552;RPL13AP5;10;98510045;98510675;630;0
4130;ENSG00000236577;SNRPGP14;13;50063106;50063500;394;0
4131;ENSG00000236624;CCDC163P;1;45959538;45965751;6213;0
4132;ENSG00000236662;;10;102740264;102745371;5107;0
4133;ENSG00000236698;EIF1AXP1;1;17012116;17012550;434;0
4134;ENSG00000236710;;11;3105623;3106673;1050;0
4135;ENSG00000236723;;1;53676128;53679447;3319;0
4136;ENSG00000236778;INTS6-AS1;13;52026503;52126500;99997;0
4137;ENSG00000236806;;1;146695146;146695940;794;0
4138;ENSG00000236810;;1;24086872;24104777;17905;0
4139;ENSG00000236915;;1;87036864;87158886;122022;0
4140;ENSG00000236943;;1;144456138;144521970;65832;0
4141;ENSG00000236947;;1;156416204;156426369;10165;1
4142;ENSG00000236993;GAPDHP21;10;57427101;57428110;1009;0
4143;ENSG00000237036;ZEB1-AS1;10;31495207;31609376;114169;0
4144;ENSG00000237076;;1;84255963;84267148;11185;0
4145;ENSG00000237096;;1;166864948;166877317;12369;0
4146;ENSG00000237101;;1;224407315;224415745;8430;1
4147;ENSG00000237149;ZNF503-AS2;10;77160759;77168738;7979;0
4148;ENSG00000237188;;1;146644350;146683136;38786;0
4149;ENSG00000237200;ZBTB40-IT1;1;22843967;22846201;2234;0
4150;ENSG00000237248;LINC00987;12;9392599;9395635;3036;0
4151;ENSG00000237250;;1;238025475;238091621;66146;0
4152;ENSG00000237276;ANO7P1;1;16542404;16554522;12118;0
4153;ENSG00000237301;;1;15912631;15930121;17490;0
4154;ENSG00000237337;;1;50639978;50641540;1562;0
4155;ENSG00000237399;PITRM1-AS1;10;3183824;3210164;26340;0
4156;ENSG00000237436;;1;6843952;6844903;951;0
4157;ENSG00000237457;;1;190447681;190449865;2184;0
4158;ENSG00000237489;LINC00959;10;131864638;131909081;44443;0
4159;ENSG00000237491;;1;714150;745440;31290;0
4160;ENSG00000237637;FRY-AS1;13;32599451;32605776;6325;0
4161;ENSG00000237683;;1;134901;139379;4478;0
4162;ENSG00000237766;GGTA2P;12;67659622;67660746;1124;0
4163;ENSG00000237781;;1;150521040;150530200;9160;0
4164;ENSG00000237840;FAM21FP;10;46201879;46222679;20800;0
4165;ENSG00000237928;;1;61405911;61436448;30537;0
4166;ENSG00000237943;PRKCQ-AS1;10;6622381;6658414;36033;0
4167;ENSG00000237950;;1;44410042;44412223;2181;0
4168;ENSG00000237973;;1;566454;567996;1542;0
4169;ENSG00000237975;FLG-AS1;1;152140601;152339163;198562;0
4170;ENSG00000237976;;1;151319443;151320503;1060;0
4171;ENSG00000238021;ARMC4P1;10;27547691;27577753;30062;0
4172;ENSG00000238061;;1;185249976;185250948;972;0
4173;ENSG00000238105;GOLGA2P5;12;100550135;100567437;17302;0
4174;ENSG00000238142;;1;17215033;17216144;1111;0
4175;ENSG00000238184;CD81-AS1;11;2349979;2399222;49243;0
4176;ENSG00000238198;;1;113554309;113615727;61418;0
4177;ENSG00000238243;OR2W3;1;248031277;248060449;29172;0
4178;ENSG00000238260;;1;3539754;3541307;1553;0
4179;ENSG00000238261;;1;143377281;143401533;24252;0
4180;ENSG00000238286;SLC35E1P1;13;21181407;21182270;863;1
4181;ENSG00000238287;;1;40958829;40974333;15504;0
4182;ENSG00000238290;;1;8086798;8182762;95964;0
4183;ENSG00000238365;RNU7-57P;1;154311219;154311278;59;0
4184;ENSG00000238437;;11;93530379;93530479;100;0
4185;ENSG00000238924;RNU7-163P;10;1088233;1088295;62;0
4186;ENSG00000238975;;1;113195210;113195310;100;0
4187;ENSG00000239149;SNORA59A;1;12567300;12567451;151;0
4188;ENSG00000239306;RBM14;11;66384053;66394818;10765;0
4189;ENSG00000239335;;12;66524531;66528229;3698;0
4190;ENSG00000239559;RPL37P2;11;67450243;67450529;286;0
4191;ENSG00000239617;;12;49297201;49297596;395;0
4192;ENSG00000239636;;1;36035414;36043330;7916;0
4193;ENSG00000239665;;10;13652047;13710299;58252;0
4194;ENSG00000239776;;12;127650616;127650672;56;0
4195;ENSG00000239827;SUGT1P3;13;41482295;41495910;13615;0
4196;ENSG00000239881;RPS27P25;12;120807243;120809491;2248;0
4197;ENSG00000239883;;10;46349541;46411619;62078;0
4198;ENSG00000239887;C1orf226;1;162336698;162356600;19902;0
4199;ENSG00000239903;;1;149646785;149649302;2517;0
4200;ENSG00000240038;AMY2B;1;104096437;104122156;25719;0
4201;ENSG00000240219;;1;204595903;204598840;2937;0
4202;ENSG00000240244;GAPDHP33;1;120138790;120139802;1012;0
4203;ENSG00000240291;;10;18802044;18834580;32536;0
4204;ENSG00000240342;RPS2P5;12;118683877;118684807;930;0
4205;ENSG00000240370;RPL13P5;12;6982553;6993905;11352;0
4206;ENSG00000240399;;12;48448596;48449374;778;0
4207;ENSG00000240441;;12;108113376;108113910;534;0
4208;ENSG00000240520;UOX;1;84831111;84863514;32403;0
4209;ENSG00000240618;;1;694412;700305;5893;0
4210;ENSG00000240731;;1;1252961;1254069;1108;0
4211;ENSG00000240771;ARHGEF25;12;58003963;58013162;9199;0
4212;ENSG00000240996;;10;91454052;91457685;3633;1
4213;ENSG00000241014;;1;35439957;35450914;10957;0
4214;ENSG00000241058;NSUN6;10;18834490;18940551;106061;0
4215;ENSG00000241170;;11;74587331;74631067;43736;0
4216;ENSG00000241255;;11;33258554;33258955;401;0
4217;ENSG00000241547;;1;27651820;27652287;467;0
4218;ENSG00000241678;;11;6707122;6707600;478;0
4219;ENSG00000241782;;11;77579768;77580241;473;0
4220;ENSG00000241860;;1;141474;173862;32388;0
4221;ENSG00000241975;TCEB1P19;1;89294785;89295102;317;0
4222;ENSG00000242125;SNHG3;1;28832492;28837404;4912;0
4223;ENSG00000242193;;1;177975271;178007085;31814;0
4224;ENSG00000242252;BGLAP;1;156211753;156213112;1359;0
4225;ENSG00000242338;BMS1P4;10;75475601;75490227;14626;0
4226;ENSG00000242349;NPPA-AS1;1;11901074;11908136;7062;0
4227;ENSG00000242485;MRPL20;1;1337288;1342693;5405;0
4228;ENSG00000242600;MBL1P;10;81664654;81710092;45438;0
4229;ENSG00000242689;CNTF;11;58390146;58393198;3052;0
4230;ENSG00000242715;CCDC169;13;36801182;36871977;70795;0
4231;ENSG00000242861;;1;226028584;226034223;5639;0
4232;ENSG00000243015;RN7SL737P;12;93903263;93903544;281;0
4233;ENSG00000243024;RPS11P6;12;64616117;64790845;174728;0
4234;ENSG00000243051;RN7SL269P;1;169927085;169927387;302;0
4235;ENSG00000243155;;1;180913178;180945618;32440;0
4236;ENSG00000243323;PTPRVP;1;202137179;202158583;21404;0
4237;ENSG00000243364;EFNA4;1;155036207;155042029;5822;0
4238;ENSG00000243406;MRPS31P5;13;52741844;52768600;26756;0
4239;ENSG00000243431;RPL5P30;11;118431405;118432295;890;0
4240;ENSG00000243452;NBPF15;1;148555979;148596267;40288;0
4241;ENSG00000243480;AMY2A;1;104159999;104168402;8403;0
4242;ENSG00000243660;ZNF487;10;43932282;43991517;59235;0
4243;ENSG00000243709;LEFTY1;1;226073982;226099082;25100;0
4244;ENSG00000243710;WDR65;1;43637820;43720029;82209;0
4245;ENSG00000243725;TTC4;1;55181495;55208330;26835;0
4246;ENSG00000243854;RN7SL67P;12;19456414;19456710;296;0
4247;ENSG00000243960;;1;111981260;111983986;2726;0
4248;ENSG00000243970;PPIEL;1;39997510;40024379;26869;0
4249;ENSG00000244038;DDOST;1;20978270;20988000;9730;0
4250;ENSG00000244242;IFITM10;11;1753640;1771821;18181;0
4251;ENSG00000244313;;11;46450163;46450700;537;0
4252;ENSG00000244398;;11;16996240;16996560;320;0
4253;ENSG00000244411;KRTAP5-7;11;71238313;71239210;897;0
4254;ENSG00000244716;;1;109534878;109535489;611;0
4255;ENSG00000244754;N4BP2L2;13;33006554;33112970;106416;0
4256;ENSG00000245017;;12;98879322;98897633;18311;0
4257;ENSG00000245105;A2M-AS1;12;9217773;9220651;2878;1
4258;ENSG00000245156;;11;66037303;66045996;8693;0
4259;ENSG00000245248;USP2-AS1;11;119252488;119397374;144886;0
4260;ENSG00000245498;;11;124670346;124704383;34037;0
4261;ENSG00000245532;NEAT1;11;65190245;65213011;22766;1
4262;ENSG00000245552;;11;94883703;94967268;83565;0
4263;ENSG00000245571;;11;58897606;58910488;12882;0
4264;ENSG00000245573;BDNF-AS;11;27528385;27719721;191336;0
4265;ENSG00000245614;DDX11-AS1;12;31173697;31226781;53084;0
4266;ENSG00000245904;;12;92539349;92583436;44087;0
4267;ENSG00000246067;RAB30-AS1;11;82783108;82817761;34653;0
4268;ENSG00000246100;LINC00900;11;115624966;115631345;6379;0
4269;ENSG00000246174;KCTD21-AS1;11;77850817;77886369;35552;1
4270;ENSG00000246203;;1;155584517;155630036;45519;0
4271;ENSG00000246250;;11;43851259;43902276;51017;0
4272;ENSG00000246273;SBF2-AS1;11;9779839;9832866;53027;0
4273;ENSG00000246308;;11;10830844;10844478;13634;1
4274;ENSG00000246363;;12;89404458;89413456;8998;0
4275;ENSG00000246695;RASSF8-AS1;12;26092262;26112698;20436;0
4276;ENSG00000246705;H2AFJ;12;14927270;14930936;3666;0
4277;ENSG00000246820;;11;8190714;8200450;9736;0
4278;ENSG00000246889;;11;70218352;70244594;26242;0
4279;ENSG00000246985;SOCS2-AS1;12;93936239;93965544;29305;0
4280;ENSG00000247077;PGAM5;12;133287405;133299228;11823;0
4281;ENSG00000247095;MIR210HG;11;565660;568457;2797;0
4282;ENSG00000247137;;11;82895533;82904836;9303;0
4283;ENSG00000247151;CSTF3-AS1;11;33183203;33213144;29941;0
4284;ENSG00000247157;;12;11700964;11743303;42339;0
4285;ENSG00000247271;ZBED5-AS1;11;10879806;10928349;48543;0
4286;ENSG00000247363;;12;69068151;69081535;13384;0
4287;ENSG00000247373;;12;124066767;124069662;2895;0
4288;ENSG00000247416;;11;112830002;112834182;4180;0
4289;ENSG00000247498;;12;13080660;13137579;56919;0
4290;ENSG00000247595;SPTY2D1-AS1;11;18621334;18631802;10468;0
4291;ENSG00000247675;LRP4-AS1;11;46867963;46895947;27984;0
4292;ENSG00000247853;;12;6687788;6693905;6117;0
4293;ENSG00000247934;;12;28316231;28343299;27068;1
4294;ENSG00000248008;DYNLL1-AS1;12;120928131;120933743;5612;0
4295;ENSG00000248027;;11;100554893;100558686;3793;0
4296;ENSG00000248333;CDK11B;1;1570603;1590473;19870;0
4297;ENSG00000248485;PCP4L1;1;161228517;161255240;26723;0
4298;ENSG00000248527;MTATP6P1;1;569076;569756;680;0
4299;ENSG00000248593;DSTNP2;12;6993846;6994950;1104;0
4300;ENSG00000248671;;11;71505409;71529284;23875;0
4301;ENSG00000248712;CCDC153;11;119060347;119067479;7132;0
4302;ENSG00000248835;;1;54635333;54637997;2664;0
4303;ENSG00000249087;C1orf213;1;23695490;23698332;2842;0
4304;ENSG00000249456;;10;126605712;126631450;25738;0
4305;ENSG00000249550;;12;114117264;114211488;94224;0
4306;ENSG00000249602;;1;151735860;151741977;6117;0
4307;ENSG00000249790;;12;8940853;8948385;7532;0
4308;ENSG00000250091;DNAH10OS;12;124410971;124419531;8560;0
4309;ENSG00000250132;;12;1083299;1100356;17057;0
4310;ENSG00000250303;;11;112141472;112233257;91785;0
4311;ENSG00000250397;;11;856880;859795;2915;0
4312;ENSG00000250404;;11;3837982;3843130;5148;0
4313;ENSG00000250510;GPR162;12;6930711;6939136;8425;0
4314;ENSG00000250519;;11;93971316;94012372;41056;0
4315;ENSG00000250770;;12;3405368;3409390;4022;0
4316;ENSG00000250790;;12;133488056;133489173;1117;0
4317;ENSG00000250899;;12;3150603;3154116;3513;0
4318;ENSG00000250959;GLUD1P3;10;75490320;75497069;6749;0
4319;ENSG00000251143;;11;71725337;71731956;6619;1
4320;ENSG00000251323;;11;78135028;78140882;5854;0
4321;ENSG00000251562;MALAT1;11;65265233;65273940;8707;0
4322;ENSG00000251661;;11;318640;325631;6991;0
4323;ENSG00000251695;;12;69186125;69187743;1618;0
4324;ENSG00000251795;;1;93303575;93303627;52;0
4325;ENSG00000252817;;1;154226921;154226997;76;0
4326;ENSG00000252874;;11;47841755;47841844;89;0
4327;ENSG00000253051;;13;45910449;45910582;133;1
4328;ENSG00000253304;TMEM200B;1;29445940;29450447;4507;0
4329;ENSG00000253368;TRNP1;1;27320198;27327389;7191;0
4330;ENSG00000253626;EIF5AL1;10;81272357;81276188;3831;0
4331;ENSG00000253710;ALG11;13;52586534;52603800;17266;0
4332;ENSG00000253719;ATXN7L3B;12;74931551;74935223;3672;0
4333;ENSG00000253771;TPTE2P1;13;25498815;25542625;43810;0
4334;ENSG00000253797;UTP14C;13;52598827;52607736;8909;0
4335;ENSG00000253973;;11;9025709;9086701;60992;0
4336;ENSG00000254016;ALG1L10P;12;8380330;8384360;4030;0
4337;ENSG00000254400;;11;6624872;6625650;778;0
4338;ENSG00000254409;;11;43942609;44022707;80098;0
4339;ENSG00000254418;;11;14284392;14295237;10845;0
4340;ENSG00000254427;;11;45376922;45387672;10750;0
4341;ENSG00000254454;RCC2P6;11;62138618;62140640;2022;0
4342;ENSG00000254459;;11;77540700;77583308;42608;0
4343;ENSG00000254463;;11;43487942;43488421;479;0
4344;ENSG00000254469;;11;71576555;71639700;63145;0
4345;ENSG00000254470;AP5B1;11;65543364;65548273;4909;0
4346;ENSG00000254489;;11;30605677;30652055;46378;0
4347;ENSG00000254510;;11;66176629;66184608;7979;0
4348;ENSG00000254539;;1;144833168;144835867;2699;0
4349;ENSG00000254551;;11;82920473;82924421;3948;1
4350;ENSG00000254577;;11;43411833;43417045;5212;0
4351;ENSG00000254595;;11;6509416;6510607;1191;0
4352;ENSG00000254598;CSNK2A3;11;11373489;11374904;1415;0
4353;ENSG00000254602;;11;57405497;57420263;14766;0
4354;ENSG00000254604;;11;70128473;70209474;81001;0
4355;ENSG00000254612;;11;127810808;127811549;741;0
4356;ENSG00000254614;;11;64945077;64949305;4228;0
4357;ENSG00000254635;WAC-AS1;10;28811581;28821672;10091;0
4358;ENSG00000254665;;11;8714904;8718154;3250;0
4359;ENSG00000254667;;11;123301058;123306427;5369;0
4360;ENSG00000254670;;11;13022637;13030706;8069;0
4361;ENSG00000254671;STT3A-AS1;11;125440180;125462473;22293;0
4362;ENSG00000254676;;11;82891186;82895562;4376;0
4363;ENSG00000254682;;11;71159720;71163203;3483;0
4364;ENSG00000254685;FPGT;1;74663896;74699770;35874;0
4365;ENSG00000254694;;11;126078506;126078922;416;0
4366;ENSG00000254726;MEX3A;1;156041804;156051789;9985;0
4367;ENSG00000254732;;11;57509635;57560715;51080;0
4368;ENSG00000254746;;11;45511239;45564024;52785;0
4369;ENSG00000254768;;11;22305276;22359791;54515;0
4370;ENSG00000254783;;11;85994969;85995710;741;0
4371;ENSG00000254815;;11;557595;560107;2512;0
4372;ENSG00000254837;;11;74204411;74209578;5167;0
4373;ENSG00000254838;GVINP1;11;6734767;6767670;32903;0
4374;ENSG00000254860;TMEM9B-AS1;11;8986222;8999074;12852;1
4375;ENSG00000254862;;11;27493276;27503980;10704;0
4376;ENSG00000254872;;11;1049880;1055284;5404;0
4377;ENSG00000254905;;11;126162817;126164149;1332;0
4378;ENSG00000254910;;11;310139;311141;1002;0
4379;ENSG00000254911;SCARNA9;11;93454679;93455032;353;0
4380;ENSG00000254921;;11;8056993;8061265;4272;0
4381;ENSG00000254941;;11;124677718;124678165;447;0
4382;ENSG00000254944;ATP5F1P5;11;122831035;122831794;759;0
4383;ENSG00000254966;;11;18728084;18762115;34031;0
4384;ENSG00000254974;;11;74196625;74197096;471;0
4385;ENSG00000254986;DPP3;11;66247484;66277130;29646;0
4386;ENSG00000254990;;11;111639392;111649074;9682;0
4387;ENSG00000255031;;11;67818207;67821229;3022;0
4388;ENSG00000255062;;11;126164193;126174213;10020;0
4389;ENSG00000255100;;11;76493625;76494106;481;0
4390;ENSG00000255103;KIAA0754;1;39876151;39882154;6003;0
4391;ENSG00000255121;;11;118865534;118868714;3180;0
4392;ENSG00000255135;;11;76152382;76155700;3318;0
4393;ENSG00000255136;;11;74919099;74952218;33119;0
4394;ENSG00000255139;;11;59383902;59407334;23432;0
4395;ENSG00000255142;;11;781645;782105;460;0
4396;ENSG00000255153;TOLLIP-AS1;11;1330999;1331937;938;0
4397;ENSG00000255158;;11;665910;678391;12481;0
4398;ENSG00000255160;;11;19321430;19329905;8475;0
4399;ENSG00000255176;;11;118507338;118508815;1477;0
4400;ENSG00000255197;;11;47404699;47430741;26042;0
4401;ENSG00000255200;;11;64941588;64943941;2353;0
4402;ENSG00000255222;SETP17;11;86005802;86006618;816;0
4403;ENSG00000255234;;11;82997171;83134559;137388;0
4404;ENSG00000255240;;11;58701116;58826132;125016;0
4405;ENSG00000255248;;11;121899063;121987031;87968;1
4406;ENSG00000255284;;11;777578;784297;6719;0
4407;ENSG00000255306;;11;67792277;67797928;5651;0
4408;ENSG00000255362;;11;75922000;75927069;5069;0
4409;ENSG00000255372;;11;22282755;22283802;1047;0
4410;ENSG00000255406;;11;133896882;133898013;1131;0
4411;ENSG00000255433;;11;56615954;56645554;29600;0
4412;ENSG00000255434;;11;75307189;75308315;1126;0
4413;ENSG00000255435;;11;118382626;118401809;19183;0
4414;ENSG00000255449;;11;77577458;77581137;3679;0
4415;ENSG00000255455;;11;130736149;130740142;3993;0
4416;ENSG00000255468;;11;66115421;66132275;16854;0
4417;ENSG00000255471;;11;86603256;86636079;32823;0
4418;ENSG00000255507;;11;75514476;75526451;11975;0
4419;ENSG00000255508;MIR3654;11;62327075;62359003;31928;0
4420;ENSG00000255517;;11;66240961;66247704;6743;1
4421;ENSG00000255537;;11;125365110;125369424;4314;0
4422;ENSG00000255545;;11;134306367;134375555;69188;0
4423;ENSG00000255547;RPA2P3;11;100207588;100208357;769;0
4424;ENSG00000255561;FDXACB1;11;111744780;111751967;7187;0
4425;ENSG00000255608;;12;4948121;4951841;3720;0
4426;ENSG00000255618;;12;119210837;119212942;2105;0
4427;ENSG00000255651;;11;63534816;63536113;1297;0
4428;ENSG00000255669;;12;2870366;2879621;9255;0
4429;ENSG00000255670;;12;12638287;12644515;6228;0
4430;ENSG00000255693;;12;65277174;65371302;94128;1
4431;ENSG00000255710;;11;113691578;113692607;1029;0
4432;ENSG00000255717;SNHG1;11;62619460;62623386;3926;0
4433;ENSG00000255794;RMST;12;97825431;97958813;133382;0
4434;ENSG00000255823;MTRNR2L8;11;10529434;10530723;1289;0
4435;ENSG00000255836;;12;7591376;7592586;1210;1
4436;ENSG00000255837;TAS2R20;12;11149094;11150474;1380;0
4437;ENSG00000255856;;12;122445340;122457920;12580;0
4438;ENSG00000255857;PXN-AS1;12;120639094;120650941;11847;0
4439;ENSG00000255864;;12;24366190;24715524;349334;1
4440;ENSG00000255893;;11;94206074;94206736;662;0
4441;ENSG00000255910;;12;19928385;20162871;234486;0
4442;ENSG00000255916;;12;132906436;132908161;1725;0
4443;ENSG00000255920;CCND2-AS2;12;4361901;4384231;22330;0
4444;ENSG00000255929;;11;94278496;94473521;195025;0
4445;ENSG00000255966;;12;6641456;6642664;1208;0
4446;ENSG00000255983;;12;5497755;5515817;18062;0
4447;ENSG00000255992;;12;132409281;132413896;4615;0
4448;ENSG00000256030;CBX3P4;12;2896097;2903461;7364;0
4449;ENSG00000256031;;12;119438581;119439647;1066;0
4450;ENSG00000256092;;12;123848415;123850660;2245;0
4451;ENSG00000256116;;11;63996686;64001824;5138;0
4452;ENSG00000256139;;12;109549023;109563399;14376;0
4453;ENSG00000256150;;12;2851792;2881074;29282;0
4454;ENSG00000256152;;12;123349882;123351568;1686;0
4455;ENSG00000256164;CCND2-AS1;12;4357931;4385350;27419;0
4456;ENSG00000256185;;12;26488797;26489883;1086;0
4457;ENSG00000256189;;11;73702328;73703225;897;0
4458;ENSG00000256196;;11;60685941;60692869;6928;0
4459;ENSG00000256223;ZNF10;12;133707161;133736051;28890;0
4460;ENSG00000256238;;12;16552208;16555340;3132;0
4461;ENSG00000256269;HMBS;11;118955576;118964259;8683;0
4462;ENSG00000256274;TAS2R64P;12;11229368;11231770;2402;0
4463;ENSG00000256299;;12;131295366;131297167;1801;0
4464;ENSG00000256304;;12;122806669;122808883;2214;0
4465;ENSG00000256360;;11;73639578;73641417;1839;0
4466;ENSG00000256393;;12;93477374;93477451;77;0
4467;ENSG00000256417;;12;5399646;5492819;93173;1
4468;ENSG00000256427;;12;9399093;9410556;11463;0
4469;ENSG00000256436;TAS2R31;12;11182986;11184006;1020;0
4470;ENSG00000256443;;11;61306988;61309731;2743;0
4471;ENSG00000256533;;11;114323786;114324845;1059;0
4472;ENSG00000256537;;12;11323963;11324164;201;0
4473;ENSG00000256552;;12;8472977;8522151;49174;0
4474;ENSG00000256576;;12;132671287;132674240;2953;0
4475;ENSG00000256589;ENPP7P5;12;8407123;8461445;54322;0
4476;ENSG00000256591;;11;61196692;61253294;56602;0
4477;ENSG00000256594;;12;9787188;9811008;23820;0
4478;ENSG00000256596;;12;124690774;124693564;2790;0
4479;ENSG00000256625;;12;27274843;27300597;25754;0
4480;ENSG00000256651;;12;10983673;10984615;942;0
4481;ENSG00000256663;;12;20704524;20705946;1422;0
4482;ENSG00000256667;KLRAP1;12;10741077;10752434;11357;1
4483;ENSG00000256673;;12;9550951;9567447;16496;0
4484;ENSG00000256690;;11;62599706;62601515;1809;0
4485;ENSG00000256723;;11;73706017;73707196;1179;0
4486;ENSG00000256742;;12;122018697;122031409;12712;0
4487;ENSG00000256763;;12;126652781;126656212;3431;0
4488;ENSG00000256885;;11;95556681;95557336;655;0
4489;ENSG00000256902;;12;2861763;2862298;535;0
4490;ENSG00000256940;;11;64013436;64015689;2253;0
4491;ENSG00000256967;;12;7281675;7283794;2119;0
4492;ENSG00000256973;;12;22613453;22616848;3395;0
4493;ENSG00000257027;;12;9811163;9814681;3518;0
4494;ENSG00000257052;;11;60674261;60677214;2953;0
4495;ENSG00000257061;;12;126842580;126843442;862;0
4496;ENSG00000257086;;11;64014411;64016966;2555;0
4497;ENSG00000257110;;13;20247071;20247197;126;0
4498;ENSG00000257159;;12;58360841;58362182;1341;0
4499;ENSG00000257167;TMPO-AS1;12;98906751;98910200;3449;0
4500;ENSG00000257176;;12;29433351;29470781;37430;0
4501;ENSG00000257218;GATC;12;120884241;120899389;15148;0
4502;ENSG00000257225;;12;42853168;42859930;6762;0
4503;ENSG00000257242;C12orf79;12;92378756;92536690;157934;0
4504;ENSG00000257261;;12;46777462;46850051;72589;0
4505;ENSG00000257298;;12;50579363;50585146;5783;0
4506;ENSG00000257315;ZBED6;1;203765437;203769686;4249;0
4507;ENSG00000257337;;12;53408380;53448222;39842;0
4508;ENSG00000257354;;12;62996532;63007855;11323;0
4509;ENSG00000257433;;12;48099868;48136077;36209;0
4510;ENSG00000257489;;12;100566974;100593561;26587;0
4511;ENSG00000257497;;12;75877904;75883600;5696;1
4512;ENSG00000257499;;12;58117544;58119448;1904;0
4513;ENSG00000257501;;12;98107190;98155637;48447;1
4514;ENSG00000257509;;12;56155334;56156412;1078;0
4515;ENSG00000257511;;12;32879317;32880321;1004;0
4516;ENSG00000257526;;12;76956074;77009211;53137;0
4517;ENSG00000257545;;12;106889736;107168696;278960;0
4518;ENSG00000257557;;12;80328681;80334448;5767;0
4519;ENSG00000257576;;12;56904786;56906487;1701;1
4520;ENSG00000257624;;12;112438543;112438789;246;0
4521;ENSG00000257660;;12;49182930;49184318;1388;0
4522;ENSG00000257696;;12;100536836;100538449;1613;0
4523;ENSG00000257698;;12;58325311;58329958;4647;0
4524;ENSG00000257718;;12;39300253;39303394;3141;0
4525;ENSG00000257727;CNPY2;12;56703626;56710120;6494;0
4526;ENSG00000257735;;12;48744728;48836194;91466;0
4527;ENSG00000257742;;12;44112796;44117803;5007;1
4528;ENSG00000257752;;12;88451653;88452355;702;0
4529;ENSG00000257815;;12;70297813;70637140;339327;0
4530;ENSG00000257818;;12;69678177;69679265;1088;0
4531;ENSG00000257839;;12;76426438;76427677;1239;0
4532;ENSG00000257875;;12;82862235;82862727;492;0
4533;ENSG00000257877;;12;112250597;112251224;627;0
4534;ENSG00000257890;;12;106444739;106452032;7293;1
4535;ENSG00000257894;;12;79734985;79897176;162191;0
4536;ENSG00000257910;;12;77271973;77274132;2159;0
4537;ENSG00000257918;;12;107108702;107126844;18142;0
4538;ENSG00000257935;;12;113909808;113918429;8621;1
4539;ENSG00000257999;;12;105496250;105500957;4707;0
4540;ENSG00000258017;;12;49521565;49541652;20087;0
4541;ENSG00000258035;;12;94561782;94579820;18038;0
4542;ENSG00000258056;;12;56122888;56124467;1579;0
4543;ENSG00000258057;BCDIN3D-AS1;12;50222325;50234926;12601;0
4544;ENSG00000258102;;12;116985911;116992186;6275;0
4545;ENSG00000258199;;12;56556143;56584068;27925;0
4546;ENSG00000258210;;12;110825268;110883353;58085;0
4547;ENSG00000258230;;12;102166892;102167533;641;0
4548;ENSG00000258297;;11;66433507;66435845;2338;0
4549;ENSG00000258302;;12;89954906;89987798;32892;0
4550;ENSG00000258311;;12;56109820;56118487;8667;0
4551;ENSG00000258325;;12;2906043;2922068;16025;1
4552;ENSG00000258359;PCNPP1;12;112107656;112108166;510;0
4553;ENSG00000258365;;12;94671534;94676620;5086;0
4554;ENSG00000258634;;1;110600962;110605177;4215;1
4555;ENSG00000259030;FPGT-TNNI3K;1;74663919;75009666;345747;0
4556;ENSG00000259799;;11;68923378;68927220;3842;0
4557;ENSG00000259834;;1;111196182;111199662;3480;0
4558;ENSG00000259865;;1;247350583;247351828;1245;0
4559;ENSG00000259887;;12;52242007;52246513;4506;0
4560;ENSG00000259943;;1;40722099;40723639;1540;0
4561;ENSG00000259946;;1;98432561;98434370;1809;0
4562;ENSG00000259984;;1;25662920;25663956;1036;0
4563;ENSG00000259994;;10;30591755;30594995;3240;0
4564;ENSG00000260063;;1;27018623;27020622;1999;0
4565;ENSG00000260196;;11;17402196;17405078;2882;0
4566;ENSG00000260233;SSSCA1-AS1;11;65337131;65337744;613;0
4567;ENSG00000260329;;12;107347807;107349275;1468;0
4568;ENSG00000260388;LINC00562;13;48504290;48506757;2467;0
4569;ENSG00000260400;;10;70458257;70460551;2294;0
4570;ENSG00000260461;;10;105637132;105639519;2387;0
4571;ENSG00000260464;;1;94312730;94314495;1765;0
4572;ENSG00000260589;;10;17683283;17685877;2594;0
4573;ENSG00000260698;;1;246845410;246848377;2967;0
4574;ENSG00000260766;;1;159994743;159996584;1841;0
4575;ENSG00000260855;;1;246935603;246939074;3471;0
4576;ENSG00000260879;;1;108742548;108744113;1565;0
4577;ENSG00000260917;;10;114583249;114587485;4236;0
4578;ENSG00000260920;;1;40929991;40932436;2445;0
4579;ENSG00000260938;;1;178449742;178450341;599;0
4580;ENSG00000260940;;1;101708714;101709305;591;0
4581;ENSG00000260941;LINC00622;1;120140325;120141894;1569;1
4582;ENSG00000260948;;1;111973668;111975690;2022;0
4583;ENSG00000260966;;11;102921416;102926528;5112;0
4584;ENSG00000260987;;12;109301517;109303778;2261;0
4585;ENSG00000261098;;11;107182858;107186997;4139;0
4586;ENSG00000261135;;1;16841140;16842249;1109;0
4587;ENSG00000261168;;1;151102551;151104086;1535;0
4588;ENSG00000261185;;1;182610951;182612442;1491;1
4589;ENSG00000261252;;1;211608414;211608675;261;0
4590;ENSG00000261254;;1;100496122;100501188;5066;0
4591;ENSG00000261324;;12;14915438;14920865;5427;0
4592;ENSG00000261326;;1;23607802;23613245;5443;0
4593;ENSG00000261340;;11;30001660;30003939;2279;1
4594;ENSG00000261349;;1;25592593;25593627;1034;0
4595;ENSG00000261355;;11;35835882;35839557;3675;0
4596;ENSG00000261485;PAN3-AS1;13;28710980;28712330;1350;0
4597;ENSG00000261504;;1;182584389;182585764;1375;0
4598;ENSG00000261578;;11;76511408;76515599;4191;0
4599;ENSG00000261594;TPBGL;11;74951950;74954742;2792;0
4600;ENSG00000261595;;1;113258294;113260418;2124;0
4601;ENSG00000261645;DISC1FP1;11;89984400;90648220;663820;0
4602;ENSG00000261654;;1;111478991;111484975;5984;0
4603;ENSG00000261662;;1;120451878;120453236;1358;0
4604;ENSG00000261716;;1;149816065;149820591;4526;0
4605;ENSG00000261728;;13;35499971;35502213;2242;0
4606;ENSG00000261737;;1;87169185;87170145;960;0
4607;ENSG00000261799;;12;383120;386289;3169;0
4608;ENSG00000262180;OCLM;1;186369704;186370587;883;0
4609;ENSG00000262198;;13;23492730;23498741;6011;0
4610;ENSG00000262412;;10;27532059;27539733;7674;0
4611;ENSG00000263675;MIR5581;1;37966536;37966595;59;0
4612;ENSG00000263906;;11;125797011;125798724;1713;1
4613;ENSG00000264043;;12;109171920;109174194;2274;0
4614;ENSG00000264384;RN7SL431P;1;154138723;154139025;302;0
4615;ENSG00000264523;;11;118821578;118824153;2575;0
4616;ENSG00000264834;MIR1273F;1;53394346;53394444;98;0
4617;ENSG00000264919;MIR4697;11;133768399;133768476;77;0
4618;ENSG00000265917;MIR3685;12;95703699;95703760;61;0
4619;ENSG00000265945;RN7SL721P;1;10450059;10450353;294;0
4620;ENSG00000265996;MIR3671;1;65523438;65523525;87;0
4621;ENSG00000266098;;1;19410046;19410145;99;0
4622;ENSG00000266852;MIR4482-1;10;106028080;106028177;97;1
4623;ENSG00000266993;;1;52259637;52264824;5187;1
4624;ENSG00000267281;;12;53900472;54019763;119291;0
4625;ENSG00000267940;;11;6223131;6224483;1352;0
4626;ENSG00000267957;;10;75880013;75880621;608;0
4627;ENSG00000268069;;12;48178706;48179787;1081;0
4628;ENSG00000268172;;1;144989309;144991365;2056;0
4629;ENSG00000268288;;1;151738962;151739476;514;1
4630;ENSG00000268313;;1;205682497;205684153;1656;0
4631;ENSG00000268403;;11;9481747;9482010;263;0
4632;ENSG00000268575;;1;1634175;1669127;34952;0
4633;ENSG00000268584;;10;75385754;75386548;794;0
4634;ENSG00000268865;;12;25055243;25057615;2372;0
4635;ENSG00000268869;ESPNP;1;17013834;17046652;32818;0
4636;ENSG00000269038;;11;64546426;64546877;451;0
4637;ENSG00000269089;;11;61735453;61736755;1302;0
4638;ENSG00000269113;TRABD2B;1;48226200;48462567;236367;0
4639;ENSG00000269176;;11;62553498;62554257;759;0
4640;ENSG00000269290;;11;64552393;64553092;699;0
4641;ENSG00000269489;;1;151770530;151771078;548;0
4642;ENSG00000269501;;1;149575482;149616786;41304;0
4643;ENSG00000269514;;12;48592170;48595814;3644;0
4644;ENSG00000269554;;1;2121237;2123179;1942;0
4645;ENSG00000269609;;10;104209574;104220863;11289;0
4646;ENSG00000269621;;1;151728017;151732387;4370;0
4647;ENSG00000269690;;1;201592013;201592738;725;0
4648;ENSG00000269783;;10;99627889;99631294;3405;0
4649;ENSG00000269821;KCNQ1OT1;11;2629558;2721224;91666;0
4650;ENSG00000269890;;1;228458144;228462098;3954;0
4651;ENSG00000269891;ARHGAP19-SLIT1;10;98757795;99052413;294618;0
4652;ENSG00000269892;;12;6852151;6852807;656;0
4653;ENSG00000269896;;1;2281853;2284259;2406;0
4654;ENSG00000269903;;12;58208277;58208709;432;0
4655;ENSG00000269916;;12;85657322;85658235;913;0
4656;ENSG00000269923;;12;124570308;124573142;2834;0
4657;ENSG00000269925;;1;7836443;7836835;392;0
4658;ENSG00000269934;;1;228462285;228463767;1482;0
4659;ENSG00000269938;;12;124452570;124453126;556;0
4660;ENSG00000269939;;11;82896563;82898078;1515;0
4661;ENSG00000269952;;10;35499344;35499678;334;0
4662;ENSG00000269956;MKNK1-AS1;1;47004368;47035927;31559;0
4663;ENSG00000269965;;13;51935701;51936371;670;0
4664;ENSG00000269978;;1;7760764;7761030;266;0
4665;ENSG00000269990;;11;66303369;66305407;2038;0
4666;ENSG00000269996;;1;121133256;121134581;1325;0
4667;ENSG00000269997;;12;124450624;124451176;552;0
4668;ENSG00000269998;;1;98399030;98407302;8272;0
4669;ENSG00000270005;;12;124420169;124420753;584;0
4670;ENSG00000270009;;1;183589981;183590626;645;0
4671;ENSG00000270018;;12;112335140;112335710;570;0
4672;ENSG00000270028;;12;124410008;124410630;622;0
4673;ENSG00000270031;;1;28146494;28146852;358;0
4674;ENSG00000270035;;1;7758363;7758932;569;0
4675;ENSG00000270039;;12;58197621;58198198;577;0
4676;ENSG00000270048;;12;124447102;124447364;262;0
4677;ENSG00000270060;;11;47189832;47191114;1282;0
4678;ENSG00000270061;;12;124454537;124454891;354;0
4679;ENSG00000270084;GAS5-AS1;1;173832386;173833079;693;0
4680;ENSG00000270095;;12;124456004;124456261;257;0
4681;ENSG00000270101;;13;51936795;51937579;784;0
4682;ENSG00000270104;;1;228571815;228572717;902;0
4683;ENSG00000270115;;1;33726813;33727281;468;0
4684;ENSG00000270130;;12;124445264;124445791;527;0
4685;ENSG00000270171;;1;7753184;7754904;1720;0
4686;ENSG00000270172;;1;53708036;53710212;2176;0
4687;ENSG00000270175;;12;53893946;53894720;774;0
4688;ENSG00000270179;;11;113239200;113239839;639;0
4689;ENSG00000270344;;12;89919431;89934079;14648;0
4690;ENSG00000270578;;11;94878601;94879168;567;0
4691;ENSG00000270589;;10;112670354;112672002;1648;0
4692;ENSG00000270599;;10;114172053;114179765;7712;0
4693;ENSG00000270605;;1;28566020;28567964;1944;0
4694;ENSG00000270607;;11;19732480;19734165;1685;0
4695;ENSG00000270689;;11;94876801;94878289;1488;0
4696;ENSG00000271259;;12;89765597;89766136;539;0
4697;ENSG00000271327;;12;89761584;89763078;1494;0
4698;ENSG00000271335;;10;35603480;35625329;21849;0
4699;ENSG00000271369;;11;34731147;34731708;561;0
4700;ENSG00000271380;;1;154934301;154935099;798;0
4701;ENSG00000271387;;1;184354887;184355838;951;0
4702;ENSG00000271427;;1;117907521;117908095;574;0
4703;ENSG00000271547;;12;49194359;49194869;510;0
4704;ENSG00000271576;;1;84542014;84543614;1600;0
4705;ENSG00000271614;LINC00936;12;90102736;90106367;3631;0
4706;ENSG00000271721;;1;146647181;146649319;2138;0
4707;ENSG00000271738;;10;82194765;82196869;2104;0
4708;ENSG00000271746;;1;6453615;6454451;836;0
4709;ENSG00000271751;;11;118935974;118936388;414;0
4710;ENSG00000271757;;11;76103240;76103949;709;0
4711;ENSG00000271769;;12;121438289;121439071;782;0
4712;ENSG00000271782;;1;50902700;50902978;278;0
4713;ENSG00000271816;;10;75458909;75490245;31336;0
4714;ENSG00000271847;;1;2309056;2309799;743;0
4715;ENSG00000271895;;1;11089716;11090585;869;0
4716;ENSG00000271917;;1;164797673;164799189;1516;0
4717;ENSG00000271992;;1;70910754;70911219;465;0
4718;ENSG00000272004;;1;1590786;1594063;3277;0
4719;ENSG00000272030;;1;153603914;153606873;2959;0
4720;ENSG00000272033;;1;167348345;167350237;1892;1
4721;ENSG00000272034;SNORD14A;11;17096201;17096291;90;0
4722;ENSG00000272055;RNU6-6P;10;13259269;13259375;106;0
4723;ENSG00000272084;;1;19398604;19402005;3401;0
4724;ENSG00000272091;;1;54492356;54494172;1816;0
4725;ENSG00000272106;;1;1549138;1551175;2037;0
4726;ENSG00000272140;;10;75463493;75473339;9846;0
4727;ENSG00000272145;NFYC-AS1;1;41156052;41157738;1686;0
4728;ENSG00000272161;;1;2257640;2258132;492;0
4729;ENSG00000272173;;12;7052671;7053767;1096;0
4730;ENSG00000272186;;11;118938085;118938409;324;0
4731;ENSG00000272195;;1;245132652;245134390;1738;0
4732;ENSG00000272198;;1;181060245;181062035;1790;0
4733;ENSG00000272201;;12;7087683;7089103;1420;0
4734;ENSG00000272301;;11;76100692;76101172;480;0
4735;ENSG00000272371;;1;53020490;53020945;455;0
4736;ENSG00000272373;;10;43069633;43134016;64383;0
4737;ENSG00000272420;;1;2294500;2295067;567;0
4738;ENSG00000272432;;1;25574328;25574812;484;0
4739;ENSG00000272438;;1;840214;851356;11142;0
4740;ENSG00000272447;;10;81585658;81587358;1700;0
4741;ENSG00000272449;;1;2477904;2478899;995;0
4742;ENSG00000272455;;1;1344476;1345998;1522;0
4743;ENSG00000272491;;1;48693560;48695233;1673;0
4744;ENSG00000272512;;1;931346;933431;2085;0
4745;ENSG00000272562;;1;226248413;226249577;1164;0
4746;ENSG00000272572;;10;102670860;102672496;1636;0
4747;ENSG00000272579;;1;193059996;193060686;690;0
4748;ENSG00000272583;;1;121260164;121260627;463;0
4749;ENSG00000272599;;10;74884331;74885163;832;0
4750;ENSG00000272630;;10;74857802;74861055;3253;0
4751;ENSG00000272631;;10;88509511;88516055;6544;0
4752;ENSG00000272645;;1;224139096;224141141;2045;0
4753;ENSG00000272654;;1;153950219;153951636;1417;0
4754;ENSG00000272668;;1;159836744;159837475;731;0
4755;ENSG00000272692;;10;77168915;77171600;2685;0
4756;ENSG00000272750;;1;222832209;222834854;2645;0
4757;ENSG00000272755;;1;145018395;145018959;564;1
4758;ENSG00000272764;;10;5855948;5856404;456;0
4759;ENSG00000272767;JMJD1C-AS1;10;65224989;65226323;1334;0
4760;ENSG00000272791;;10;75390314;75391248;934;0
4761;ENSG00000272796;;1;23243175;23247993;4818;1
4762;ENSG00000272817;;10;93667888;93669105;1217;0
4763;ENSG00000272824;;1;147830374;147830815;441;0
4764;ENSG00000272853;;10;14919687;14920685;998;0
4765;ENSG00000272865;;1;242310816;242372431;61615;0
4766;ENSG00000272880;;1;181781840;181782396;556;0
4767;ENSG00000272906;;1;179850742;179851730;988;0
4768;ENSG00000272914;;10;31120757;31122316;1559;0
4769;ENSG00000272916;;10;75556272;75571409;15137;0
4770;ENSG00000272931;;1;90285733;90286427;694;0
4771;ENSG00000272983;;10;38426265;38433327;7062;0
4772;ENSG00000272993;;1;149817383;149818053;670;0
4773;ENSG00000273001;;10;3107616;3108193;577;0
4774;ENSG00000273002;;1;155948590;155952777;4187;0
4775;ENSG00000273004;;1;185286911;185287662;751;0
4776;ENSG00000273008;;10;43632272;43633782;1510;0
4777;ENSG00000273010;;1;111505924;111507271;1347;0
4778;ENSG00000273015;LINC00938;12;46119510;46121558;2048;0
4779;ENSG00000273019;;10;38438896;38439221;325;0
4780;ENSG00000273026;;1;153938992;153939406;414;0
4781;ENSG00000273030;;10;102172691;102173178;487;0
4782;ENSG00000273038;;10;33176189;33178239;2050;0
4783;ENSG00000273058;;1;236699473;236700004;531;0
4784;ENSG00000273062;;1;178693441;178695420;1979;0
4785;ENSG00000273075;;1;161344552;161345130;578;0
4786;ENSG00000273079;GRIN2B;12;13693165;14133053;439888;0
4787;ENSG00000273108;;10;105368376;105369807;1431;1
4788;ENSG00000273131;;1;120693320;120697146;3826;0
4789;ENSG00000273149;;13;45914174;45915318;1144;0
4790;ENSG00000273162;;10;102819786;102820762;976;0
4791;ENSG00000273175;;1;245028040;245028574;534;0
4792;ENSG00000273204;;1;101360484;101360912;428;0
4793;ENSG00000273274;ZBTB8B;1;32930670;32962287;31617;0
4794;ENSG00000273367;;1;234507932;234508557;625;0
4795;ENSG00000273372;;10;81727969;81732969;5000;0
4796;ENSG00000273373;;1;110912776;110915625;2849;0
4797;ENSG00000273382;;1;109630593;109633480;2887;0
4798;ENSG00000273416;;1;235267495;235267924;429;0
4799;ENSG00000273483;;1;113060421;113061063;642;0
4800;ENSG00000273485;;10;105209953;105210609;656;0
4801;ENSG00000273487;;1;92654794;92656264;1470;1
4802;ENSG00000002834;LASP1;17;37026112;37078023;51911;0
4803;ENSG00000002919;SNX11;17;46180719;46200436;19717;0
4804;ENSG00000003249;DBNDD1;16;90071273;90086536;15263;0
4805;ENSG00000004139;SARM1;17;26691378;26728065;36687;0
4806;ENSG00000004142;POLDIP2;17;26673659;26684545;10886;0
4807;ENSG00000004660;CAMKK1;17;3763609;3798185;34576;0
4808;ENSG00000004776;HSPB6;19;36245469;36248980;3511;0
4809;ENSG00000004777;ARHGAP33;19;36265434;36279724;14290;0
4810;ENSG00000004779;NDUFAB1;16;23592323;23607677;15354;0
4811;ENSG00000004897;CDC27;17;45195069;45266788;71719;0
4812;ENSG00000004975;DVL2;17;7128660;7137864;9204;0
4813;ENSG00000005007;UPF1;19;18942747;18979045;36298;0
4814;ENSG00000005100;DHX33;17;5344232;5372380;28148;0
4815;ENSG00000005156;LIG3;17;33307513;33332083;24570;0
4816;ENSG00000005187;ACSM3;16;20621565;20808903;187338;0
4817;ENSG00000005189;;16;20817751;20860987;43236;0
4818;ENSG00000005194;CIAPIN1;16;57462081;57481440;19359;0
4819;ENSG00000005206;SPPL2B;19;2328614;2355099;26485;0
4820;ENSG00000005243;COPZ2;17;46103533;46115392;11859;0
4821;ENSG00000005339;CREBBP;16;3775055;3930727;155672;0
4822;ENSG00000005379;BZRAP1;17;56378592;56406152;27560;0
4823;ENSG00000005513;SOX8;16;1031808;1036979;5171;0
4824;ENSG00000005810;MYCBP2;13;77618792;77901185;282393;0
4825;ENSG00000005812;FBXL3;13;77566740;77601330;34590;0
4826;ENSG00000005882;PDK2;17;48172101;48189516;17415;0
4827;ENSG00000005884;ITGA3;17;48133332;48167845;34513;0
4828;ENSG00000005955;GGNBP2;17;34900737;34946278;45541;0
4829;ENSG00000005961;ITGA2B;17;42449548;42466873;17325;0
4830;ENSG00000006007;GDE1;16;19513015;19533467;20452;0
4831;ENSG00000006015;C19orf60;19;18699495;18703146;3651;0
4832;ENSG00000006016;CRLF1;19;18683030;18718551;35521;0
4833;ENSG00000006025;OSBPL7;17;45884738;45899200;14462;0
4834;ENSG00000006042;TMEM98;17;31254928;31272124;17196;0
4835;ENSG00000006047;YBX2;17;7191571;7197934;6363;0
4836;ENSG00000006062;MAP3K14;17;43340488;43394414;53926;0
4837;ENSG00000006114;SYNRG;17;35874900;35969544;94644;0
4838;ENSG00000006125;AP2B1;17;33905065;34053436;148371;0
4839;ENSG00000006194;ZNF263;16;3313743;3351401;37658;0
4840;ENSG00000006210;CX3CL1;16;57406370;57418960;12590;0
4841;ENSG00000006282;SPATA20;17;48620419;48633213;12794;0
4842;ENSG00000006283;CACNA1G;17;48638429;48704835;66406;0
4843;ENSG00000006327;TNFRSF12A;16;3068446;3072384;3938;1
4844;ENSG00000006432;MAP3K9;14;71189243;71276251;87008;0
4845;ENSG00000006695;COX10;17;13972813;14111994;139181;0
4846;ENSG00000006712;PAF1;19;39876492;39881835;5343;0
4847;ENSG00000006740;ARHGAP44;17;12692856;12894960;202104;0
4848;ENSG00000006744;ELAC2;17;12895708;12921504;25796;0
4849;ENSG00000007047;MARK4;19;45582546;45808541;225995;0
4850;ENSG00000007080;CCDC124;19;18043825;18054800;10975;0
4851;ENSG00000007129;CEACAM21;19;42055886;42093197;37311;0
4852;ENSG00000007168;PAFAH1B1;17;2496504;2588909;92405;0
4853;ENSG00000007171;NOS2;17;26083792;26127525;43733;0
4854;ENSG00000007174;DNAH9;17;11501748;11873065;371317;0
4855;ENSG00000007202;KIAA0100;17;26941458;26972472;31014;0
4856;ENSG00000007237;GAS7;17;9813926;10101868;287942;0
4857;ENSG00000007255;TRAPPC6A;19;45666186;45681495;15309;0
4858;ENSG00000007264;MATK;19;3777971;3802127;24156;0
4859;ENSG00000007376;RPUSD1;16;834974;838397;3423;0
4860;ENSG00000007384;RHBDF1;16;108058;126354;18296;0
4861;ENSG00000007392;LUC7L;16;238968;279462;40494;0
4862;ENSG00000007516;BAIAP3;16;1383602;1399439;15837;0
4863;ENSG00000007520;TSR3;16;1399241;1401912;2671;0
4864;ENSG00000007541;PIGQ;16;616995;634136;17141;0
4865;ENSG00000007545;CRAMP1L;16;1662326;1727909;65583;0
4866;ENSG00000008283;CYB561;17;61509665;61523739;14074;0
4867;ENSG00000008294;SPAG9;17;49039535;49198226;158691;0
4868;ENSG00000008382;MPND;19;4343524;4360083;16559;0
4869;ENSG00000008441;NFIX;19;13106422;13209610;103188;1
4870;ENSG00000008710;PKD1;16;2138711;2185899;47188;0
4871;ENSG00000008838;MED24;17;38175350;38217468;42118;0
4872;ENSG00000009830;POMT2;14;77741299;77787227;45928;0
4873;ENSG00000010244;ZNF207;17;30677136;30708905;31769;0
4874;ENSG00000010310;GIPR;19;46171502;46186982;15480;0
4875;ENSG00000010361;FUZ;19;50310126;50320633;10507;0
4876;ENSG00000010539;ZNF200;16;3272325;3286221;13896;0
4877;ENSG00000011028;MRC2;17;60704762;60770958;66196;0
4878;ENSG00000011114;BTBD7;14;93703896;93799438;95542;0
4879;ENSG00000011132;APBA3;19;3750817;3761697;10880;0
4880;ENSG00000011143;MKS1;17;56282803;56296966;14163;0
4881;ENSG00000011243;AKAP8L;19;15490859;15529952;39093;0
4882;ENSG00000011258;MBTD1;17;49254786;49337524;82738;0
4883;ENSG00000011260;UTP18;17;49337889;49375297;37408;0
4884;ENSG00000011295;TTC19;17;15902694;15948329;45635;0
4885;ENSG00000011304;PTBP1;19;797075;812327;15252;0
4886;ENSG00000011332;DPF1;19;38701646;38720354;18708;0
4887;ENSG00000011422;PLAUR;19;44150247;44174699;24452;0
4888;ENSG00000011451;WIZ;19;15532319;15560762;28443;0
4889;ENSG00000011478;QPCTL;19;46195741;46207247;11506;0
4890;ENSG00000011485;PPP5C;19;46850251;46896238;45987;0
4891;ENSG00000011638;TMEM159;16;21169698;21191937;22239;0
4892;ENSG00000012048;BRCA1;17;41196312;41277500;81188;1
4893;ENSG00000012061;ERCC1;19;45910591;45982086;71495;0
4894;ENSG00000012963;UBR7;14;93673401;93695561;22160;0
4895;ENSG00000012983;MAP4K5;14;50885219;51027844;142625;0
4896;ENSG00000013275;PSMC4;19;40476912;40487348;10436;0
4897;ENSG00000013306;SLC25A39;17;42396993;42402238;5245;0
4898;ENSG00000013364;MVP;16;29831715;29859355;27640;0
4899;ENSG00000013523;ANGEL1;14;77253588;77292589;39001;0
4900;ENSG00000015133;CCDC88C;14;91737667;91884188;146521;0
4901;ENSG00000015532;XYLT2;17;48423453;48440499;17046;0
4902;ENSG00000017373;SRCIN1;17;36686251;36762183;75932;0
4903;ENSG00000017797;RALBP1;18;9475007;9538114;63107;0
4904;ENSG00000020426;MNAT1;14;61201460;61436671;235211;0
4905;ENSG00000020577;SAMD4A;14;55033815;55260033;226218;0
4906;ENSG00000021488;SLC7A9;19;33321415;33360672;39257;0
4907;ENSG00000021645;NRXN3;14;78708734;80330762;1622028;0
4908;ENSG00000021776;AQR;15;35147732;35262040;114308;0
4909;ENSG00000022976;ZNF839;14;102783714;102809044;25330;0
4910;ENSG00000023608;SNAPC1;14;62229075;62263146;34071;0
4911;ENSG00000024422;EHD2;19;48216600;48246391;29791;1
4912;ENSG00000027075;PRKCH;14;61654277;62017694;363417;0
4913;ENSG00000028277;POU2F2;19;42590263;42700737;110474;0
4914;ENSG00000028528;SNX1;15;64386322;64438289;51967;0
4915;ENSG00000029364;SLC39A9;14;69864732;69929105;64373;0
4916;ENSG00000029725;RABEP1;17;5185558;5289129;103571;0
4917;ENSG00000030582;GRN;17;42422614;42430470;7856;0
4918;ENSG00000031544;NR2E3;15;72084977;72110600;25623;0
4919;ENSG00000031823;RANBP3;19;5916150;5978153;62003;0
4920;ENSG00000032219;ARID4A;14;58765103;58840605;75502;0
4921;ENSG00000032444;PNPLA6;19;7598890;7626650;27760;0
4922;ENSG00000033011;ALG1;16;5083703;5137380;53677;0
4923;ENSG00000033170;FUT8;14;65877310;66210839;333529;0
4924;ENSG00000033627;ATP6V0A1;17;40610862;40674629;63767;0
4925;ENSG00000033800;PIAS1;15;68346517;68483096;136579;0
4926;ENSG00000034053;APBA2;15;29129629;29410518;280889;0
4927;ENSG00000034063;UHRF1;19;4903092;4962165;59073;1
4928;ENSG00000034152;MAP2K3;17;21187984;21218552;30568;0
4929;ENSG00000034713;GABARAPL2;16;75600249;75611779;11530;0
4930;ENSG00000035664;DAPK2;15;64199235;64364232;164997;0
4931;ENSG00000035862;TIMP2;17;76849059;76921469;72410;0
4932;ENSG00000036530;CYP46A1;14;100150641;100193638;42997;0
4933;ENSG00000037042;TUBG2;17;40811323;40819024;7701;0
4934;ENSG00000037757;MRI1;19;13875346;13885096;9750;0
4935;ENSG00000038358;EDC4;16;67906926;67918406;11480;0
4936;ENSG00000038532;CLEC16A;16;11038345;11276046;237701;0
4937;ENSG00000039068;CDH1;16;68771128;68869451;98323;0
4938;ENSG00000039523;FAM65A;16;67552321;67580691;28370;0
4939;ENSG00000039650;PNKP;19;50364461;50371166;6705;0
4940;ENSG00000040199;PHLPP2;16;71671738;71758604;86866;0
4941;ENSG00000040531;CTNS;17;3539762;3564836;25074;0
4942;ENSG00000040633;PHF23;17;7138347;7143041;4694;0
4943;ENSG00000041353;RAB27B;18;52385091;52562747;177656;0
4944;ENSG00000041357;PSMA4;15;78832747;78841604;8857;0
4945;ENSG00000041515;MYO16;13;109248500;109860355;611855;0
4946;ENSG00000042088;TDP1;14;90421283;90511106;89823;0
4947;ENSG00000042317;SPATA7;14;88851268;88936694;85426;0
4948;ENSG00000042753;AP2S1;19;47341393;47354249;12856;0
4949;ENSG00000043355;ZIC2;13;100634026;100639018;4992;0
4950;ENSG00000046604;DSG2;18;29078006;29128971;50965;0
4951;ENSG00000047346;FAM214A;15;52873514;53002014;128500;0
4952;ENSG00000047578;KIAA0556;16;27561454;27791690;230236;0
4953;ENSG00000048471;SNX29;16;12070594;12668146;597552;0
4954;ENSG00000049759;NEDD4L;18;55711599;56068772;357173;0
4955;ENSG00000050130;JKAMP;14;59951161;59972128;20967;0
4956;ENSG00000050820;BCAR1;16;75262928;75301951;39023;0
4957;ENSG00000051108;HERPUD1;16;56965960;56977798;11838;0
4958;ENSG00000051128;HOMER3;19;19040010;19052070;12060;0
4959;ENSG00000051180;RAD51;15;40986972;41024354;37382;0
4960;ENSG00000051523;CYBA;16;88709691;88717560;7869;0
4961;ENSG00000053254;FOXN3;14;89591215;90085493;494278;0
4962;ENSG00000053501;USE1;19;17326155;17330638;4483;0
4963;ENSG00000053747;LAMA3;18;21269407;21535030;265623;0
4964;ENSG00000053770;AP5M1;14;57735627;57756797;21170;0
4965;ENSG00000054654;SYNE2;14;64319683;64693165;373482;0
4966;ENSG00000054690;PLEKHH1;14;68000018;68056329;56311;0
4967;ENSG00000054983;GALC;14;88304164;88460009;155845;0
4968;ENSG00000055483;USP36;17;76783463;76837523;54060;0
4969;ENSG00000056661;PCGF2;17;36890150;36906070;15920;0
4970;ENSG00000057593;F7;13;113760105;113774995;14890;0
4971;ENSG00000058335;RASGRF1;15;79252289;79383115;130826;0
4972;ENSG00000058600;POLR3E;16;22308730;22346424;37694;0
4973;ENSG00000059122;FLYWCH1;16;2961938;3001209;39271;0
4974;ENSG00000059145;UNKL;16;1413206;1464752;51546;0
4975;ENSG00000060069;CTDP1;18;77439801;77514510;74709;0
4976;ENSG00000062038;CDH3;16;68670092;68756519;86427;0
4977;ENSG00000062370;ZNF112;19;44830708;44871377;40669;0
4978;ENSG00000062716;VMP1;17;57784553;57919616;135063;0
4979;ENSG00000062725;APPBP2;17;58520520;58603580;83060;0
4980;ENSG00000062822;POLD1;19;50887461;50921273;33812;0
4981;ENSG00000063015;SEZ6;17;27281919;27333458;51539;0
4982;ENSG00000063127;SLC6A16;19;49792895;49828482;35587;0
4983;ENSG00000063169;GLTSCR1;19;48111453;48206533;95080;0
4984;ENSG00000063176;SPHK2;19;49122548;49133974;11426;0
4985;ENSG00000063177;RPL18;19;49118585;49122793;4208;0
4986;ENSG00000063180;CA11;19;49141199;49149569;8370;0
4987;ENSG00000063322;MED29;19;39881943;39891277;9334;0
4988;ENSG00000063761;ADCK1;14;78266426;78401355;134929;0
4989;ENSG00000063854;HAGH;16;1845621;1877195;31574;0
4990;ENSG00000064270;ATP2C2;16;84402133;84497793;95660;0
4991;ENSG00000064300;NGFR;17;47572655;47592379;19724;0
4992;ENSG00000064490;RFXANK;19;19303008;19312678;9670;0
4993;ENSG00000064545;TMEM161A;19;19229978;19249322;19344;0
4994;ENSG00000064547;LPAR2;19;19734477;19739739;5262;0
4995;ENSG00000064607;SUGP2;19;19101697;19144832;43135;0
4996;ENSG00000064666;CNN2;19;1026298;1039068;12770;0
4997;ENSG00000064687;ABCA7;19;1040102;1065571;25469;0
4998;ENSG00000064726;BTBD1;15;83685174;83736106;50932;0
4999;ENSG00000064932;SBNO2;19;1107636;1174282;66646;0
5000;ENSG00000064961;HMG20B;19;3572775;3579086;6311;0
5001;ENSG00000065000;AP3D1;19;2100988;2164464;63476;0
5002;ENSG00000065054;SLC9A3R2;16;2075357;2089027;13670;0
5003;ENSG00000065057;NTHL1;16;2089816;2097867;8051;0
5004;ENSG00000065150;IPO5;13;98605912;98676551;70639;0
5005;ENSG00000065268;WDR18;19;983174;994569;11395;0
5006;ENSG00000065320;NTN1;17;8924859;9147317;222458;0
5007;ENSG00000065427;KARS;16;75661622;75682541;20919;0
5008;ENSG00000065457;ADAT1;16;75630879;75657198;26319;0
5009;ENSG00000065559;MAP2K4;17;11924141;12047147;123006;0
5010;ENSG00000065717;TLE2;19;2997636;3047633;49997;0
5011;ENSG00000065989;PDE4A;19;10527449;10580305;52856;0
5012;ENSG00000066044;ELAVL1;19;8023463;8070543;47080;0
5013;ENSG00000066427;ATXN3;14;92524896;92572965;48069;0
5014;ENSG00000066455;GOLGA5;14;93260576;93306308;45732;0
5015;ENSG00000066629;EML1;14;100204030;100408397;204367;0
5016;ENSG00000066654;THUMPD1;16;20744986;20753406;8420;0
5017;ENSG00000066735;KIF26A;14;104605060;104647231;42171;0
5018;ENSG00000066739;ATG2B;14;96747595;96830207;82612;0
5019;ENSG00000066926;FECH;18;55215515;55254004;38489;0
5020;ENSG00000066933;MYO9A;15;72114632;72410918;296286;0
5021;ENSG00000067141;NEO1;15;73344051;73597547;253496;0
5022;ENSG00000067191;CACNB1;17;37329709;37353956;24247;0
5023;ENSG00000067221;STOML1;15;74275547;74286963;11416;0
5024;ENSG00000067225;PKM;15;72491370;72524164;32794;0
5025;ENSG00000067365;METTL22;16;8715540;8740081;24541;0
5026;ENSG00000067369;TP53BP1;15;43699407;43802926;103519;0
5027;ENSG00000067596;DHX8;17;41561233;41621831;60598;0
5028;ENSG00000067836;ROGDI;16;4846969;4852951;5982;0
5029;ENSG00000067900;ROCK1;18;18526867;18691812;164945;0
5030;ENSG00000067955;CBFB;16;67063019;67134961;71942;0
5031;ENSG00000068079;IFI35;17;41158742;41166473;7731;0
5032;ENSG00000068097;HEATR6;17;58120555;58156292;35737;0
5033;ENSG00000068120;COASY;17;40713485;40718295;4810;0
5034;ENSG00000068137;PLEKHH3;17;40819932;40829048;9116;0
5035;ENSG00000068305;MEF2A;15;100017370;100256671;239301;0
5036;ENSG00000068489;PRR11;17;57232860;57282066;49206;1
5037;ENSG00000068650;ATP11A;13;113344643;113541482;196839;0
5038;ENSG00000068793;CYFIP1;15;22892005;23006016;114011;0
5039;ENSG00000068903;SIRT2;19;39369197;39390502;21305;0
5040;ENSG00000069188;SDK2;17;71330523;71640228;309705;0
5041;ENSG00000069329;VPS35;16;46690054;46723430;33376;0
5042;ENSG00000069345;DNAJA2;16;46989299;47007699;18400;0
5043;ENSG00000069399;BCL3;19;45250962;45263301;12339;0
5044;ENSG00000069667;RORA;15;60780483;61521518;741035;1
5045;ENSG00000069869;NEDD4;15;56119120;56285944;166824;1
5046;ENSG00000069943;PIGB;15;55611158;55647846;36688;0
5047;ENSG00000069956;MAPK6;15;52244303;52358462;114159;0
5048;ENSG00000069966;GNB5;15;52413117;52483566;70449;1
5049;ENSG00000069974;RAB27A;15;55495164;55611311;116147;0
5050;ENSG00000070182;SPTB;14;65213002;65346601;133599;0
5051;ENSG00000070269;TMEM260;14;56955072;57117324;162252;0
5052;ENSG00000070366;SMG6;17;1963133;2207065;243932;0
5053;ENSG00000070367;EXOC5;14;57670518;57735726;65208;0
5054;ENSG00000070404;FSTL3;19;676392;683385;6993;0
5055;ENSG00000070423;RNF126;19;647526;663277;15751;0
5056;ENSG00000070444;MNT;17;2287354;2304412;17058;0
5057;ENSG00000070495;JMJD6;17;74708919;74722866;13947;0
5058;ENSG00000070540;WIPI1;17;66417089;66453654;36565;1
5059;ENSG00000070729;CNGB1;16;57917503;58005020;87517;0
5060;ENSG00000070761;C16orf80;16;58147496;58163354;15858;0
5061;ENSG00000070770;CSNK2A2;16;58191811;58231824;40013;0
5062;ENSG00000070778;PTPN21;14;88932122;89021077;88955;0
5063;ENSG00000071246;VASH1;14;77228532;77249354;20822;0
5064;ENSG00000071537;SEL1L;14;81937893;82000205;62312;0
5065;ENSG00000071564;TCF3;19;1609291;1652604;43313;0
5066;ENSG00000071626;DAZAP1;19;1407568;1435719;28151;0
5067;ENSG00000071655;MBD3;19;1576639;1592882;16243;0
5068;ENSG00000072042;RDH11;14;68143518;68162531;19013;0
5069;ENSG00000072062;PRKACA;19;14202500;14228896;26396;0
5070;ENSG00000072071;LPHN1;19;14260750;14316999;56249;0
5071;ENSG00000072110;ACTN1;14;69340860;69446157;105297;0
5072;ENSG00000072121;ZFYVE26;14;68194091;68283307;89216;0
5073;ENSG00000072134;EPN2;17;19118928;19240028;121100;0
5074;ENSG00000072210;ALDH3A2;17;19551449;19580911;29462;0
5075;ENSG00000072310;SREBF1;17;17713713;17740325;26612;0
5076;ENSG00000072415;MPP5;14;67707826;67802536;94710;0
5077;ENSG00000072736;NFATC3;16;68118654;68263162;144508;0
5078;ENSG00000072778;ACADVL;17;7120444;7128592;8148;0
5079;ENSG00000072818;ACAP1;17;7239848;7254797;14949;0
5080;ENSG00000072849;DERL2;17;5374571;5390131;15560;0
5081;ENSG00000072864;NDE1;16;15737124;15820210;83086;1
5082;ENSG00000072954;TMEM38A;19;16771938;16800840;28902;1
5083;ENSG00000072958;AP1M1;19;16308389;16346160;37771;0
5084;ENSG00000073008;PVR;19;45147098;45166850;19752;0
5085;ENSG00000073050;XRCC1;19;44047192;44084625;37433;0
5086;ENSG00000073417;PDE8A;15;85523671;85682376;158705;0
5087;ENSG00000073536;NLE1;17;33455772;33469334;13562;0
5088;ENSG00000073584;SMARCE1;17;38781214;38804760;23546;0
5089;ENSG00000073605;GSDMB;17;38060848;38076107;15259;1
5090;ENSG00000073670;ADAM11;17;42836399;42859214;22815;0
5091;ENSG00000073712;FERMT2;14;53323986;53419153;95167;0
5092;ENSG00000073969;NSF;17;44668035;44834830;166795;0
5093;ENSG00000074071;MRPS34;16;1821891;1823156;1265;0
5094;ENSG00000074181;NOTCH3;19;15270444;15311792;41348;0
5095;ENSG00000074219;TEAD2;19;49843852;49865714;21862;0
5096;ENSG00000074356;C17orf85;17;3714460;3749545;35085;0
5097;ENSG00000074370;ATP2A3;17;3827169;3867736;40567;0
5098;ENSG00000074410;CA12;15;63613577;63674360;60783;0
5099;ENSG00000074603;DPP8;15;65734801;65810042;75241;0
5100;ENSG00000074621;SLC24A1;15;65903704;65953333;49629;0
5101;ENSG00000074657;ZNF532;18;56529832;56653712;123880;0
5102;ENSG00000074660;SCARF1;17;1537152;1549041;11889;0
5103;ENSG00000074695;LMAN1;18;56995055;57027194;32139;0
5104;ENSG00000074696;PTPLAD1;15;65822756;65870687;47931;0
5105;ENSG00000074755;ZZEF1;17;3907739;4046314;138575;0
5106;ENSG00000074803;SLC12A1;15;48483861;48596275;112414;0
5107;ENSG00000074842;C19orf10;19;4641386;4670382;28996;0
5108;ENSG00000074855;ANO8;19;17434032;17445638;11606;0
5109;ENSG00000075131;TIPIN;15;66628544;66679084;50540;0
5110;ENSG00000075336;TIMM21;18;71815746;71826197;10451;0
5111;ENSG00000075399;VPS9D1;16;89773542;89787394;13852;0
5112;ENSG00000075413;MARK3;14;103851729;103970168;118439;0
5113;ENSG00000075429;CACNG5;17;64831235;64881603;50368;0
5114;ENSG00000075461;CACNG4;17;64961026;65029514;68488;0
5115;ENSG00000075643;MOCOS;18;33767482;33852120;84638;0
5116;ENSG00000075702;WDR62;19;36545783;36596008;50225;0
5117;ENSG00000076344;RGS11;16;318300;325980;7680;0
5118;ENSG00000076351;SLC46A1;17;26721661;26734215;12554;0
5119;ENSG00000076382;SPAG5;17;26904588;26926297;21709;0
5120;ENSG00000076604;TRAF4;17;27071002;27077974;6972;0
5121;ENSG00000076650;GPATCH1;19;33571786;33621448;49662;0
5122;ENSG00000076662;ICAM3;19;10444452;10450499;6047;0
5123;ENSG00000076826;CAMSAP3;19;7660788;7683190;22402;0
5124;ENSG00000076924;XAB2;19;7684411;7694451;10040;0
5125;ENSG00000076928;ARHGEF1;19;42387228;42434302;47074;0
5126;ENSG00000076944;STXBP2;19;7701767;7712759;10992;0
5127;ENSG00000076984;MAP2K7;19;7968728;7979363;10635;0
5128;ENSG00000077235;GTF3C1;16;27470876;27561234;90358;0
5129;ENSG00000077238;IL4R;16;27324989;27376099;51110;0
5130;ENSG00000077312;SNRPA;19;41256542;41271294;14752;0
5131;ENSG00000077348;EXOSC5;19;41892279;41903384;11105;0
5132;ENSG00000077463;SIRT6;19;4174106;4182601;8495;0
5133;ENSG00000078043;PIAS2;18;44388353;44500123;111770;0
5134;ENSG00000078142;PIK3C3;18;39535171;39667794;132623;0
5135;ENSG00000078304;PPP2R5C;14;102228135;102394326;166191;0
5136;ENSG00000078687;TNRC6C;17;76000249;76104916;104667;0
5137;ENSG00000079101;CLUL1;18;596988;650334;53346;0
5138;ENSG00000079134;THOC1;18;214520;268050;53530;0
5139;ENSG00000079313;REXO1;19;1815248;1848452;33204;0
5140;ENSG00000079432;CIC;19;42772689;42799949;27260;0
5141;ENSG00000079435;LIPE;19;42905659;42931578;25919;0
5142;ENSG00000079462;PAFAH1B3;19;42801185;42807698;6513;0
5143;ENSG00000079616;KIF22;16;29802040;29816706;14666;0
5144;ENSG00000079805;DNM2;19;10828755;10944164;115409;0
5145;ENSG00000079999;KEAP1;19;10596796;10614417;17621;0
5146;ENSG00000080166;DCT;13;95089558;95131936;42378;0
5147;ENSG00000080573;COL5A3;19;10070237;10121147;50910;1
5148;ENSG00000080603;SRCAP;16;30709530;30755602;46072;0
5149;ENSG00000080644;CHRNA3;15;78885394;78913637;28243;0
5150;ENSG00000080815;PSEN1;14;73603126;73690399;87273;0
5151;ENSG00000080823;MOK;14;102690837;102771537;80700;0
5152;ENSG00000080824;HSP90AA1;14;102547075;102606036;58961;0
5153;ENSG00000080986;NDC80;18;2571510;2616634;45124;0
5154;ENSG00000081014;AP4E1;15;51200869;51298097;97228;0
5155;ENSG00000081138;CDH7;18;63417488;63548638;131150;0
5156;ENSG00000081177;EXD2;14;69658228;69709075;50847;0
5157;ENSG00000081181;ARG2;14;68086515;68118437;31922;0
5158;ENSG00000081665;ZNF506;19;19896648;19932560;35912;0
5159;ENSG00000081913;PHLPP1;18;60382672;60647666;264994;0
5160;ENSG00000082212;ME2;18;48405419;48474691;69272;0
5161;ENSG00000082397;EPB41L3;18;5392383;5630699;238316;0
5162;ENSG00000082641;NFE2L1;17;46125691;46138849;13158;0
5163;ENSG00000083093;PALB2;16;23614488;23652631;38143;0
5164;ENSG00000083290;ULK2;17;19674142;19771249;97107;0
5165;ENSG00000083454;P2RX5;17;3575493;3599698;24205;0
5166;ENSG00000083457;ITGAE;17;3617922;3704537;86615;0
5167;ENSG00000083520;DIS3;13;73329540;73356234;26694;0
5168;ENSG00000083535;PIBF1;13;73356197;73590591;234394;0
5169;ENSG00000083544;TDRD3;13;60970591;61148012;177421;0
5170;ENSG00000083799;CYLD;16;50775961;50835846;59885;0
5171;ENSG00000085415;SEH1L;18;12947132;12987535;40403;0
5172;ENSG00000085644;ZNF213;16;3179778;3192806;13028;0
5173;ENSG00000085721;RRN3;16;15153879;15188174;34295;0
5174;ENSG00000085872;CHERP;19;16628700;16653341;24641;0
5175;ENSG00000086504;MRPL28;16;417384;420527;3143;0
5176;ENSG00000086544;ITPKC;19;41223008;41246765;23757;0
5177;ENSG00000086666;ZFAND6;15;80351910;80430735;78825;0
5178;ENSG00000087074;PPP1R15A;19;49375649;49379314;3665;1
5179;ENSG00000087076;HSD17B14;19;49316274;49339935;23661;0
5180;ENSG00000087086;FTL;19;49468558;49470135;1577;0
5181;ENSG00000087088;BAX;19;49458072;49465055;6983;0
5182;ENSG00000087095;NLK;17;26368763;26523407;154644;0
5183;ENSG00000087111;PIGS;17;26880401;26898890;18489;0
5184;ENSG00000087152;ATXN7L3;17;42269173;42277481;8308;0
5185;ENSG00000087157;PGS1;17;76374721;76421195;46474;0
5186;ENSG00000087191;PSMC5;17;61904512;61909379;4867;0
5187;ENSG00000087245;MMP2;16;55423612;55540603;116991;0
5188;ENSG00000087250;MT3;16;56622986;56625000;2014;0
5189;ENSG00000087253;LPCAT2;16;55542910;55620582;77672;0
5190;ENSG00000087258;GNAO1;16;56225302;56391356;166054;0
5191;ENSG00000087263;OGFOD1;16;56485402;56513012;27610;0
5192;ENSG00000087299;L2HGDH;14;50704281;50779266;74985;0
5193;ENSG00000087301;TXNDC16;14;52897308;53019240;121932;0
5194;ENSG00000087302;C14orf166;14;52456193;52471420;15227;0
5195;ENSG00000087303;NID2;14;52471521;52535712;64191;0
5196;ENSG00000087903;RFX2;19;5993175;6199583;206408;0
5197;ENSG00000087995;METTL2A;17;60501228;60527454;26226;0
5198;ENSG00000088247;KHSRP;19;6413359;6424805;11446;0
5199;ENSG00000088256;GNA11;19;3094408;3124002;29594;0
5200;ENSG00000088387;DOCK9;13;99445741;99738879;293138;0
5201;ENSG00000088448;ANKRD10;13;111530887;111567416;36529;0
5202;ENSG00000088451;TGDS;13;95226308;95248511;22203;0
5203;ENSG00000088682;COQ9;16;57481337;57495187;13850;0
5204;ENSG00000088756;ARHGAP28;18;6729717;6915715;185998;1
5205;ENSG00000088808;PPP1R13B;14;104200089;104313927;113838;0
5206;ENSG00000089280;FUS;16;31191431;31203127;11696;0
5207;ENSG00000089335;ZNF302;19;35168544;35177302;8758;0
5208;ENSG00000089351;GRAMD1A;19;35485688;35517375;31687;0
5209;ENSG00000089486;CDIP1;16;4560676;4588829;28153;0
5210;ENSG00000089505;CMTM1;16;66600294;66613040;12746;0
5211;ENSG00000089558;KCNH4;17;40308909;40333296;24387;0
5212;ENSG00000089639;GMIP;19;19740285;19754476;14191;0
5213;ENSG00000089685;BIRC5;17;76210267;76221717;11450;0
5214;ENSG00000089723;OTUB2;14;94492675;94515276;22601;0
5215;ENSG00000089737;DDX24;14;94517266;94547591;30325;0
5216;ENSG00000089775;ZBTB25;14;64915824;64971931;56107;0
5217;ENSG00000089847;ANKRD24;19;4183351;4224811;41460;0
5218;ENSG00000089902;RCOR1;14;103058998;103196913;137915;0
5219;ENSG00000089916;GPATCH2L;14;76618259;76720685;102426;0
5220;ENSG00000090006;LTBP4;19;41098789;41135725;36936;0
5221;ENSG00000090013;BLVRB;19;40953696;40971747;18051;0
5222;ENSG00000090060;PAPOLA;14;96967770;97033448;65678;0
5223;ENSG00000090061;CCNK;14;99947506;100001381;53875;0
5224;ENSG00000090238;YPEL3;16;30103635;30108236;4601;0
5225;ENSG00000090372;STRN4;19;47222764;47250251;27487;0
5226;ENSG00000090447;TFAP4;16;4307187;4323076;15889;0
5227;ENSG00000090470;PDCD7;15;65409717;65426174;16457;0
5228;ENSG00000090487;SPG21;15;65255362;65282648;27286;0
5229;ENSG00000090565;RAB11FIP3;16;475619;573011;97392;0
5230;ENSG00000090581;GNPTG;16;1401924;1413352;11428;0
5231;ENSG00000090661;CERS4;19;8271620;8327305;55685;0
5232;ENSG00000090674;MCOLN1;19;7587512;7598895;11383;0
5233;ENSG00000090857;PDPR;16;70147529;70195203;47674;0
5234;ENSG00000090861;AARS;16;70286198;70323446;37248;0
5235;ENSG00000090863;GLG1;16;74485856;74641012;155156;0
5236;ENSG00000090905;TNRC6A;16;24741016;24838953;97937;0
5237;ENSG00000090920;FCGBP;19;40353963;40440533;86570;0
5238;ENSG00000090924;PLEKHG2;19;39903225;39919054;15829;0
5239;ENSG00000090932;DLL3;19;39989535;39999121;9586;0
5240;ENSG00000091157;WDR7;18;54318574;54698828;380254;0
5241;ENSG00000091164;TXNL1;18;54264439;54318831;54392;0
5242;ENSG00000091262;ABCC6;16;16242785;16317379;74594;0
5243;ENSG00000091536;MYO15A;17;18012020;18083116;71096;0
5244;ENSG00000091542;ALKBH5;17;18086392;18113268;26876;0
5245;ENSG00000091592;NLRP1;17;5402747;5522744;119997;0
5246;ENSG00000091622;PITPNM3;17;6354584;6459814;105230;0
5247;ENSG00000091640;SPAG7;17;4862521;4871167;8646;0
5248;ENSG00000091651;ORC6;16;46723555;46732306;8751;0
5249;ENSG00000091947;TMEM101;17;42088556;42101314;12758;0
5250;ENSG00000092010;PSME1;14;24605367;24608176;2809;0
5251;ENSG00000092020;PPP2R3C;14;35554673;35591723;37050;0
5252;ENSG00000092036;HAUS4;14;23415437;23426370;10933;0
5253;ENSG00000092051;JPH4;14;24037244;24048009;10765;0
5254;ENSG00000092054;MYH7;14;23881947;23904927;22980;0
5255;ENSG00000092068;SLC7A8;14;23594504;23652883;58379;0
5256;ENSG00000092094;OSGEP;14;20914570;20923264;8694;0
5257;ENSG00000092096;SLC22A17;14;23815515;23822121;6606;0
5258;ENSG00000092098;RNF31;14;24615892;24629870;13978;0
5259;ENSG00000092108;SCFD1;14;31091318;31205018;113700;0
5260;ENSG00000092140;G2E3;14;31028329;31089269;60940;0
5261;ENSG00000092148;HECTD1;14;31569318;31677010;107692;0
5262;ENSG00000092199;HNRNPC;14;21677295;21737653;60358;0
5263;ENSG00000092201;SUPT16H;14;21819631;21852425;32794;0
5264;ENSG00000092203;TOX4;14;21944756;21967319;22563;0
5265;ENSG00000092208;GEMIN2;14;39583427;39606177;22750;0
5266;ENSG00000092295;TGM1;14;24718320;24733638;15318;0
5267;ENSG00000092330;TINF2;14;24708849;24711880;3031;0
5268;ENSG00000092439;TRPM7;15;50844670;50979012;134342;0
5269;ENSG00000092445;TYRO3;15;41849873;41871536;21663;0
5270;ENSG00000092470;WDR76;15;44119161;44160617;41456;0
5271;ENSG00000092529;CAPN3;15;42640301;42704516;64215;1
5272;ENSG00000092531;SNAP23;15;42783431;42837547;54116;0
5273;ENSG00000092871;RFFL;17;33333009;33416338;83329;0
5274;ENSG00000092929;UNC13D;17;73823306;73840798;17492;0
5275;ENSG00000092931;MFSD11;17;74731947;74777531;45584;0
5276;ENSG00000094804;CDC6;17;38443885;38459171;15286;0
5277;ENSG00000095059;DHPS;19;12786531;12792716;6185;0
5278;ENSG00000095066;HOOK2;19;12873817;12983554;109737;0
5279;ENSG00000095906;NUBP2;16;1832902;1839192;6290;0
5280;ENSG00000099203;TMED1;19;10943114;10946994;3880;0
5281;ENSG00000099308;MAST3;19;18208603;18262502;53899;0
5282;ENSG00000099330;OCEL1;19;17337013;17340028;3015;0
5283;ENSG00000099331;MYO9B;19;17186591;17325346;138755;0
5284;ENSG00000099338;CATSPERG;19;38826415;38861589;35174;0
5285;ENSG00000099341;PSMD8;19;38865176;38874464;9288;0
5286;ENSG00000099364;FBXL19;16;30934376;30960104;25728;0
5287;ENSG00000099365;STX1B;16;31000577;31021949;21372;0
5288;ENSG00000099377;HSD3B7;16;30996519;31000473;3954;0
5289;ENSG00000099381;SETD1A;16;30968615;30996437;27822;0
5290;ENSG00000099385;BCL7C;16;30844947;30906281;61334;0
5291;ENSG00000099617;EFNA2;19;1286153;1301430;15277;0
5292;ENSG00000099622;CIRBP;19;1259384;1274879;15495;0
5293;ENSG00000099624;ATP5D;19;1241749;1244824;3075;0
5294;ENSG00000099625;C19orf26;19;1228286;1238026;9740;0
5295;ENSG00000099783;HNRNPM;19;8509651;8553998;44347;0
5296;ENSG00000099785;02-Mar;19;8478154;8503901;25747;0
5297;ENSG00000099795;NDUFB7;19;14676890;14682874;5984;0
5298;ENSG00000099797;TECR;19;14627897;14676792;48895;0
5299;ENSG00000099800;TIMM13;19;2425622;2427892;2270;0
5300;ENSG00000099804;CDC34;19;531714;542097;10383;0
5301;ENSG00000099812;MISP;19;751126;764319;13193;0
5302;ENSG00000099814;CEP170B;14;105331617;105363107;31490;0
5303;ENSG00000099817;POLR2E;19;1086594;1095598;9004;0
5304;ENSG00000099821;POLRMT;19;617223;633597;16374;0
5305;ENSG00000099822;HCN2;19;589893;617159;27266;0
5306;ENSG00000099840;IZUMO4;19;2096380;2099592;3212;0
5307;ENSG00000099860;GADD45B;19;2476120;2478257;2137;0
5308;ENSG00000099864;PALM;19;708953;748329;39376;0
5309;ENSG00000099866;MADCAM1;19;489176;505347;16171;0
5310;ENSG00000099875;MKNK2;19;2037470;2051243;13773;0
5311;ENSG00000100433;KCNK10;14;88649113;88793251;144138;0
5312;ENSG00000100439;ABHD4;14;23067146;23081265;14119;0
5313;ENSG00000100441;KHNYN;14;24898492;24910540;12048;0
5314;ENSG00000100442;FKBP3;14;45584803;45604522;19719;0
5315;ENSG00000100445;SDR39U1;14;24908972;24912111;3139;0
5316;ENSG00000100461;RBM23;14;23369854;23388393;18539;0
5317;ENSG00000100462;PRMT5;14;23389720;23398794;9074;0
5318;ENSG00000100473;COCH;14;31343720;31364271;20551;0
5319;ENSG00000100478;AP4S1;14;31494312;31562818;68506;0
5320;ENSG00000100479;POLE2;14;50110273;50155140;44867;0
5321;ENSG00000100483;VCPKMT;14;50575350;50583318;7968;0
5322;ENSG00000100485;SOS2;14;50583847;50698276;114429;0
5323;ENSG00000100490;CDKL1;14;50796310;50883179;86869;0
5324;ENSG00000100503;NIN;14;51186481;51297839;111358;0
5325;ENSG00000100504;PYGL;14;51324609;51411454;86845;1
5326;ENSG00000100505;TRIM9;14;51441980;51562779;120799;0
5327;ENSG00000100519;PSMC6;14;53173890;53195305;21415;0
5328;ENSG00000100522;GNPNAT1;14;53241912;53258386;16474;0
5329;ENSG00000100523;DDHD1;14;53510686;53620000;109314;0
5330;ENSG00000100526;CDKN3;14;54863567;54886936;23369;0
5331;ENSG00000100528;CNIH1;14;54893654;54908149;14495;0
5332;ENSG00000100532;CGRRF1;14;54976530;55005567;29037;0
5333;ENSG00000100554;ATP6V1D;14;67761088;67826982;65894;0
5334;ENSG00000100557;C14orf105;14;57936019;57960585;24566;1
5335;ENSG00000100564;PIGH;14;68048672;68067004;18332;0
5336;ENSG00000100567;PSMA3;14;58711549;58738730;27181;0
5337;ENSG00000100568;VTI1B;14;68113792;68141548;27756;0
5338;ENSG00000100575;TIMM9;14;58875212;58894332;19120;0
5339;ENSG00000100577;GSTZ1;14;77787227;77797940;10713;0
5340;ENSG00000100578;KIAA0586;14;58894103;59015216;121113;0
5341;ENSG00000100580;TMED8;14;77801364;77843452;42088;0
5342;ENSG00000100583;SAMD15;14;77843032;77857840;14808;0
5343;ENSG00000100591;AHSA1;14;77924213;77935817;11604;0
5344;ENSG00000100592;DAAM1;14;59655364;59838123;182759;0
5345;ENSG00000100593;ISM2;14;77940740;77965210;24470;1
5346;ENSG00000100596;SPTLC2;14;77972340;78083116;110776;0
5347;ENSG00000100599;RIN3;14;92980118;93155339;175221;0
5348;ENSG00000100600;LGMN;14;93170152;93215047;44895;1
5349;ENSG00000100601;ALKBH1;14;78138747;78174363;35616;0
5350;ENSG00000100603;SNW1;14;78183942;78227550;43608;0
5351;ENSG00000100604;CHGA;14;93389425;93401638;12213;0
5352;ENSG00000100605;ITPK1;14;93403259;93582665;179406;0
5353;ENSG00000100612;DHRS7;14;60610838;60636574;25736;0
5354;ENSG00000100614;PPM1A;14;60712470;60765805;53335;0
5355;ENSG00000100625;SIX4;14;61176246;61191066;14820;0
5356;ENSG00000100626;GALNT16;14;69725994;69821183;95189;0
5357;ENSG00000100629;CEP128;14;80943330;81425861;482531;0
5358;ENSG00000100632;ERH;14;69846848;69865344;18496;0
5359;ENSG00000100644;HIF1A;14;62162231;62214976;52745;0
5360;ENSG00000100647;KIAA0247;14;70078313;70181859;103546;0
5361;ENSG00000100650;SRSF5;14;70193617;70238722;45105;0
5362;ENSG00000100664;EIF5;14;103799881;103811362;11481;0
5363;ENSG00000100678;SLC8A3;14;70510934;70655787;144853;0
5364;ENSG00000100697;DICER1;14;95552565;95624347;71782;0
5365;ENSG00000100711;ZFYVE21;14;104182067;104200005;17938;0
5366;ENSG00000100714;MTHFD1;14;64854749;64926722;71973;0
5367;ENSG00000100722;ZC3H14;14;89029253;89079853;50600;0
5368;ENSG00000100726;TELO2;16;1543345;1560458;17113;0
5369;ENSG00000100731;PCNX;14;71374122;71582099;207977;0
5370;ENSG00000100744;GSKIP;14;96829814;96853625;23811;0
5371;ENSG00000100749;VRK1;14;97263641;97398059;134418;0
5372;ENSG00000100764;PSMC1;14;90722839;90738968;16129;0
5373;ENSG00000100767;PAPLN;14;73704205;73741348;37143;0
5374;ENSG00000100784;RPS6KA5;14;91336799;91526980;190181;0
5375;ENSG00000100796;SMEK1;14;91923955;91976898;52943;0
5376;ENSG00000100802;C14orf93;14;23456110;23479375;23265;0
5377;ENSG00000100804;PSMB5;14;23485752;23504439;18687;0
5378;ENSG00000100811;YY1;14;100704635;100749129;44494;0
5379;ENSG00000100813;ACIN1;14;23527773;23564823;37050;0
5380;ENSG00000100814;CCNB1IP1;14;20779527;20801471;21944;0
5381;ENSG00000100815;TRIP11;14;92432335;92507240;74905;0
5382;ENSG00000100823;APEX1;14;20923350;20925927;2577;0
5383;ENSG00000100836;PABPN1;14;23790498;23795394;4896;0
5384;ENSG00000100842;EFS;14;23825611;23834961;9350;0
5385;ENSG00000100852;ARHGAP5;14;32545320;32628934;83614;0
5386;ENSG00000100865;CINP;14;102808956;102829253;20297;0
5387;ENSG00000100867;DHRS2;14;24099324;24114848;15524;0
5388;ENSG00000100883;SRP54;14;35451163;35498773;47610;0
5389;ENSG00000100884;CPNE6;14;24540046;24547309;7263;0
5390;ENSG00000100888;CHD8;14;21853353;21924285;70932;0
5391;ENSG00000100889;PCK2;14;24563262;24579807;16545;0
5392;ENSG00000100890;KIAA0391;14;35591052;35743271;152219;0
5393;ENSG00000100897;DCAF11;14;24583404;24594451;11047;0
5394;ENSG00000100902;PSMA6;14;35747839;35786699;38860;0
5395;ENSG00000100906;NFKBIA;14;35870717;35873955;3238;0
5396;ENSG00000100908;EMC9;14;24608174;24610797;2623;0
5397;ENSG00000100911;PSME2;14;24612574;24616779;4205;0
5398;ENSG00000100916;BRMS1L;14;36295524;36401531;106007;0
5399;ENSG00000100918;REC8;14;24641062;24649463;8401;0
5400;ENSG00000100926;TM9SF1;14;24658349;24682679;24330;0
5401;ENSG00000100934;SEC23A;14;39501123;39578850;77727;0
5402;ENSG00000100938;GMPR2;14;24701628;24708448;6820;0
5403;ENSG00000100941;PNN;14;39644387;39652422;8035;0
5404;ENSG00000100949;RABGGTA;14;24734744;24740945;6201;0
5405;ENSG00000100968;NFATC4;14;24834879;24848810;13931;0
5406;ENSG00000101489;CELF4;18;34823010;35146000;322990;0
5407;ENSG00000101493;ZNF516;18;74069644;74207146;137502;0
5408;ENSG00000101542;CDH20;18;59000815;59223006;222191;0
5409;ENSG00000101544;ADNP2;18;77866915;77905406;38491;0
5410;ENSG00000101546;RBFA;18;77794358;77806397;12039;0
5411;ENSG00000101557;USP14;18;158383;214629;56246;0
5412;ENSG00000101558;VAPA;18;9913999;9960018;46019;0
5413;ENSG00000101574;METTL4;18;2537524;2571508;33984;0
5414;ENSG00000101577;LPIN2;18;2916992;3013313;96321;0
5415;ENSG00000101596;SMCHD1;18;2655737;2805015;149278;0
5416;ENSG00000101605;MYOM1;18;3066805;3220106;153301;0
5417;ENSG00000101608;MYL12A;18;3247479;3256234;8755;0
5418;ENSG00000101624;CEP76;18;12661832;12702776;40944;0
5419;ENSG00000101638;ST8SIA5;18;44259081;44339220;80139;1
5420;ENSG00000101639;CEP192;18;12991361;13125051;133690;0
5421;ENSG00000101654;RNMT;18;13726659;13764557;37898;0
5422;ENSG00000101665;SMAD7;18;46446223;46477081;30858;0
5423;ENSG00000101670;LIPG;18;47087069;47119272;32203;0
5424;ENSG00000101680;LAMA1;18;6941743;7117813;176070;0
5425;ENSG00000101695;RNF125;18;29598335;29653176;54841;0
5426;ENSG00000101745;ANKRD12;18;9136226;9285983;149757;0
5427;ENSG00000101746;NOL4;18;31431064;31804916;373852;0
5428;ENSG00000101751;POLI;18;51795774;51847636;51862;0
5429;ENSG00000101752;MIB1;18;19284918;19450918;166000;0
5430;ENSG00000101773;RBBP8;18;20378224;20606451;228227;0
5431;ENSG00000101782;RIOK3;18;21032787;21066567;33780;0
5432;ENSG00000102452;NALCN;13;101706130;102068843;362713;0
5433;ENSG00000102466;FGF14;13;102372134;103054124;681990;0
5434;ENSG00000102471;NDFIP2;13;80055287;80130210;74923;0
5435;ENSG00000102554;KLF5;13;73629114;73651676;22562;0
5436;ENSG00000102572;STK24;13;99102455;99230194;127739;0
5437;ENSG00000102580;DNAJC3;13;96329393;96447243;117850;0
5438;ENSG00000102595;UGGT2;13;96453834;96705736;251902;0
5439;ENSG00000102606;ARHGEF7;13;111766906;111958084;191178;0
5440;ENSG00000102805;CLN5;13;77564795;77576652;11857;0
5441;ENSG00000102858;MGRN1;16;4666494;4740975;74481;0
5442;ENSG00000102870;ZNF629;16;30789778;30798523;8745;0
5443;ENSG00000102871;TRADD;16;67188083;67194201;6118;0
5444;ENSG00000102878;HSF4;16;67197288;67203848;6560;0
5445;ENSG00000102879;CORO1A;16;30194148;30200397;6249;0
5446;ENSG00000102882;MAPK3;16;30125426;30134827;9401;0
5447;ENSG00000102886;GDPD3;16;30116131;30125177;9046;0
5448;ENSG00000102890;ELMO3;16;67233014;67237932;4918;0
5449;ENSG00000102893;PHKB;16;47495034;47735434;240400;0
5450;ENSG00000102897;LYRM1;16;20911190;20936328;25138;0
5451;ENSG00000102898;NUTF2;16;67880635;67906470;25835;0
5452;ENSG00000102900;NUP93;16;56764017;56878797;114780;0
5453;ENSG00000102901;CENPT;16;67862060;67881714;19654;0
5454;ENSG00000102904;TSNAXIP1;16;67840668;67866051;25383;0
5455;ENSG00000102908;NFAT5;16;69598997;69738569;139572;0
5456;ENSG00000102910;LONP2;16;48278207;48397033;118826;0
5457;ENSG00000102921;N4BP1;16;48572637;48654059;81422;0
5458;ENSG00000102924;CBLN1;16;49311828;49315742;3914;0
5459;ENSG00000102931;ARL2BP;16;57279010;57287516;8506;0
5460;ENSG00000102934;PLLP;16;57290004;57318599;28595;0
5461;ENSG00000102935;ZNF423;16;49521435;49891830;370395;0
5462;ENSG00000102967;DHODH;16;72042487;72058954;16467;0
5463;ENSG00000102974;CTCF;16;67596310;67673086;76776;0
5464;ENSG00000102977;ACD;16;67691415;67694713;3298;0
5465;ENSG00000102978;POLR2C;16;57496299;57505922;9623;0
5466;ENSG00000102981;PARD6A;16;67694849;67696681;1832;0
5467;ENSG00000102984;ZNF821;16;71893583;71929239;35656;0
5468;ENSG00000102996;MMP15;16;58059470;58080805;21335;0
5469;ENSG00000103005;USB1;16;58033450;58055522;22072;0
5470;ENSG00000103018;CYB5B;16;69458428;69500169;41741;0
5471;ENSG00000103021;CCDC113;16;58265061;58317740;52679;0
5472;ENSG00000103024;NME3;16;1820287;1821731;1444;0
5473;ENSG00000103034;NDRG4;16;58496750;58547532;50782;0
5474;ENSG00000103035;PSMD7;16;74330673;74340186;9513;0
5475;ENSG00000103037;SETD6;16;58549383;58554431;5048;0
5476;ENSG00000103042;SLC38A7;16;58699013;58719008;19995;0
5477;ENSG00000103043;VAC14;16;70721342;70835064;113722;0
5478;ENSG00000103044;HAS3;16;69139467;69152622;13155;0
5479;ENSG00000103047;TANGO6;16;68877507;69119083;241576;0
5480;ENSG00000103051;COG4;16;70514471;70557468;42997;0
5481;ENSG00000103056;SMPD3;16;68392231;68482591;90360;0
5482;ENSG00000103061;SLC7A6OS;16;68318406;68344849;26443;0
5483;ENSG00000103064;SLC7A6;16;68298433;68335722;37289;0
5484;ENSG00000103066;PLA2G15;16;68279207;68294961;15754;0
5485;ENSG00000103091;WDR59;16;74907468;75034071;126603;0
5486;ENSG00000103111;MON1B;16;77224732;77236302;11570;0
5487;ENSG00000103121;CMC2;16;81009698;81053875;44177;0
5488;ENSG00000103126;AXIN1;16;337440;402673;65233;0
5489;ENSG00000103145;HCFC1R1;16;3072621;3074287;1666;0
5490;ENSG00000103148;NPRL3;16;134273;188859;54586;0
5491;ENSG00000103150;MLYCD;16;83932731;83949787;17056;0
5492;ENSG00000103152;MPG;16;127006;135852;8846;0
5493;ENSG00000103154;NECAB2;16;84002237;84036381;34144;0
5494;ENSG00000103160;HSDL1;16;84155886;84178797;22911;0
5495;ENSG00000103168;TAF1C;16;84211458;84220669;9211;0
5496;ENSG00000103174;NAGPA;16;5074845;5084142;9297;0
5497;ENSG00000103175;WFDC1;16;84328252;84363450;35198;0
5498;ENSG00000103184;SEC14L5;16;5008318;5069159;60841;0
5499;ENSG00000103187;COTL1;16;84599200;84651683;52483;0
5500;ENSG00000103194;USP10;16;84733584;84813528;79944;0
5501;ENSG00000103196;CRISPLD2;16;84853590;84954374;100784;0
5502;ENSG00000103197;TSC2;16;2097466;2138716;41250;0
5503;ENSG00000103199;ZNF500;16;4798240;4817625;19385;0
5504;ENSG00000103202;NME4;16;446725;460367;13642;0
5505;ENSG00000103222;ABCC1;16;16043434;16236931;193497;0
5506;ENSG00000103226;NOMO3;16;16326352;16388668;62316;0
5507;ENSG00000103227;LMF1;16;903634;1031318;127684;0
5508;ENSG00000103245;NARFL;16;779753;791329;11576;0
5509;ENSG00000103248;MTHFSD;16;86563782;86588841;25059;0
5510;ENSG00000103249;CLCN7;16;1494935;1525581;30646;0
5511;ENSG00000103253;HAGHL;16;776936;785525;8589;0
5512;ENSG00000103254;FAM173A;16;770581;772601;2020;0
5513;ENSG00000103257;SLC7A5;16;87863629;87903094;39465;0
5514;ENSG00000103260;METRN;16;765115;769655;4540;0
5515;ENSG00000103264;FBXO31;16;87360593;87425748;65155;0
5516;ENSG00000103266;STUB1;16;730224;732870;2646;0
5517;ENSG00000103269;RHBDL1;16;725666;728268;2602;0
5518;ENSG00000103274;NUBP1;16;10837643;10863208;25565;0
5519;ENSG00000103275;UBE2I;16;1355548;1377019;21471;0
5520;ENSG00000103316;CRYM;16;21250195;21314404;64209;0
5521;ENSG00000103319;EEF2K;16;22217603;22298554;80951;0
5522;ENSG00000103326;CAPN15;16;577717;604636;26919;0
5523;ENSG00000103335;PIEZO1;16;88781751;88851619;69868;0
5524;ENSG00000103342;GSPT1;16;11961985;12009939;47954;0
5525;ENSG00000103343;ZNF174;16;3451235;3459370;8135;0
5526;ENSG00000103351;CLUAP1;16;3550924;3589048;38124;0
5527;ENSG00000103353;UBFD1;16;23568392;23585710;17318;0
5528;ENSG00000103356;EARS2;16;23533335;23569052;35717;0
5529;ENSG00000103363;TCEB2;16;2821415;2827298;5883;0
5530;ENSG00000103365;GGA2;16;23474863;23533316;58453;0
5531;ENSG00000103375;AQP8;16;25227052;25240261;13209;0
5532;ENSG00000103381;CPPED1;16;12756919;12897874;140955;0
5533;ENSG00000103404;USP31;16;23072727;23160591;87864;0
5534;ENSG00000103415;HMOX2;16;4524691;4560348;35657;0
5535;ENSG00000103423;DNAJA3;16;4475806;4506776;30970;0
5536;ENSG00000103429;BFAR;16;14726672;14763093;36421;0
5537;ENSG00000103449;SALL1;16;51169886;51185278;15392;1
5538;ENSG00000103460;TOX3;16;52471917;52581714;109797;0
5539;ENSG00000103472;RRN3P2;16;29086163;29128039;41876;0
5540;ENSG00000103479;RBL2;16;53467889;53525561;57672;0
5541;ENSG00000103485;QPRT;16;29674600;29710020;35420;0
5542;ENSG00000103489;XYLT1;16;17195626;17564738;369112;0
5543;ENSG00000103494;RPGRIP1L;16;53631595;53737850;106255;0
5544;ENSG00000103495;MAZ;16;29817427;29823649;6222;0
5545;ENSG00000103496;STX4;16;31044210;31054296;10086;0
5546;ENSG00000103502;CDIPT;16;29869678;29875057;5379;0
5547;ENSG00000103507;BCKDK;16;31117428;31124110;6682;0
5548;ENSG00000103510;KAT8;16;31127075;31142714;15639;0
5549;ENSG00000103512;NOMO1;16;14927538;14990017;62479;0
5550;ENSG00000103528;SYT17;16;19179293;19279652;100359;0
5551;ENSG00000103540;CCP110;16;19535133;19564730;29597;0
5552;ENSG00000103544;C16orf62;16;19566562;19718115;151553;0
5553;ENSG00000103549;RNF40;16;30773066;30787628;14562;0
5554;ENSG00000103550;KNOP1;16;19714902;19729557;14655;0
5555;ENSG00000103591;AAGAB;15;67493371;67547533;54162;0
5556;ENSG00000103599;IQCH;15;67547138;67794598;247460;0
5557;ENSG00000103642;LACTB;15;63413999;63434260;20261;0
5558;ENSG00000103647;CORO2B;15;68871308;69020145;148837;0
5559;ENSG00000103653;CSK;15;75074398;75095539;21141;0
5560;ENSG00000103657;HERC1;15;63900817;64126141;225324;0
5561;ENSG00000103671;TRIP4;15;64679947;64747502;67555;0
5562;ENSG00000103707;MTFMT;15;65294845;65321977;27132;0
5563;ENSG00000103723;AP3B2;15;83328033;83378666;50633;0
5564;ENSG00000103740;ACSBG1;15;78459810;78538030;78220;0
5565;ENSG00000103742;IGDCC4;15;65673802;65715410;41608;0
5566;ENSG00000103769;RAB11A;15;66018392;66184329;165937;0
5567;ENSG00000103811;CTSH;15;79213400;79241916;28516;0
5568;ENSG00000103852;TTC23;15;99676528;99791428;114900;0
5569;ENSG00000103855;CD276;15;73976307;74006859;30552;0
5570;ENSG00000103876;FAH;15;80444832;80479288;34456;1
5571;ENSG00000103888;KIAA1199;15;81071684;81244117;172433;0
5572;ENSG00000103932;RPAP1;15;41809374;41836467;27093;0
5573;ENSG00000103942;HOMER2;15;83509838;83654661;144823;0
5574;ENSG00000103966;EHD4;15;42190950;42264776;73826;0
5575;ENSG00000103978;TMEM87A;15;42502730;42565861;63131;0
5576;ENSG00000103994;ZNF106;15;42705021;42783321;78300;0
5577;ENSG00000103995;CEP152;15;49005125;49103343;98218;0
5578;ENSG00000104043;ATP8B4;15;50150435;50475014;324579;1
5579;ENSG00000104044;OCA2;15;28000021;28344504;344483;0
5580;ENSG00000104047;DTWD1;15;49913177;49937333;24156;0
5581;ENSG00000104059;FAM189A1;15;29412457;29862927;450470;0
5582;ENSG00000104064;GABPB1;15;50569389;50647605;78216;0
5583;ENSG00000104067;TJP1;15;29991571;30261068;269497;0
5584;ENSG00000104081;BMF;15;40380091;40401093;21002;1
5585;ENSG00000104093;DMXL2;15;51739908;51915030;175122;0
5586;ENSG00000104112;SCG3;15;51973550;52013223;39673;0
5587;ENSG00000104129;DNAJC17;15;41060067;41099675;39608;0
5588;ENSG00000104131;EIF3J;15;44829255;44855227;25972;0
5589;ENSG00000104133;SPG11;15;44854894;44955876;100982;0
5590;ENSG00000104140;RHOV;15;41164412;41166487;2075;0
5591;ENSG00000104142;VPS18;15;41186628;41196173;9545;0
5592;ENSG00000104147;OIP5;15;41601466;41624819;23353;0
5593;ENSG00000104154;SLC30A4;15;45771809;45815005;43196;0
5594;ENSG00000104164;BLOC1S6;15;45879321;45908197;28876;0
5595;ENSG00000104177;MYEF2;15;48431625;48470714;39089;0
5596;ENSG00000104731;KLHDC4;16;87730091;87799598;69507;0
5597;ENSG00000104774;MAN2B1;19;12757325;12777556;20231;0
5598;ENSG00000104805;NUCB1;19;49403307;49426629;23322;0
5599;ENSG00000104808;DHDH;19;49436939;49448226;11287;0
5600;ENSG00000104812;GYS1;19;49471382;49496567;25185;0
5601;ENSG00000104814;MAP4K1;19;39078281;39109522;31241;0
5602;ENSG00000104823;ECH1;19;39306062;39322645;16583;0
5603;ENSG00000104824;HNRNPL;19;39327028;39342987;15959;0
5604;ENSG00000104825;NFKBIB;19;39390340;39399533;9193;0
5605;ENSG00000104833;TUBB4A;19;6494330;6502859;8529;0
5606;ENSG00000104835;SARS2;19;39405906;39440495;34589;0
5607;ENSG00000104852;SNRNP70;19;49588676;49611862;23186;0
5608;ENSG00000104853;CLPTM1;19;45457842;45496599;38757;0
5609;ENSG00000104856;RELB;19;45504688;45541452;36764;0
5610;ENSG00000104859;CLASRP;19;45542298;45574214;31916;0
5611;ENSG00000104863;LIN7B;19;49617581;49621717;4136;0
5612;ENSG00000104866;PPP1R37;19;45594654;45651335;56681;0
5613;ENSG00000104870;FCGRT;19;50010073;50029590;19517;0
5614;ENSG00000104872;PIH1D1;19;49949555;49956754;7199;0
5615;ENSG00000104880;ARHGEF18;19;7459999;7537363;77364;0
5616;ENSG00000104881;PPP1R13L;19;45882892;45909607;26715;0
5617;ENSG00000104883;PEX11G;19;7541761;7562335;20574;0
5618;ENSG00000104884;ERCC2;19;45853095;45874176;21081;0
5619;ENSG00000104885;DOT1L;19;2164148;2232577;68429;0
5620;ENSG00000104886;PLEKHJ1;19;2230002;2237703;7701;0
5621;ENSG00000104888;SLC17A7;19;49932658;49945617;12959;0
5622;ENSG00000104889;RNASEH2A;19;12917394;12924452;7058;0
5623;ENSG00000104897;SF3A2;19;2236520;2248678;12158;0
5624;ENSG00000104899;AMH;19;2249308;2252072;2764;0
5625;ENSG00000104901;DKKL1;19;49865040;49878373;13333;0
5626;ENSG00000104904;OAZ1;19;2269485;2273487;4002;0
5627;ENSG00000104907;TRMT1;19;13215716;13228381;12665;0
5628;ENSG00000104915;STX10;19;13254872;13261197;6325;0
5629;ENSG00000104936;DMPK;19;46272975;46285810;12835;0
5630;ENSG00000104946;TBC1D17;19;50380682;50392005;11323;0
5631;ENSG00000104951;IL4I1;19;50392911;50432796;39885;0
5632;ENSG00000104953;TLE6;19;2977444;2995177;17733;0
5633;ENSG00000104957;CCDC130;19;13842574;13874110;31536;0
5634;ENSG00000104960;PTOV1;19;50353992;50364001;10009;0
5635;ENSG00000104964;AES;19;3052908;3063105;10197;0
5636;ENSG00000104967;NOVA2;19;46436992;46476804;39812;0
5637;ENSG00000104969;SGTA;19;2754712;2783369;28657;0
5638;ENSG00000104973;MED25;19;50321539;50342073;20534;0
5639;ENSG00000104976;SNAPC2;19;7985201;7988135;2934;0
5640;ENSG00000104979;C19orf53;19;13884982;13889276;4294;0
5641;ENSG00000104980;TIMM44;19;7991603;8008805;17202;0
5642;ENSG00000104983;CCDC61;19;46498339;46524576;26237;0
5643;ENSG00000104998;IL27RA;19;14142560;14163743;21183;0
5644;ENSG00000105011;ASF1B;19;14230321;14247768;17447;0
5645;ENSG00000105053;VRK3;19;50479724;50529203;49479;0
5646;ENSG00000105058;FAM32A;19;16296191;16302857;6666;0
5647;ENSG00000105072;C19orf44;19;16607122;16632163;25041;0
5648;ENSG00000105085;MED26;19;16685718;16739873;54155;0
5649;ENSG00000105088;OLFM2;19;9964394;10047228;82834;0
5650;ENSG00000105127;AKAP8;19;15464196;15490609;26413;0
5651;ENSG00000105135;ILVBL;19;15225795;15236596;10801;0
5652;ENSG00000105137;SYDE1;19;15218214;15225799;7585;0
5653;ENSG00000105143;SLC1A6;19;15060846;15133802;72956;0
5654;ENSG00000105171;POP4;19;30094924;30108144;13220;0
5655;ENSG00000105173;CCNE1;19;30302805;30315215;12410;0
5656;ENSG00000105176;URI1;19;30414551;30506611;92060;0
5657;ENSG00000105185;PDCD5;19;33071974;33078358;6384;0
5658;ENSG00000105186;ANKRD27;19;33087913;33167503;79590;0
5659;ENSG00000105193;RPS16;19;39923847;39926588;2741;0
5660;ENSG00000105197;TIMM50;19;39971052;39984422;13370;0
5661;ENSG00000105202;FBL;19;40325098;40337054;11956;0
5662;ENSG00000105204;DYRK1B;19;40315990;40324841;8851;0
5663;ENSG00000105219;CNTD2;19;40728115;40732597;4482;0
5664;ENSG00000105220;GPI;19;34850385;34893061;42676;0
5665;ENSG00000105221;AKT2;19;40736224;40791443;55219;0
5666;ENSG00000105223;PLD3;19;40854363;40886346;31983;0
5667;ENSG00000105227;PRX;19;40899675;40919273;19598;0
5668;ENSG00000105229;PIAS4;19;4007644;4039384;31740;0
5669;ENSG00000105245;NUMBL;19;41172596;41196877;24281;0
5670;ENSG00000105248;CCDC94;19;4247076;4269087;22011;0
5671;ENSG00000105251;SHD;19;4278598;4290721;12123;1
5672;ENSG00000105254;TBCB;19;36605191;36616849;11658;0
5673;ENSG00000105255;FSD1;19;4304597;4323840;19243;0
5674;ENSG00000105258;POLR2I;19;36604612;36606248;1636;0
5675;ENSG00000105270;CLIP3;19;36505562;36524245;18683;0
5676;ENSG00000105278;ZFR2;19;3804022;3869030;65008;0
5677;ENSG00000105281;SLC1A5;19;47278140;47291851;13711;0
5678;ENSG00000105287;PRKD2;19;47177532;47220384;42852;1
5679;ENSG00000105289;TJP3;19;3708107;3750811;42704;0
5680;ENSG00000105290;APLP1;19;36358801;36370693;11892;0
5681;ENSG00000105298;CACTIN;19;3610639;3626813;16174;0
5682;ENSG00000105321;CCDC9;19;47759237;47775210;15973;0
5683;ENSG00000105323;HNRNPUL1;19;41768401;41813503;45102;0
5684;ENSG00000105325;FZR1;19;3506271;3538328;32057;0
5685;ENSG00000105327;BBC3;19;47724081;47736023;11942;1
5686;ENSG00000105329;TGFB1;19;41807492;41859816;52324;0
5687;ENSG00000105341;ATP5SL;19;41937223;41946622;9399;0
5688;ENSG00000105355;PLIN3;19;4838353;4867780;29427;0
5689;ENSG00000105364;MRPL4;19;10362577;10370721;8144;0
5690;ENSG00000105372;RPS19;19;42363988;42376994;13006;0
5691;ENSG00000105373;GLTSCR2;19;48248779;48260315;11536;0
5692;ENSG00000105376;ICAM5;19;10400657;10407454;6797;0
5693;ENSG00000105379;ETFB;19;51848423;51869672;21249;1
5694;ENSG00000105393;BABAM1;19;17378159;17392058;13899;0
5695;ENSG00000105397;TYK2;19;10461209;10491352;30143;0
5696;ENSG00000105401;CDC37;19;10501810;10530797;28987;0
5697;ENSG00000105402;NAPA;19;47990894;48018497;27603;0
5698;ENSG00000105404;RABAC1;19;42460833;42463542;2709;0
5699;ENSG00000105409;ATP1A3;19;42470734;42501649;30915;0
5700;ENSG00000105419;MEIS3;19;47906381;47922780;16399;0
5701;ENSG00000105426;PTPRS;19;5158506;5340814;182308;0
5702;ENSG00000105429;MEGF8;19;42829761;42882921;53160;0
5703;ENSG00000105438;KDELR1;19;48885827;48894810;8983;0
5704;ENSG00000105443;CYTH2;19;48972289;48985571;13282;0
5705;ENSG00000105447;GRWD1;19;48949030;48960279;11249;0
5706;ENSG00000105464;GRIN2D;19;48898132;48948188;50056;0
5707;ENSG00000105472;CLEC11A;19;51226586;51228974;2388;0
5708;ENSG00000105479;CCDC114;19;48799714;48825151;25437;0
5709;ENSG00000105483;CARD8;19;48684027;48759203;75176;0
5710;ENSG00000105486;LIG1;19;48618702;48673860;55158;0
5711;ENSG00000105497;ZNF175;19;52074551;52092991;18440;0
5712;ENSG00000105499;PLA2G4C;19;48551100;48614074;62974;0
5713;ENSG00000105509;HAS1;19;52216365;52227247;10882;0
5714;ENSG00000105514;RAB3D;19;11432722;11456946;24224;0
5715;ENSG00000105516;DBP;19;49133287;49140695;7408;0
5716;ENSG00000105518;TMEM205;19;11453452;11457194;3742;0
5717;ENSG00000105519;CAPS;19;5911718;5915888;4170;0
5718;ENSG00000105520;;19;11466062;11476374;10312;0
5719;ENSG00000105538;RASIP1;19;49223844;49243978;20134;0
5720;ENSG00000105552;BCAT2;19;49298319;49314286;15967;0
5721;ENSG00000105556;MIER2;19;305575;344798;39223;0
5722;ENSG00000105559;PLEKHA4;19;49340354;49371889;31535;0
5723;ENSG00000105568;PPP2R1A;19;52693292;52730687;37395;0
5724;ENSG00000105576;TNPO2;19;12810008;12834825;24817;0
5725;ENSG00000105583;WDR83OS;19;12778885;12782170;3285;0
5726;ENSG00000105607;GCDH;19;13001840;13025021;23181;0
5727;ENSG00000105612;DNASE2;19;12986025;12992282;6257;0
5728;ENSG00000105613;MAST1;19;12944765;12985765;41000;0
5729;ENSG00000105639;JAK3;19;17935589;17958880;23291;0
5730;ENSG00000105640;RPL18A;19;17970685;17974962;4277;0
5731;ENSG00000105642;KCNN1;19;18062102;18110889;48787;0
5732;ENSG00000105643;ARRDC2;19;18111941;18124911;12970;0
5733;ENSG00000105649;RAB3A;19;18307594;18314884;7290;0
5734;ENSG00000105650;PDE4C;19;18318771;18366229;47458;0
5735;ENSG00000105655;ISYNA1;19;18545198;18549111;3913;0
5736;ENSG00000105656;ELL;19;18553473;18632937;79464;0
5737;ENSG00000105662;CRTC1;19;18794487;18893004;98517;0
5738;ENSG00000105663;KMT2B;19;36208921;36229779;20858;0
5739;ENSG00000105668;UPK1A;19;36157715;36169367;11652;0
5740;ENSG00000105669;COPE;19;19010323;19030206;19883;0
5741;ENSG00000105671;DDX49;19;19030484;19039436;8952;0
5742;ENSG00000105672;ETV2;19;36132647;36135773;3126;0
5743;ENSG00000105676;ARMC6;19;19144384;19170563;26179;0
5744;ENSG00000105677;TMEM147;19;36036497;36038428;1931;0
5745;ENSG00000105696;TMEM59L;19;18718240;18731849;13609;0
5746;ENSG00000105698;USF2;19;35759881;35770724;10843;0
5747;ENSG00000105699;LSR;19;35739233;35758867;19634;0
5748;ENSG00000105700;KXD1;19;18668572;18680197;11625;0
5749;ENSG00000105701;FKBP8;19;18642561;18654887;12326;0
5750;ENSG00000105705;SUGP1;19;19386827;19431653;44826;0
5751;ENSG00000105708;ZNF14;19;19821280;19843906;22626;0
5752;ENSG00000105711;SCN1B;19;35521588;35531352;9764;0
5753;ENSG00000105717;PBX4;19;19672522;19729725;57203;0
5754;ENSG00000105722;ERF;19;42751724;42759309;7585;0
5755;ENSG00000105723;GSK3A;19;42734338;42746777;12439;0
5756;ENSG00000105726;ATP13A1;19;19756007;19774502;18495;0
5757;ENSG00000105732;ZNF574;19;42572629;42585701;13072;0
5758;ENSG00000105737;GRIK5;19;42502473;42573650;71177;0
5759;ENSG00000105738;SIPA1L3;19;38397868;38699012;301144;0
5760;ENSG00000105750;ZNF85;19;21106028;21133503;27475;0
5761;ENSG00000105755;ETHE1;19;44010871;44031396;20525;0
5762;ENSG00000105767;CADM4;19;44126520;44143991;17471;0
5763;ENSG00000105771;SMG9;19;44235301;44259142;23841;0
5764;ENSG00000108256;NUFIP2;17;27582854;27621136;38282;0
5765;ENSG00000108262;GIT1;17;27900487;27921072;20585;0
5766;ENSG00000108264;TADA2A;17;35766965;35839835;72870;0
5767;ENSG00000108270;AATF;17;35306175;35414171;107996;0
5768;ENSG00000108272;DHRS11;17;34948228;34957235;9007;0
5769;ENSG00000108278;ZNHIT3;17;34842473;34855154;12681;0
5770;ENSG00000108292;MLLT6;17;36861795;36886056;24261;0
5771;ENSG00000108294;PSMB3;17;36908989;36920484;11495;0
5772;ENSG00000108296;CWC25;17;36956687;36981734;25047;0
5773;ENSG00000108298;RPL19;17;37356536;37360980;4444;0
5774;ENSG00000108306;FBXL20;17;37415384;37558776;143392;0
5775;ENSG00000108309;RUNDC3A;17;42385781;42396039;10258;0
5776;ENSG00000108312;UBTF;17;42282401;42298994;16593;0
5777;ENSG00000108344;PSMD3;17;38137050;38154213;17163;0
5778;ENSG00000108349;CASC3;17;38296571;38328436;31865;0
5779;ENSG00000108352;RAPGEFL1;17;38333263;38351908;18645;0
5780;ENSG00000108370;RGS9;17;63133549;63223821;90272;0
5781;ENSG00000108375;RNF43;17;56429861;56494956;65095;0
5782;ENSG00000108379;WNT3;17;44839872;44910520;70648;0
5783;ENSG00000108381;ASPA;17;3375668;3406713;31045;0
5784;ENSG00000108384;RAD51C;17;56769934;56811703;41769;0
5785;ENSG00000108387;04-Sep;17;56597611;56618179;20568;0
5786;ENSG00000108389;MTMR4;17;56566898;56595266;28368;0
5787;ENSG00000108395;TRIM37;17;57059999;57184282;124283;0
5788;ENSG00000108406;DHX40;17;57642886;57685706;42820;0
5789;ENSG00000108423;TUBD1;17;57936851;57970304;33453;0
5790;ENSG00000108424;KPNB1;17;45726842;45762871;36029;0
5791;ENSG00000108433;GOSR2;17;45000483;45105003;104520;0
5792;ENSG00000108439;PNPO;17;46018872;46025654;6782;0
5793;ENSG00000108443;RPS6KB1;17;57970447;58027925;57478;0
5794;ENSG00000108448;TRIM16L;17;18601311;18639431;38120;0
5795;ENSG00000108465;CDK5RAP3;17;46045176;46059140;13964;0
5796;ENSG00000108468;CBX1;17;46147414;46178883;31469;0
5797;ENSG00000108469;RECQL5;17;73622925;73663269;40344;0
5798;ENSG00000108474;PIGL;17;16120505;16252115;131610;0
5799;ENSG00000108479;GALK1;17;73747675;73761792;14117;0
5800;ENSG00000108506;INTS2;17;59942731;60005377;62646;0
5801;ENSG00000108509;CAMTA2;17;4871287;4890960;19673;0
5802;ENSG00000108510;MED13;17;60019966;60142643;122677;0
5803;ENSG00000108515;ENO3;17;4851387;4860426;9039;0
5804;ENSG00000108518;PFN1;17;4848947;4852356;3409;0
5805;ENSG00000108523;RNF167;17;4843303;4848517;5214;0
5806;ENSG00000108528;SLC25A11;17;4840425;4843546;3121;0
5807;ENSG00000108551;RASD1;17;17397751;17399709;1958;0
5808;ENSG00000108556;CHRNE;17;4801069;4806369;5300;0
5809;ENSG00000108557;RAI1;17;17584787;17714767;129980;0
5810;ENSG00000108559;NUP88;17;5264258;5323480;59222;0
5811;ENSG00000108561;C1QBP;17;5336097;5352150;16053;0
5812;ENSG00000108578;BLMH;17;28575218;28619074;43856;0
5813;ENSG00000108582;CPD;17;28705923;28797007;91084;0
5814;ENSG00000108587;GOSR1;17;28804380;28854610;50230;0
5815;ENSG00000108588;CCDC47;17;61822610;61853711;31101;0
5816;ENSG00000108590;MED31;17;6546635;6554954;8319;0
5817;ENSG00000108591;DRG2;17;17991200;18011285;20085;0
5818;ENSG00000108592;FTSJ3;17;61896793;61907372;10579;0
5819;ENSG00000108599;AKAP10;17;19807615;19881656;74041;0
5820;ENSG00000108604;SMARCD2;17;61909444;61920425;10981;0
5821;ENSG00000108639;SYNGR2;17;76164639;76169608;4969;0
5822;ENSG00000108641;B9D1;17;19240867;19281495;40628;0
5823;ENSG00000108651;UTP6;17;30187923;30228784;40861;0
5824;ENSG00000108654;DDX5;17;62495734;62504317;8583;0
5825;ENSG00000108666;C17orf75;17;30651584;30677042;25458;0
5826;ENSG00000108669;CYTH1;17;76670130;76778379;108249;0
5827;ENSG00000108671;PSMD11;17;30771279;30810336;39057;0
5828;ENSG00000108679;LGALS3BP;17;76967320;76976191;8871;0
5829;ENSG00000108684;ASIC2;17;31340105;32501983;1161878;0
5830;ENSG00000108691;CCL2;17;32582304;32584222;1918;0
5831;ENSG00000108733;PEX12;17;33901814;33905882;4068;0
5832;ENSG00000108753;HNF1B;17;36046435;36105237;58802;0
5833;ENSG00000108771;DHX58;17;40253422;40264751;11329;0
5834;ENSG00000108773;KAT2A;17;40265126;40273376;8250;0
5835;ENSG00000108774;RAB5C;17;40276994;40307035;30041;0
5836;ENSG00000108784;NAGLU;17;40688190;40696467;8277;0
5837;ENSG00000108785;HSD17B1P1;17;40698782;40700724;1942;0
5838;ENSG00000108786;HSD17B1;17;40701232;40707231;5999;0
5839;ENSG00000108788;MLX;17;40719086;40725257;6171;0
5840;ENSG00000108797;CNTNAP1;17;40834631;40851832;17201;0
5841;ENSG00000108799;EZH1;17;40852293;40897071;44778;0
5842;ENSG00000108819;PPP1R9B;17;48211104;48227991;16887;0
5843;ENSG00000108821;COL1A1;17;48260650;48278993;18343;0
5844;ENSG00000108826;MRPL27;17;48445218;48450575;5357;0
5845;ENSG00000108828;VAT1;17;41166622;41177140;10518;0
5846;ENSG00000108829;LRRC59;17;48452420;48474914;22494;0
5847;ENSG00000108830;RND2;17;41177258;41184057;6799;0
5848;ENSG00000108840;HDAC5;17;42154114;42201070;46956;0
5849;ENSG00000108848;LUC7L3;17;48796905;48833574;36669;0
5850;ENSG00000108852;MPP2;17;41952725;41987068;34343;0
5851;ENSG00000108854;SMURF2;17;62538413;62658186;119773;0
5852;ENSG00000108861;DUSP3;17;41843489;41856356;12867;0
5853;ENSG00000108878;CACNG1;17;65040706;65052909;12203;0
5854;ENSG00000108883;EFTUD2;17;42927311;42977030;49719;0
5855;ENSG00000108924;HLF;17;53342373;53402426;60053;0
5856;ENSG00000108932;SLC16A6;17;66263167;66287408;24241;1
5857;ENSG00000108946;PRKAR1A;17;66507921;66547460;39539;0
5858;ENSG00000108947;EFNB3;17;7608520;7614696;6176;0
5859;ENSG00000108953;YWHAE;17;1247566;1303672;56106;0
5860;ENSG00000108960;MMD;17;53469974;53499353;29379;0
5861;ENSG00000108961;RANGRF;17;8191815;8193410;1595;0
5862;ENSG00000108963;DPH1;17;1933404;1946724;13320;0
5863;ENSG00000108984;MAP2K6;17;67410839;67539472;128633;0
5864;ENSG00000109016;DHRS7B;17;21026677;21096578;69901;0
5865;ENSG00000109046;WSB1;17;25621102;25640657;19555;0
5866;ENSG00000109062;SLC9A3R1;17;72744791;72765492;20701;0
5867;ENSG00000109063;MYH3;17;10531843;10560626;28783;0
5868;ENSG00000109065;NAT9;17;72766686;72772506;5820;0
5869;ENSG00000109066;TMEM104;17;72772622;72835918;63296;0
5870;ENSG00000109072;VTN;17;26691290;26700110;8820;0
5871;ENSG00000109072;SEBOX;17;26691290;26700110;8820;0
5872;ENSG00000109079;TNFAIP1;17;26662628;26674035;11407;0
5873;ENSG00000109083;IFT20;17;26655352;26662515;7163;0
5874;ENSG00000109084;TMEM97;17;26646121;26655707;9586;0
5875;ENSG00000109089;CDR2L;17;72983727;73001895;18168;0
5876;ENSG00000109099;PMP22;17;15133095;15168643;35548;0
5877;ENSG00000109103;UNC119;17;26873725;26879686;5961;0
5878;ENSG00000109107;ALDOC;17;26900133;26904282;4149;1
5879;ENSG00000109111;SUPT6H;17;26989109;27029697;40588;0
5880;ENSG00000109113;RAB34;17;27041299;27045447;4148;0
5881;ENSG00000109118;PHF12;17;27232268;27278789;46521;0
5882;ENSG00000114062;UBE3A;15;25582381;25684128;101747;0
5883;ENSG00000115255;REEP6;19;1491165;1497926;6761;0
5884;ENSG00000115257;PCSK4;19;1481427;1490751;9324;0
5885;ENSG00000115266;APC2;19;1446300;1473243;26943;0
5886;ENSG00000115268;RPS15;19;1438358;1440583;2225;0
5887;ENSG00000115286;NDUFS7;19;1383526;1395583;12057;0
5888;ENSG00000116017;ARID3A;19;925781;975939;50158;0
5889;ENSG00000117877;CD3EAP;19;45909467;45914024;4557;0
5890;ENSG00000117899;MESDC2;15;81239667;81282219;42552;0
5891;ENSG00000117906;RCN2;15;77223960;77242601;18641;0
5892;ENSG00000117971;CHRNB4;15;78916461;79020096;103635;0
5893;ENSG00000118046;STK11;19;1189406;1228428;39022;0
5894;ENSG00000118160;SLC8A2;19;47931274;47975425;44151;0
5895;ENSG00000118162;KPTN;19;47978401;47987525;9124;0
5896;ENSG00000118276;B4GALT6;18;29202210;29265799;63589;0
5897;ENSG00000118557;PMFBP1;16;72146056;72210777;64721;0
5898;ENSG00000118620;ZNF430;19;21203426;21242856;39430;0
5899;ENSG00000118680;MYL12B;18;3261907;3278282;16375;0
5900;ENSG00000118894;FAM86A;16;5134305;5147809;13504;0
5901;ENSG00000118898;PPL;16;4932508;5010742;78234;0
5902;ENSG00000118900;UBN1;16;4896666;4932361;35695;0
5903;ENSG00000118922;KLF12;13;74260226;74708394;448168;0
5904;ENSG00000118939;UCHL3;13;76123619;76180085;56466;0
5905;ENSG00000118946;PCDH17;13;58205944;58303445;97501;0
5906;ENSG00000119537;KDSR;18;60994959;61034743;39784;0
5907;ENSG00000119541;VPS4B;18;61056423;61089716;33293;0
5908;ENSG00000119547;ONECUT2;18;55102917;55158529;55612;0
5909;ENSG00000119559;C19orf25;19;1461142;1479555;18413;0
5910;ENSG00000119596;YLPM1;14;75230069;75322244;92175;0
5911;ENSG00000119599;DCAF4;14;73393040;73426411;33371;0
5912;ENSG00000119616;FCF1;14;75179847;75203394;23547;0
5913;ENSG00000119630;PGF;14;75408537;75422487;13950;0
5914;ENSG00000119632;IFI27L2;14;94594116;94596590;2474;0
5915;ENSG00000119636;CCDC176;14;74486056;74549566;63510;0
5916;ENSG00000119638;NEK9;14;75548822;75594047;45225;0
5917;ENSG00000119640;ACYP1;14;75519924;75536186;16262;0
5918;ENSG00000119650;IFT43;14;76368479;76550928;182449;0
5919;ENSG00000119655;NPC2;14;74942895;74960880;17985;0
5920;ENSG00000119661;DNAL1;14;74111578;74170435;58857;0
5921;ENSG00000119669;IRF2BPL;14;77490888;77495034;4146;0
5922;ENSG00000119673;ACOT2;14;74034324;74042357;8033;0
5923;ENSG00000119681;LTBP2;14;74964873;75079306;114433;0
5924;ENSG00000119682;AREL1;14;75120140;75179818;59678;0
5925;ENSG00000119684;MLH3;14;75480467;75518235;37768;0
5926;ENSG00000119685;TTLL5;14;76099968;76421421;321453;0
5927;ENSG00000119686;FLVCR2;14;76044960;76129557;84597;0
5928;ENSG00000119688;ABCD4;14;74752126;74769759;17633;0
5929;ENSG00000119689;DLST;14;75348594;75370448;21854;0
5930;ENSG00000119698;PPP4R4;14;94612465;94746072;133607;0
5931;ENSG00000119699;TGFB3;14;76424442;76449334;24892;0
5932;ENSG00000119703;ZC2HC1C;14;75530873;75545126;14253;0
5933;ENSG00000119705;SLIRP;14;78174414;78227447;53033;0
5934;ENSG00000119707;RBM25;14;73525144;73588122;62978;0
5935;ENSG00000119711;ALDH6A1;14;74523553;74551196;27643;0
5936;ENSG00000119714;GPR68;14;91698876;91720269;21393;0
5937;ENSG00000119715;ESRRB;14;76776957;76968178;191221;1
5938;ENSG00000119718;EIF2B2;14;75469614;75476292;6678;0
5939;ENSG00000119720;NRDE2;14;90742580;90798481;55901;0
5940;ENSG00000119723;COQ6;14;74416629;74430373;13744;0
5941;ENSG00000119725;ZNF410;14;74353320;74399214;45894;0
5942;ENSG00000120063;GNA13;17;63006833;63052957;46124;0
5943;ENSG00000120071;KANSL1;17;44107282;44302733;195451;0
5944;ENSG00000120088;CRHR1;17;43699267;43913194;213927;0
5945;ENSG00000120784;ZFP30;19;38104650;38183238;78588;0
5946;ENSG00000121057;AKAP1;17;55162453;55198710;36257;0
5947;ENSG00000121058;COIL;17;55015548;55038415;22867;0
5948;ENSG00000121060;TRIM25;17;54965270;54991399;26129;0
5949;ENSG00000121064;SCPEP1;17;55055466;55084129;28663;0
5950;ENSG00000121067;SPOP;17;47676246;47755596;79350;0
5951;ENSG00000121073;SLC35B1;17;47778305;47786376;8071;0
5952;ENSG00000121101;TEX14;17;56634039;56769416;135377;0
5953;ENSG00000121104;FAM117A;17;47787694;47866542;78848;0
5954;ENSG00000121270;ABCC11;16;48200821;48281479;80658;0
5955;ENSG00000121274;PAPD5;16;50186829;50269221;82392;0
5956;ENSG00000121281;ADCY7;16;50280048;50352046;71998;0
5957;ENSG00000121289;CEP89;19;33369902;33462897;92995;0
5958;ENSG00000121297;TSHZ3;19;31765851;31840453;74602;0
5959;ENSG00000122254;HS3ST2;16;22825498;22927659;102161;0
5960;ENSG00000122257;RBBP6;16;24549014;24584184;35170;0
5961;ENSG00000122299;ZC3H7A;16;11844442;11891123;46681;0
5962;ENSG00000122386;ZNF205;16;3162561;3170518;7957;0
5963;ENSG00000122390;NAA60;16;3493611;3536963;43352;0
5964;ENSG00000122490;PQLC1;18;77662420;77711664;49244;0
5965;ENSG00000123136;DDX39A;19;14519631;14530192;10561;0
5966;ENSG00000123143;PKN1;19;14543865;14582679;38814;0
5967;ENSG00000123144;C19orf43;19;12841454;12845589;4135;0
5968;ENSG00000123146;CD97;19;14491313;14519537;28224;0
5969;ENSG00000123154;WDR83;19;12777614;12786646;9032;0
5970;ENSG00000123159;GIPC1;19;14588572;14606944;18372;0
5971;ENSG00000123700;KCNJ2;17;68164814;68176189;11375;0
5972;ENSG00000123810;B9D2;19;41860326;41870078;9752;0
5973;ENSG00000123815;ADCK4;19;41197434;41224112;26678;0
5974;ENSG00000123870;ZNF137P;19;53091758;53100660;8902;0
5975;ENSG00000124067;SLC12A4;16;67977377;68003504;26127;0
5976;ENSG00000124074;ENKD1;16;67696848;67701168;4320;0
5977;ENSG00000124299;PEPD;19;33877856;34012700;134844;0
5978;ENSG00000124302;CHST8;19;34112861;34264414;151553;0
5979;ENSG00000124422;USP22;17;20902910;20947073;44163;0
5980;ENSG00000124440;HIF3A;19;46800303;46846690;46387;1
5981;ENSG00000124444;ZNF576;19;44100544;44105309;4765;1
5982;ENSG00000124459;ZNF45;19;44416781;44439430;22649;0
5983;ENSG00000124466;LYPD3;19;43964939;43969812;4873;0
5984;ENSG00000125107;CNOT1;16;58553855;58663790;109935;0
5985;ENSG00000125122;LRRC29;16;67241042;67260951;19909;0
5986;ENSG00000125124;BBS2;16;56500748;56554195;53447;0
5987;ENSG00000125148;MT2A;16;56642111;56643409;1298;0
5988;ENSG00000125149;C16orf70;16;67143861;67182442;38581;0
5989;ENSG00000125166;GOT2;16;58741035;58768261;27226;0
5990;ENSG00000125170;DOK4;16;57505863;57521239;15376;0
5991;ENSG00000125246;CLYBL;13;100258919;100549387;290468;1
5992;ENSG00000125247;TMTC4;13;101256181;101327347;71166;0
5993;ENSG00000125249;RAP2A;13;98086476;98121382;34906;0
5994;ENSG00000125257;ABCC4;13;95672083;95953687;281604;1
5995;ENSG00000125266;EFNB2;13;107142079;107187462;45383;0
5996;ENSG00000125285;SOX21;13;95361886;95364389;2503;0
5997;ENSG00000125304;TM9SF2;13;100153671;100216260;62589;0
5998;ENSG00000125319;C17orf53;17;42219274;42239844;20570;0
5999;ENSG00000125375;ATP5S;14;50779044;50802276;23232;0
6000;ENSG00000125378;BMP4;14;54416454;54425479;9025;0
6001;ENSG00000125398;SOX9;17;70117161;70122561;5400;0
6002;ENSG00000125409;TEKT3;17;15207128;15244958;37830;0
6003;ENSG00000125430;HS3ST3B1;17;14204400;14252721;48321;0
6004;ENSG00000125434;SLC25A35;17;8191081;8198661;7580;0
6005;ENSG00000125445;MRPS7;17;73257755;73262454;4699;0
6006;ENSG00000125447;GGA3;17;73232694;73258444;25750;0
6007;ENSG00000125449;ARMC7;17;73106047;73126360;20313;0
6008;ENSG00000125450;NUP85;17;73201754;73231853;30099;0
6009;ENSG00000125454;SLC25A19;17;73269073;73285591;16518;0
6010;ENSG00000125457;MIF4GD;17;73262309;73267308;4999;0
6011;ENSG00000125458;NT5C;17;73126320;73127890;1570;0
6012;ENSG00000125648;SLC25A23;19;6436090;6465214;29124;0
6013;ENSG00000125650;PSPN;19;6375159;6379069;3910;0
6014;ENSG00000125651;GTF2F1;19;6379580;6393992;14412;0
6015;ENSG00000125652;ALKBH7;19;6372444;6375042;2598;0
6016;ENSG00000125656;CLPP;19;6361463;6368919;7456;0
6017;ENSG00000125657;TNFSF9;19;6531010;6535931;4921;0
6018;ENSG00000125686;MED1;17;37560538;37607539;47001;0
6019;ENSG00000125691;RPL23;17;37004118;37010096;5978;0
6020;ENSG00000125731;SH2D3A;19;6752171;6767599;15428;0
6021;ENSG00000125733;TRIP10;19;6737936;6751537;13601;0
6022;ENSG00000125734;GPR108;19;6729925;6737614;7689;0
6023;ENSG00000125740;FOSB;19;45971253;45978437;7184;0
6024;ENSG00000125741;OPA3;19;46030685;46105470;74785;0
6025;ENSG00000125743;SNRPD2;19;46190712;46195827;5115;0
6026;ENSG00000125744;RTN2;19;45988547;46000319;11772;0
6027;ENSG00000125746;EML2;19;46110252;46148887;38635;0
6028;ENSG00000125753;VASP;19;46009837;46030241;20404;0
6029;ENSG00000125755;SYMPK;19;46318668;46366548;47880;0
6030;ENSG00000125912;NCLN;19;3185561;3209573;24012;0
6031;ENSG00000125952;MAX;14;65472892;65569413;96521;0
6032;ENSG00000126214;KLC1;14;104028233;104167888;139655;0
6033;ENSG00000126215;XRCC3;14;104163946;104181841;17895;0
6034;ENSG00000126216;TUBGCP3;13;113139325;113242481;103156;0
6035;ENSG00000126217;MCF2L;13;113548692;113754053;205361;0
6036;ENSG00000126218;F10;13;113777128;113803843;26715;0
6037;ENSG00000126226;PCID2;13;113831891;113863029;31138;0
6038;ENSG00000126243;LRFN3;19;36426260;36436669;10409;0
6039;ENSG00000126246;IGFLR1;19;36230058;36233354;3296;0
6040;ENSG00000126247;CAPNS1;19;36630477;36641255;10778;0
6041;ENSG00000126249;PDCD2L;19;34895289;34917073;21784;0
6042;ENSG00000126254;RBM42;19;36119932;36128588;8656;0
6043;ENSG00000126259;KIRREL2;19;36346763;36358011;11248;0
6044;ENSG00000126261;UBA2;19;34919257;34960853;41596;0
6045;ENSG00000126267;COX6B1;19;36139125;36149763;10638;0
6046;ENSG00000126351;THRA;17;38214543;38250120;35577;0
6047;ENSG00000126368;NR1D1;17;38249040;38256978;7938;0
6048;ENSG00000126453;BCL2L12;19;50168823;50177173;8350;0
6049;ENSG00000126456;IRF3;19;50162826;50169132;6306;0
6050;ENSG00000126457;PRMT1;19;50179043;50192286;13243;0
6051;ENSG00000126458;RRAS;19;50138549;50143458;4909;0
6052;ENSG00000126460;PRRG2;19;50083903;50094272;10369;0
6053;ENSG00000126461;SCAF1;19;50145382;50161899;16517;0
6054;ENSG00000126464;PRR12;19;50094900;50129696;34796;0
6055;ENSG00000126561;STAT5A;17;40439565;40463961;24396;0
6056;ENSG00000126581;BECN1;17;40962152;40985367;23215;0
6057;ENSG00000126583;PRKCG;19;54382444;54410906;28462;0
6058;ENSG00000126602;TRAP1;16;3701640;3767598;65958;0
6059;ENSG00000126603;GLIS2;16;4364762;4389598;24836;0
6060;ENSG00000126653;NSRP1;17;28442539;28513493;70954;0
6061;ENSG00000126773;PCNXL4;14;60558629;60635851;77222;0
6062;ENSG00000126775;ATG14;14;55833110;55878576;45466;0
6063;ENSG00000126777;KTN1;14;56025790;56168244;142454;0
6064;ENSG00000126785;RHOJ;14;63670832;63759937;89105;0
6065;ENSG00000126787;DLGAP5;14;55614830;55658396;43566;0
6066;ENSG00000126790;L3HYPDH;14;59927081;59951148;24067;0
6067;ENSG00000126803;HSPA2;14;65002623;65009955;7332;0
6068;ENSG00000126804;ZBTB1;14;64970430;65000408;29978;0
6069;ENSG00000126814;TRMT5;14;61438169;61448076;9907;0
6070;ENSG00000126821;SGPP1;14;64150932;64194757;43825;0
6071;ENSG00000126822;PLEKHG3;14;65170820;65213610;42790;0
6072;ENSG00000126858;RHOT1;17;30469473;30580393;110920;0
6073;ENSG00000126861;OMG;17;29599031;29624557;25526;0
6074;ENSG00000126934;MAP2K2;19;4090319;4124126;33807;0
6075;ENSG00000127152;BCL11B;14;99635624;99737861;102237;0
6076;ENSG00000127220;ABHD8;19;17402940;17421045;18105;0
6077;ENSG00000127445;PIN1;19;9945933;9960358;14425;0
6078;ENSG00000127452;FBXL12;19;9920943;9938492;17549;0
6079;ENSG00000127511;SIN3B;19;16940211;16991164;50953;0
6080;ENSG00000127526;SLC35E1;19;16660642;16683193;22551;0
6081;ENSG00000127527;EPS15L1;19;16466050;16582896;116846;0
6082;ENSG00000127528;KLF2;19;16435628;16438685;3057;0
6083;ENSG00000127540;UQCR11;19;1597171;1605480;8309;0
6084;ENSG00000127554;GFER;16;2034208;2037750;3542;0
6085;ENSG00000127561;SYNGR3;16;2039661;2044276;4615;0
6086;ENSG00000127564;PKMYT1;16;3018025;3030540;12515;0
6087;ENSG00000127578;WFIKKN1;16;679239;684116;4877;0
6088;ENSG00000127580;WDR24;16;734622;740444;5822;0
6089;ENSG00000127585;FBXL16;16;742500;755829;13329;0
6090;ENSG00000127586;CHTF18;16;838046;850737;12691;0
6091;ENSG00000127616;SMARCA4;19;11071598;11176071;104473;0
6092;ENSG00000127663;KDM4B;19;4969125;5153606;184481;0
6093;ENSG00000127666;TICAM1;19;4815944;4831716;15772;0
6094;ENSG00000127774;EMC6;17;3572109;3572962;853;0
6095;ENSG00000127804;METTL16;17;2308856;2415185;106329;0
6096;ENSG00000128000;ZNF780B;19;40534167;40562116;27949;0
6097;ENSG00000128011;LRFN1;19;39797208;39805976;8768;0
6098;ENSG00000128016;ZFP36;19;39897453;39900052;2599;0
6099;ENSG00000128463;EMC4;15;34517200;34522357;5157;0
6100;ENSG00000128482;RNF112;17;19314438;19320589;6151;1
6101;ENSG00000128487;SPECC1;17;19912657;20222339;309682;0
6102;ENSG00000128626;MRPS12;19;39421188;39423802;2614;0
6103;ENSG00000128731;HERC2;15;28356186;28567298;211112;0
6104;ENSG00000128739;SNRPN;15;25068794;25223870;155076;0
6105;ENSG00000128789;PSMG2;18;12658737;12725739;67002;0
6106;ENSG00000128791;TWSG1;18;9334765;9402418;67653;0
6107;ENSG00000128829;EIF2AK4;15;40226347;40327797;101450;0
6108;ENSG00000128833;MYO5C;15;52484519;52587995;103476;0
6109;ENSG00000128849;CGNL1;15;57668165;57842925;174760;0
6110;ENSG00000128872;TMOD2;15;52043758;52108565;64807;0
6111;ENSG00000128881;TTBK2;15;43030932;43213007;182075;0
6112;ENSG00000128891;C15orf57;15;40820882;40857256;36374;0
6113;ENSG00000128908;INO80;15;41271078;41408552;137474;0
6114;ENSG00000128915;NARG2;15;60711808;60771359;59551;0
6115;ENSG00000128917;DLL4;15;41221538;41231237;9699;0
6116;ENSG00000128923;FAM63B;15;59063391;59154099;90708;0
6117;ENSG00000128928;IVD;15;40697686;40728146;30460;0
6118;ENSG00000128944;KNSTRN;15;40674922;40686447;11525;0
6119;ENSG00000128951;DUT;15;48623208;48635570;12362;0
6120;ENSG00000128965;CHAC1;15;41245160;41248710;3550;0
6121;ENSG00000128973;CLN6;15;68499330;68549549;50219;0
6122;ENSG00000128989;ARPP19;15;52839242;52862080;22838;0
6123;ENSG00000129003;VPS13C;15;62144588;62352672;208084;0
6124;ENSG00000129007;CALML4;15;68483043;68498417;15374;1
6125;ENSG00000129028;THAP10;15;71173681;71185124;11443;0
6126;ENSG00000129038;LOXL1;15;74218330;74244478;26148;0
6127;ENSG00000129195;FAM64A;17;6347735;6354789;7054;0
6128;ENSG00000129197;RPAIN;17;5322961;5336196;13235;0
6129;ENSG00000129214;SHBG;17;7517382;7536700;19318;0
6130;ENSG00000129219;PLD2;17;4710391;4726729;16338;0
6131;ENSG00000129235;TXNDC17;17;6544078;6547861;3783;0
6132;ENSG00000129244;ATP1B2;17;7549945;7561086;11141;0
6133;ENSG00000129245;FXR2;17;7494548;7518189;23641;0
6134;ENSG00000129250;KIF1C;17;4901243;4931696;30453;1
6135;ENSG00000129255;MPDU1;17;7486847;7496107;9260;0
6136;ENSG00000129270;MMP28;17;34083268;34122711;39443;0
6137;ENSG00000129282;MRM1;17;34958001;34965407;7406;0
6138;ENSG00000129347;KRI1;19;10663761;10676713;12952;0
6139;ENSG00000129351;ILF3;19;10764937;10803093;38156;0
6140;ENSG00000129353;SLC44A2;19;10713133;10755235;42102;0
6141;ENSG00000129355;CDKN2D;19;10677138;10679735;2597;0
6142;ENSG00000129437;KLK14;19;51580752;51587502;6750;0
6143;ENSG00000129460;NGDN;14;23938897;23979071;40174;0
6144;ENSG00000129472;RAB2B;14;21927179;21945132;17953;0
6145;ENSG00000129473;BCL2L2;14;23767999;23780968;12969;0
6146;ENSG00000129474;AJUBA;14;23440383;23451851;11468;0
6147;ENSG00000129480;DTD2;14;31915242;31926716;11474;0
6148;ENSG00000129484;PARP2;14;20811741;20826064;14323;0
6149;ENSG00000129493;HEATR5A;14;31760994;31889788;128794;0
6150;ENSG00000129515;SNX6;14;35030300;35099389;69089;0
6151;ENSG00000129518;EAPP;14;34985135;35008916;23781;0
6152;ENSG00000129521;EGLN3;14;34393437;34931980;538543;0
6153;ENSG00000129534;MIS18BP1;14;45672393;45722743;50350;0
6154;ENSG00000129535;NRL;14;24549316;24584223;34907;0
6155;ENSG00000129559;NEDD8;14;24686058;24701660;15602;0
6156;ENSG00000129562;DAD1;14;23033805;23058175;24370;0
6157;ENSG00000129566;TEP1;14;20833826;20881588;47762;0
6158;ENSG00000129636;ITFG1;16;47188298;47498060;309762;0
6159;ENSG00000129646;QRICH2;17;74270130;74303761;33631;0
6160;ENSG00000129654;FOXJ1;17;74132414;74137380;4966;0
6161;ENSG00000129657;SEC14L1;17;75082798;75213179;130381;0
6162;ENSG00000129667;RHBDF2;17;74466973;74497872;30899;0
6163;ENSG00000129910;CDH15;16;89238175;89261900;23725;0
6164;ENSG00000129911;KLF16;19;1852399;1863567;11168;0
6165;ENSG00000129925;TMEM8A;16;420773;437113;16340;0
6166;ENSG00000129932;DOHH;19;3490819;3500938;10119;0
6167;ENSG00000129933;MAU2;19;19431490;19469563;38073;0
6168;ENSG00000129946;SHC2;19;416583;460996;44413;0
6169;ENSG00000129951;;19;812518;821967;9449;0
6170;ENSG00000129968;ABHD17A;19;1876809;1885546;8737;0
6171;ENSG00000129993;CBFA2T3;16;88941266;89043612;102346;0
6172;ENSG00000130005;GAMT;19;1397091;1401569;4478;0
6173;ENSG00000130158;DOCK6;19;11309971;11373157;63186;0
6174;ENSG00000130159;ECSIT;19;11616731;11639989;23258;0
6175;ENSG00000130164;LDLR;19;11200038;11244492;44454;0
6176;ENSG00000130165;ELOF1;19;11661962;11670051;8089;0
6177;ENSG00000130175;PRKCSH;19;11546109;11561783;15674;0
6178;ENSG00000130176;CNN1;19;11649532;11661138;11606;1
6179;ENSG00000130177;CDC16;13;115000362;115038198;37836;0
6180;ENSG00000130202;PVRL2;19;45349432;45392485;43053;0
6181;ENSG00000130203;APOE;19;45409011;45412650;3639;0
6182;ENSG00000130204;TOMM40;19;45393826;45406946;13120;0
6183;ENSG00000130244;FAM98C;19;38893775;38899728;5953;0
6184;ENSG00000130254;SAFB2;19;5587010;5624057;37047;0
6185;ENSG00000130255;RPL36;19;5674958;5691887;16929;0
6186;ENSG00000130270;ATP8B3;19;1782074;1812275;30201;0
6187;ENSG00000130287;NCAN;19;19322782;19363042;40260;0
6188;ENSG00000130299;GTPBP3;19;17445729;17453544;7815;0
6189;ENSG00000130304;SLC27A1;19;17579578;17616977;37399;0
6190;ENSG00000130309;COLGALT1;19;17666403;17693971;27568;0
6191;ENSG00000130311;DDA1;19;17420327;17434110;13783;0
6192;ENSG00000130312;MRPL34;19;17403418;17417652;14234;0
6193;ENSG00000130313;PGLS;19;17622438;17632097;9659;0
6194;ENSG00000130332;LSM7;19;2321516;2328619;7103;0
6195;ENSG00000130382;MLLT1;19;6212966;6279959;66993;0
6196;ENSG00000130402;ACTN4;19;39138289;39222223;83934;0
6197;ENSG00000130475;FCHO1;19;17858527;17899377;40850;0
6198;ENSG00000130477;UNC13A;19;17712137;17799401;87264;0
6199;ENSG00000130479;MAP1S;19;17830051;17845325;15274;0
6200;ENSG00000130511;SSBP4;19;18529674;18545372;15698;0
6201;ENSG00000130513;GDF15;19;18485541;18499986;14445;0
6202;ENSG00000130517;PGPEP1;19;18451397;18480760;29363;0
6203;ENSG00000130518;KIAA1683;19;18367908;18385319;17411;0
6204;ENSG00000130520;LSM4;19;18417040;18434084;17044;0
6205;ENSG00000130522;JUND;19;18390563;18392432;1869;0
6206;ENSG00000130528;HRC;19;49654455;49658681;4226;0
6207;ENSG00000130529;TRPM4;19;49660998;49715093;54095;0
6208;ENSG00000130544;ZNF557;19;7069455;7087979;18524;0
6209;ENSG00000130545;CRB3;19;6463788;6467232;3444;0
6210;ENSG00000130612;CYP2G1P;19;41396731;41406413;9682;0
6211;ENSG00000130669;PAK4;19;39616410;39673456;57046;0
6212;ENSG00000130731;C16orf13;16;684429;686358;1929;0
6213;ENSG00000130733;YIPF2;19;11033444;11039357;5913;0
6214;ENSG00000130734;ATG4D;19;10654571;10664094;9523;0
6215;ENSG00000130748;TMEM160;19;47549165;47551888;2723;0
6216;ENSG00000130749;ZC3H4;19;47567444;47617009;49565;0
6217;ENSG00000130751;NPAS1;19;47523077;47549033;25956;0
6218;ENSG00000130755;GMFG;19;39818993;39833012;14019;0
6219;ENSG00000130758;MAP3K10;19;40697651;40721482;23831;0
6220;ENSG00000130803;ZNF317;19;9251056;9274100;23044;0
6221;ENSG00000130810;PPAN;19;10216965;10225414;8449;0
6222;ENSG00000130811;EIF3G;19;10225693;10230596;4903;0
6223;ENSG00000130813;C19orf66;19;10196798;10203928;7130;0
6224;ENSG00000130816;DNMT1;19;10244021;10341962;97941;0
6225;ENSG00000130818;ZNF426;19;9638667;9649303;10636;0
6226;ENSG00000130844;ZNF331;19;54024235;54083523;59288;0
6227;ENSG00000130856;ZNF236;18;74534563;74682683;148120;0
6228;ENSG00000130881;LRP3;19;33668509;33698694;30185;0
6229;ENSG00000130935;NOL11;17;65713949;65740647;26698;0
6230;ENSG00000131094;C1QL1;17;43037061;43045439;8378;0
6231;ENSG00000131095;GFAP;17;42982376;42994305;11929;1
6232;ENSG00000131115;ZNF227;19;44711700;44741421;29721;0
6233;ENSG00000131116;ZNF428;19;44111371;44124026;12655;0
6234;ENSG00000131142;CCL25;19;8117651;8127534;9883;1
6235;ENSG00000131143;COX4I1;16;85832239;85840650;8411;0
6236;ENSG00000131148;EMC8;16;85805364;85833214;27850;0
6237;ENSG00000131149;GSE1;16;85645015;85709810;64795;0
6238;ENSG00000131153;GINS2;16;85709804;85723679;13875;0
6239;ENSG00000131165;CHMP1A;16;89710839;89724253;13414;0
6240;ENSG00000131196;NFATC1;18;77155856;77289325;133469;0
6241;ENSG00000131242;RAB11FIP4;17;29718642;29865236;146594;0
6242;ENSG00000131323;TRAF3;14;103243813;103377837;134024;0
6243;ENSG00000131351;HAUS8;19;17160539;17186435;25896;0
6244;ENSG00000131398;KCNC3;19;50815194;50836772;21578;0
6245;ENSG00000131408;NR1H2;19;50832910;50886239;53329;0
6246;ENSG00000131409;LRRC4B;19;51020149;51071302;51153;0
6247;ENSG00000131462;TUBG1;17;40761694;40767252;5558;0
6248;ENSG00000131467;PSME3;17;40976402;40995774;19372;0
6249;ENSG00000131469;RPL27;17;41150290;41154976;4686;0
6250;ENSG00000131470;PSMC3IP;17;40724333;40729849;5516;0
6251;ENSG00000131471;AOC3;17;41003201;41010147;6946;1
6252;ENSG00000131473;ACLY;17;40023161;40086795;63634;0
6253;ENSG00000131475;VPS25;17;40925454;40931617;6163;0
6254;ENSG00000131477;RAMP2;17;40910465;40915059;4594;0
6255;ENSG00000131480;AOC2;17;40996617;41002724;6107;1
6256;ENSG00000131484;;17;43580626;43612076;31450;0
6257;ENSG00000131650;KREMEN2;16;3013945;3018384;4439;0
6258;ENSG00000131652;THOC6;16;3074028;3077756;3728;0
6259;ENSG00000131653;TRAF7;16;2205699;2228130;22431;0
6260;ENSG00000131747;TOP2A;17;38544768;38574202;29434;1
6261;ENSG00000131748;STARD3;17;37793318;37819737;26419;0
6262;ENSG00000131759;RARA;17;38465444;38513094;47650;0
6263;ENSG00000131771;PPP1R1B;17;37782993;37792879;9886;1
6264;ENSG00000131797;CLUHP3;16;31711911;31721097;9186;0
6265;ENSG00000131871;VIMP;15;101811022;101817705;6683;0
6266;ENSG00000131873;CHSY1;15;101715928;101792137;76209;0
6267;ENSG00000131876;SNRPA1;15;101821715;101835487;13772;0
6268;ENSG00000131899;LLGL1;17;18128901;18148189;19288;0
6269;ENSG00000131941;RHPN2;19;33469499;33555794;86295;0
6270;ENSG00000131943;C19orf12;19;30191721;30206364;14643;0
6271;ENSG00000131944;C19orf40;19;33463115;33469128;6013;0
6272;ENSG00000131951;LRRC9;14;60386431;60530277;143846;0
6273;ENSG00000131966;ACTR10;14;58666798;58701750;34952;0
6274;ENSG00000131979;GCH1;14;55308726;55369570;60844;0
6275;ENSG00000131981;LGALS3;14;55590828;55612126;21298;1
6276;ENSG00000132000;PODNL1;19;14042000;14064204;22204;0
6277;ENSG00000132002;DNAJB1;19;14625582;14640582;15000;0
6278;ENSG00000132003;ZSWIM4;19;13906274;13943044;36770;0
6279;ENSG00000132004;FBXW9;19;12798867;12807457;8590;0
6280;ENSG00000132005;RFX1;19;14072350;14117851;45501;0
6281;ENSG00000132010;ZNF20;19;12203658;12251222;47564;0
6282;ENSG00000132016;C19orf57;19;13993161;14017265;24104;0
6283;ENSG00000132017;DCAF15;19;14063304;14072254;8950;0
6284;ENSG00000132024;CC2D1A;19;14017014;14041692;24678;0
6285;ENSG00000132026;RTBDN;19;12936292;12946242;9950;0
6286;ENSG00000132130;LHX1;17;35294084;35301917;7833;1
6287;ENSG00000132139;GAS2L2;17;34071530;34079897;8367;0
6288;ENSG00000132141;CCT6B;17;33254878;33308097;53219;0
6289;ENSG00000132142;ACACA;17;35441923;35766909;324986;0
6290;ENSG00000132199;ENOSF1;18;670324;712676;42352;0
6291;ENSG00000132205;EMILIN2;18;2847028;2915991;68963;1
6292;ENSG00000132359;RAP1GAP2;17;2680350;2941033;260683;0
6293;ENSG00000132361;CLUH;17;2592680;2615957;23277;0
6294;ENSG00000132376;INPP5K;17;1397865;1420182;22317;0
6295;ENSG00000132382;MYBBP1A;17;4442192;4458926;16734;0
6296;ENSG00000132383;RPA1;17;1732996;1803376;70380;0
6297;ENSG00000132386;SERPINF1;17;1665253;1680868;15615;0
6298;ENSG00000132388;UBE2G1;17;4172554;4269923;97369;0
6299;ENSG00000132470;ITGB4;17;73717408;73753899;36491;1
6300;ENSG00000132471;WBP2;17;73841780;73852588;10808;0
6301;ENSG00000132475;H3F3B;17;73772515;73781974;9459;0
6302;ENSG00000132478;UNK;17;73780681;73821886;41205;0
6303;ENSG00000132481;TRIM47;17;73870242;73874656;4414;0
6304;ENSG00000132507;EIF5A;17;7210318;7215774;5456;0
6305;ENSG00000132510;KDM6B;17;7743222;7758114;14892;0
6306;ENSG00000132522;GPS2;17;7214643;7218883;4240;0
6307;ENSG00000132535;DLG4;17;7093209;7123021;29812;0
6308;ENSG00000132581;SDF2;17;26975374;26989207;13833;0
6309;ENSG00000132589;FLOT2;17;27206353;27224697;18344;0
6310;ENSG00000132591;ERAL1;17;27181956;27188085;6129;0
6311;ENSG00000132600;PRMT7;16;68344877;68392466;47589;0
6312;ENSG00000132603;NIP7;16;69373333;69377014;3681;0
6313;ENSG00000132604;TERF2;16;69389464;69442474;53010;0
6314;ENSG00000132612;VPS4A;16;69345259;69358949;13690;0
6315;ENSG00000132613;MTSS1L;16;70695107;70719969;24862;0
6316;ENSG00000132872;SYT4;18;40847843;40857615;9772;0
6317;ENSG00000132874;SLC14A2;18;42792960;43263072;470112;0
6318;ENSG00000133026;MYH10;17;8377523;8534079;156556;0
6319;ENSG00000133027;PEMT;17;17408877;17495022;86145;0
6320;ENSG00000133028;SCO1;17;10583654;10601692;18038;0
6321;ENSG00000133030;MPRIP;17;16945859;17120993;175134;0
6322;ENSG00000133193;FAM104A;17;71203492;71232892;29400;0
6323;ENSG00000133195;SLC39A11;17;70642088;71088851;446763;0
6324;ENSG00000133243;BTBD2;19;1985447;2034880;49433;0
6325;ENSG00000133246;PRAM1;19;8554940;8567996;13056;0
6326;ENSG00000133250;ZNF414;19;8575462;8579048;3586;0
6327;ENSG00000133275;CSNK1G2;19;1941188;1981337;40149;0
6328;ENSG00000133313;CNDP2;18;72163051;72188366;25315;0
6329;ENSG00000133392;MYH11;16;15797029;15950890;153861;1
6330;ENSG00000133393;FOPNL;16;15959577;15982482;22905;0
6331;ENSG00000133935;C14orf1;14;76116134;76127532;11398;0
6332;ENSG00000133943;C14orf159;14;91526677;91691976;165299;0
6333;ENSG00000133958;UNC79;14;93799565;94174222;374657;0
6334;ENSG00000133961;NUMB;14;73741815;73930348;188533;0
6335;ENSG00000133983;COX16;14;70791798;70826448;34650;0
6336;ENSG00000133985;TTC9;14;71108504;71142077;33573;0
6337;ENSG00000133997;MED6;14;71047974;71067384;19410;0
6338;ENSG00000134001;EIF2S1;14;67826714;67853233;26519;0
6339;ENSG00000134007;ADAM20;14;70989075;71001732;12657;0
6340;ENSG00000134030;CTIF;18;46065417;46389588;324171;0
6341;ENSG00000134042;MRO;18;48324574;48351772;27198;0
6342;ENSG00000134046;MBD2;18;51679079;51751158;72079;0
6343;ENSG00000134049;IER3IP1;18;44681413;44702745;21332;0
6344;ENSG00000134138;MEIS2;15;37181406;37393504;212098;0
6345;ENSG00000134146;DPH6;15;35509546;35838394;328848;0
6346;ENSG00000134152;KATNBL1;15;34432875;34502297;69422;0
6347;ENSG00000134153;EMC7;15;34376218;34394149;17931;0
6348;ENSG00000134265;NAPG;18;10525902;10552758;26856;0
6349;ENSG00000134278;SPIRE1;18;12446511;12658133;211622;0
6350;ENSG00000134419;RPS15A;16;18792617;18801705;9088;0
6351;ENSG00000134440;NARS;18;55267888;55289445;21557;0
6352;ENSG00000134444;KIAA1468;18;59854491;59974355;119864;0
6353;ENSG00000134489;HRH4;18;22040593;22059921;19328;0
6354;ENSG00000134490;TMEM241;18;20777108;21017925;240817;0
6355;ENSG00000134504;KCTD1;18;24034874;24237365;202491;0
6356;ENSG00000134508;CABLES1;18;20714528;20840431;125903;1
6357;ENSG00000134755;DSC2;18;28645940;28682378;36438;0
6358;ENSG00000134758;RNF138;18;29671818;29711524;39706;0
6359;ENSG00000134759;ELP2;18;33709407;33757909;48502;0
6360;ENSG00000134762;DSC3;18;28569974;28622781;52807;0
6361;ENSG00000134769;DTNA;18;32073254;32471808;398554;1
6362;ENSG00000134775;FHOD3;18;33877677;34360018;482341;0
6363;ENSG00000134779;TPGS2;18;34359987;34409158;49171;0
6364;ENSG00000134815;DHX34;19;47852538;47885961;33423;0
6365;ENSG00000134864;GGACT;13;101183810;101241782;57972;0
6366;ENSG00000134871;COL4A2;13;110958159;111165374;207215;0
6367;ENSG00000134874;DZIP1;13;96230457;96296957;66500;0
6368;ENSG00000134882;UBAC2;13;99853028;100038688;185660;0
6369;ENSG00000134884;ARGLU1;13;107194021;107220512;26491;0
6370;ENSG00000134897;BIVM;13;103451399;103493885;42486;0
6371;ENSG00000134899;ERCC5;13;103497194;103528345;31151;0
6372;ENSG00000134900;TPP2;13;103249353;103331521;82168;0
6373;ENSG00000134901;KDELC1;13;103436631;103451357;14726;0
6374;ENSG00000134905;CARS2;13;111293759;111365950;72191;0
6375;ENSG00000135686;KLHL36;16;84682131;84701292;19161;0
6376;ENSG00000135698;MPHOSPH6;16;82181403;82203831;22428;0
6377;ENSG00000135702;CHST5;16;75562433;75569145;6712;0
6378;ENSG00000135709;KIAA0513;16;85061375;85127836;66461;0
6379;ENSG00000135720;DYNC1LI2;16;66754796;66785701;30905;0
6380;ENSG00000135723;FHOD1;16;67263290;67281561;18271;0
6381;ENSG00000135736;CCDC102A;16;57546090;57570511;24421;0
6382;ENSG00000135740;SLC9A5;16;67271586;67306093;34507;0
6383;ENSG00000136111;TBC1D4;13;75858808;76056250;197442;0
6384;ENSG00000136122;BORA;13;73302061;73330336;28275;0
6385;ENSG00000136149;RPL13AP25;13;55014839;55015450;611;0
6386;ENSG00000136153;LMO7;13;76194570;76434004;239434;0
6387;ENSG00000136155;SCEL;13;78109809;78219398;109589;1
6388;ENSG00000136158;SPRY2;13;80910111;80915086;4975;0
6389;ENSG00000136160;EDNRB;13;78469616;78493903;24287;0
6390;ENSG00000136319;TTC5;14;20724717;20774153;49436;0
6391;ENSG00000136367;ZFHX2;14;23990066;24025401;35335;0
6392;ENSG00000136371;MTHFS;15;80125927;80189721;63794;0
6393;ENSG00000136378;ADAMTS7;15;79051545;79103773;52228;0
6394;ENSG00000136379;ABHD17C;15;80972025;81047962;75937;0
6395;ENSG00000136381;IREB2;15;78729773;78793798;64025;0
6396;ENSG00000136383;ALPK3;15;85359911;85416713;56802;1
6397;ENSG00000136425;CIB2;15;78396948;78423886;26938;0
6398;ENSG00000136436;CALCOCO2;17;46908350;46943884;35534;0
6399;ENSG00000136444;RSAD1;17;48556161;48563336;7175;0
6400;ENSG00000136448;NMT1;17;43128978;43186384;57406;0
6401;ENSG00000136450;SRSF1;17;56080721;56084707;3986;0
6402;ENSG00000136451;VEZF1;17;56048910;56065620;16710;0
6403;ENSG00000136463;TACO1;17;61678231;61685725;7494;0
6404;ENSG00000136478;TEX2;17;62224587;62340661;116074;0
6405;ENSG00000136485;DCAF7;17;61627822;61671639;43817;0
6406;ENSG00000136490;LIMD2;17;61773262;61778532;5270;0
6407;ENSG00000136492;BRIP1;17;59758627;59940882;182255;0
6408;ENSG00000136504;KAT7;17;47865917;47906458;40541;0
6409;ENSG00000137764;MAP2K5;15;67835047;68099461;264414;0
6410;ENSG00000137766;UNC13C;15;54305101;54920806;615705;0
6411;ENSG00000137767;SQRDL;15;45923346;45983492;60146;0
6412;ENSG00000137770;CTDSPL2;15;44719432;44821236;101804;0
6413;ENSG00000137776;SLTM;15;59171244;59225852;54608;0
6414;ENSG00000137801;THBS1;15;39873280;39891667;18387;0
6415;ENSG00000137802;MAPKBP1;15;42066632;42120053;53421;0
6416;ENSG00000137804;NUSAP1;15;41624892;41673248;48356;1
6417;ENSG00000137806;NDUFAF1;15;41679551;41694717;15166;0
6418;ENSG00000137807;KIF23;15;69706585;69740764;34179;1
6419;ENSG00000137812;CASC5;15;40886218;40956540;70322;0
6420;ENSG00000137814;HAUS2;15;42841008;42862192;21184;0
6421;ENSG00000137815;RTF1;15;41700606;41775761;75155;0
6422;ENSG00000137817;PARP6;15;72533522;72565340;31818;0
6423;ENSG00000137818;RPLP1;15;69745123;69748255;3132;0
6424;ENSG00000137821;LRRC49;15;71145578;71342414;196836;0
6425;ENSG00000137822;TUBGCP4;15;43661419;43699293;37874;0
6426;ENSG00000137824;RMDN3;15;41028082;41048049;19967;0
6427;ENSG00000137825;ITPKA;15;41785591;41795747;10156;0
6428;ENSG00000137831;UACA;15;70946893;71055932;109039;0
6429;ENSG00000137834;SMAD6;15;66994566;67074338;79772;0
6430;ENSG00000137841;PLCB2;15;40570377;40600136;29759;0
6431;ENSG00000137842;TMEM62;15;43415477;43477344;61867;0
6432;ENSG00000137843;PAK6;15;40509629;40569688;60059;0
6433;ENSG00000137845;ADAM10;15;58887403;59042177;154774;0
6434;ENSG00000137868;STRA6;15;74471807;74504608;32801;1
6435;ENSG00000137869;CYP19A1;15;51500254;51630807;130553;1
6436;ENSG00000137871;ZNF280D;15;56922379;57210769;288390;0
6437;ENSG00000137872;SEMA6D;15;47476298;48066420;590122;0
6438;ENSG00000137875;BCL2L10;15;52401460;52404972;3512;0
6439;ENSG00000137876;RSL24D1;15;55473004;55489265;16261;0
6440;ENSG00000137877;SPTBN5;15;42140345;42186275;45930;0
6441;ENSG00000137878;GCOM1;15;57884106;58006943;122837;0
6442;ENSG00000137880;GCHFR;15;41056218;41059906;3688;0
6443;ENSG00000138587;MNS1;15;56713742;56757335;43593;0
6444;ENSG00000138592;USP8;15;50716577;50793280;76703;0
6445;ENSG00000138593;SECISBP2L;15;49280673;49338760;58087;0
6446;ENSG00000138594;TMOD3;15;52121825;52239492;117667;0
6447;ENSG00000138600;SPPL2A;15;50999506;51058005;58499;0
6448;ENSG00000138604;GLCE;15;69452923;69564556;111633;0
6449;ENSG00000138606;SHF;15;45459412;45493373;33961;0
6450;ENSG00000138613;APH1B;15;63568217;63601325;33108;0
6451;ENSG00000138614;VWA9;15;65871091;65903627;32536;0
6452;ENSG00000138615;CILP;15;65488337;65503826;15489;0
6453;ENSG00000138617;PARP16;15;65526798;65592956;66158;0
6454;ENSG00000138621;PPCDC;15;75315896;75409803;93907;0
6455;ENSG00000138622;HCN4;15;73612200;73661605;49405;0
6456;ENSG00000138623;SEMA7A;15;74701630;74726808;25178;0
6457;ENSG00000138629;UBL7;15;74738318;74753523;15205;0
6458;ENSG00000138834;MAPK8IP3;16;1756184;1820318;64134;0
6459;ENSG00000139734;DIAPH3;13;60239717;60738121;498404;1
6460;ENSG00000139737;SLAIN1;13;78272023;78338377;66354;0
6461;ENSG00000139746;RBM26;13;79885962;79980612;94650;0
6462;ENSG00000139793;MBNL2;13;97873688;98046374;172686;0
6463;ENSG00000139800;ZIC5;13;100615218;100624163;8945;0
6464;ENSG00000139826;ABHD13;13;108870727;108886603;15876;0
6465;ENSG00000139832;RAB20;13;111175417;111214080;38663;0
6466;ENSG00000139835;GRTP1;13;113978505;114018446;39941;0
6467;ENSG00000139842;CUL4A;13;113862552;113919399;56847;0
6468;ENSG00000139874;SSTR1;14;38677204;38682272;5068;0
6469;ENSG00000139880;CDH24;14;23516271;23526747;10476;0
6470;ENSG00000139890;REM2;14;23352374;23356895;4521;0
6471;ENSG00000139899;CBLN3;14;24895738;24900160;4422;0
6472;ENSG00000139910;NOVA1;14;26912299;27066960;154661;0
6473;ENSG00000139915;MDGA2;14;47308826;48144157;835331;0
6474;ENSG00000139921;TMX1;14;51706880;51722759;15879;0
6475;ENSG00000139926;FRMD6;14;51955818;52197445;241627;0
6476;ENSG00000139946;PELI2;14;56584532;56768244;183712;0
6477;ENSG00000139970;RTN1;14;60062694;60337684;274990;0
6478;ENSG00000139971;C14orf37;14;58466453;58764857;298404;0
6479;ENSG00000139973;SYT16;14;62453803;62568431;114628;0
6480;ENSG00000139974;SLC38A6;14;61447832;61550451;102619;0
6481;ENSG00000139977;NAA30;14;57857262;57882635;25373;0
6482;ENSG00000139985;ADAM21;14;70918874;70926622;7748;0
6483;ENSG00000139988;RDH12;14;68168603;68201169;32566;0
6484;ENSG00000139990;DCAF5;14;69517598;69619867;102269;0
6485;ENSG00000139998;RAB15;14;65412532;65439494;26962;0
6486;ENSG00000140006;WDR89;14;64063757;64108579;44822;0
6487;ENSG00000140009;ESR2;14;64550950;64804830;253880;1
6488;ENSG00000140015;KCNH5;14;63173287;63568755;395468;0
6489;ENSG00000140022;STON2;14;81727000;81902809;175809;0
6490;ENSG00000140025;EFCAB11;14;90261013;90421121;160108;0
6491;ENSG00000140043;PTGR2;14;74318547;74353530;34983;0
6492;ENSG00000140044;JDP2;14;75894419;75940814;46395;0
6493;ENSG00000140057;AK7;14;96858448;96955764;97316;0
6494;ENSG00000140067;FAM181A;14;94385240;94395954;10714;0
6495;ENSG00000140090;SLC24A4;14;92788925;92962596;173671;1
6496;ENSG00000140092;FBLN5;14;92335756;92414331;78575;0
6497;ENSG00000140104;C14orf79;14;105452112;105476819;24707;0
6498;ENSG00000140105;WARS;14;100800125;100843142;43017;0
6499;ENSG00000140153;WDR20;14;102605840;102691184;85344;0
6500;ENSG00000140157;NIPA2;15;23004684;23034427;29743;0
6501;ENSG00000140181;HERC2P2;15;23282281;23378228;95947;0
6502;ENSG00000140199;SLC12A6;15;34525460;34630261;104801;0
6503;ENSG00000140259;MFAP1;15;44096690;44117000;20310;0
6504;ENSG00000140262;TCF12;15;57210821;57591479;380658;0
6505;ENSG00000140263;SORD;15;45315302;45369383;54081;0
6506;ENSG00000140264;SERF2;15;44069285;44094787;25502;0
6507;ENSG00000140265;ZSCAN29;15;43650370;43663223;12853;0
6508;ENSG00000140279;DUOX2;15;45384848;45406542;21694;0
6509;ENSG00000140280;LYSMD2;15;52015208;52043782;28574;0
6510;ENSG00000140284;SLC27A2;15;50474393;50528592;54199;0
6511;ENSG00000140285;FGF7;15;49715293;49780972;65679;0
6512;ENSG00000140297;GCNT3;15;59887074;59932438;45364;0
6513;ENSG00000140299;BNIP2;15;59951345;59981733;30388;0
6514;ENSG00000140307;GTF2A2;15;59930261;59949740;19479;0
6515;ENSG00000140319;SRP14;15;40327940;40331389;3449;0
6516;ENSG00000140320;BAHD1;15;40731920;40760441;28521;0
6517;ENSG00000140323;DISP2;15;40650436;40663257;12821;0
6518;ENSG00000140326;CDAN1;15;43015757;43029324;13567;0
6519;ENSG00000140332;TLE3;15;70340129;70390515;50386;0
6520;ENSG00000140350;ANP32A;15;69070874;69113236;42362;0
6521;ENSG00000140365;COMMD4;15;75628232;75634268;6036;0
6522;ENSG00000140367;UBE2Q2;15;76135622;76193419;57797;0
6523;ENSG00000140374;ETFA;15;76507696;76603813;96117;0
6524;ENSG00000140382;HMG20A;15;77712754;77777949;65195;0
6525;ENSG00000140386;SCAPER;15;76640526;77197785;557259;0
6526;ENSG00000140391;TSPAN3;15;77336359;77376326;39967;0
6527;ENSG00000140395;WDR61;15;78570177;78592136;21959;0
6528;ENSG00000140398;NEIL1;15;75639296;75647592;8296;0
6529;ENSG00000140400;MAN2C1;15;75648133;75660971;12838;0
6530;ENSG00000140406;MESDC1;15;81293295;81296342;3047;0
6531;ENSG00000140416;TPM1;15;63334831;63364114;29283;0
6532;ENSG00000140443;IGF1R;15;99192200;99507759;315559;0
6533;ENSG00000140450;ARRDC4;15;98462784;98517068;54284;0
6534;ENSG00000140451;PIF1;15;65107831;65117867;10036;0
6535;ENSG00000140455;USP3;15;63796793;63886839;90046;0
6536;ENSG00000140463;BBS4;15;72978527;73030817;52290;0
6537;ENSG00000140464;PML;15;74287014;74340153;53139;0
6538;ENSG00000140465;CYP1A1;15;75011883;75017951;6068;0
6539;ENSG00000140471;LINS;15;101099574;101143435;43861;0
6540;ENSG00000140474;ULK3;15;75128457;75135687;7230;0
6541;ENSG00000140479;PCSK6;15;101840818;102065405;224587;0
6542;ENSG00000140488;CELF6;15;72577068;72612470;35402;0
6543;ENSG00000140497;SCAMP2;15;75136071;75165706;29635;0
6544;ENSG00000140521;POLG;15;89859534;89878092;18558;0
6545;ENSG00000140522;RLBP1;15;89753100;89764982;11882;0
6546;ENSG00000140525;FANCI;15;89787180;89860492;73312;0
6547;ENSG00000140526;ABHD2;15;89630690;89745591;114901;0
6548;ENSG00000140527;WDR93;15;90234028;90286869;52841;0
6549;ENSG00000140534;TICRR;15;90118713;90174287;55574;1
6550;ENSG00000140538;NTRK3;15;88418230;88799999;381769;0
6551;ENSG00000140543;DET1;15;89054790;89089906;35116;0
6552;ENSG00000140545;MFGE8;15;89441916;89456642;14726;0
6553;ENSG00000140548;ZNF710;15;90544624;90625438;80814;0
6554;ENSG00000140553;UNC45A;15;91473410;91497323;23913;0
6555;ENSG00000140557;ST8SIA2;15;92937058;93011958;74900;0
6556;ENSG00000140563;MCTP2;15;94774767;95023632;248865;0
6557;ENSG00000140564;FURIN;15;91411822;91426688;14866;0
6558;ENSG00000140575;IQGAP1;15;90931450;91045475;114025;1
6559;ENSG00000140577;CRTC3;15;91073157;91188577;115420;0
6560;ENSG00000140598;EFTUD1;15;82422571;82555104;132533;0
6561;ENSG00000140600;SH3GL3;15;84115980;84287495;171515;0
6562;ENSG00000140612;SEC11A;15;85212775;85259947;47172;0
6563;ENSG00000140623;12-Sep;16;4827670;4838522;10852;0
6564;ENSG00000140632;GLYR1;16;4853204;4897343;44139;0
6565;ENSG00000140650;PMM2;16;8882680;8943188;60508;0
6566;ENSG00000140675;SLC5A2;16;31494323;31502181;7858;0
6567;ENSG00000140682;TGFB1I1;16;31482906;31489281;6375;0
6568;ENSG00000140688;C16orf58;16;31500792;31520630;19838;0
6569;ENSG00000140691;ARMC5;16;31469401;31478487;9086;0
6570;ENSG00000140694;PARN;16;14529558;14726585;197027;0
6571;ENSG00000140718;FTO;16;53737875;54155853;417978;0
6572;ENSG00000140740;UQCRC2;16;21963981;21994981;31000;0
6573;ENSG00000140743;CDR2;16;22357257;22448486;91229;0
6574;ENSG00000140750;ARHGAP17;16;24930706;25026987;96281;0
6575;ENSG00000140795;MYLK3;16;46740891;46824319;83428;0
6576;ENSG00000140807;NKD1;16;50582241;50670647;88406;0
6577;ENSG00000140829;DHX38;16;72127461;72146811;19350;0
6578;ENSG00000140830;TXNL4B;16;72078188;72128330;50142;0
6579;ENSG00000140836;ZFHX3;16;72816784;73093597;276813;0
6580;ENSG00000140839;CLEC18B;16;74442529;74455368;12839;0
6581;ENSG00000140848;CPNE2;16;57126449;57181878;55429;0
6582;ENSG00000140853;NLRC5;16;57023397;57117443;94046;0
6583;ENSG00000140854;KATNB1;16;57769642;57791162;21520;0
6584;ENSG00000140859;KIFC3;16;57792129;57896957;104828;0
6585;ENSG00000140873;ADAMTS18;16;77281710;77469011;187301;1
6586;ENSG00000140876;NUDT7;16;77756411;77776157;19746;0
6587;ENSG00000140905;GCSH;16;81115566;81130008;14442;0
6588;ENSG00000140931;CMTM3;16;66637777;66647795;10018;0
6589;ENSG00000140937;CDH11;16;64977656;65160015;182359;0
6590;ENSG00000140939;NOL3;16;67204057;67209643;5586;0
6591;ENSG00000140941;MAP1LC3B;16;87417601;87438385;20784;0
6592;ENSG00000140943;MBTPS1;16;84087368;84150511;63143;0
6593;ENSG00000140945;CDH13;16;82660408;83830204;1169796;1
6594;ENSG00000140948;ZCCHC14;16;87439852;87525651;85799;0
6595;ENSG00000140950;TLDC1;16;84511681;84587639;75958;0
6596;ENSG00000140961;OSGIN1;16;83981887;83999937;18050;0
6597;ENSG00000140983;RHOT2;16;718086;724174;6088;0
6598;ENSG00000140987;ZSCAN32;16;3432085;3451065;18980;0
6599;ENSG00000140988;RPS2;16;2012053;2014861;2808;0
6600;ENSG00000140990;NDUFB10;16;2009509;2011976;2467;0
6601;ENSG00000140992;PDPK1;16;2587965;2653189;65224;0
6602;ENSG00000140993;TIGD7;16;3348832;3355729;6897;0
6603;ENSG00000140995;DEF8;16;90014333;90034468;20135;0
6604;ENSG00000141002;TCF25;16;89940000;89977792;37792;0
6605;ENSG00000141012;GALNS;16;88880142;88923378;43236;0
6606;ENSG00000141013;GAS8;16;90086037;90111383;25346;0
6607;ENSG00000141026;MED9;17;17380300;17396540;16240;0
6608;ENSG00000141027;NCOR1;17;15932471;16121499;189028;0
6609;ENSG00000141030;COPS3;17;17150141;17184607;34466;0
6610;ENSG00000141034;GID4;17;17942606;17971718;29112;0
6611;ENSG00000141040;ZNF287;17;16454701;16472520;17819;0
6612;ENSG00000141052;MYOCD;17;12569207;12672266;103059;0
6613;ENSG00000141068;KSR1;17;25783670;25953461;169791;0
6614;ENSG00000141076;CIRH1A;16;69165194;69265033;99839;0
6615;ENSG00000141084;RANBP10;16;67757005;67840555;83550;0
6616;ENSG00000141098;GFOD2;16;67708434;67753324;44890;0
6617;ENSG00000141101;NOB1;16;69775770;69788843;13073;0
6618;ENSG00000141127;PRPSAP2;17;18743398;18834581;91183;0
6619;ENSG00000141140;MYO19;17;34851477;34899284;47807;0
6620;ENSG00000141141;DDX52;17;35969787;36003493;33706;0
6621;ENSG00000141150;RASL10B;17;34058668;34070540;11872;0
6622;ENSG00000141179;PCTP;17;53828340;53920191;91851;0
6623;ENSG00000141198;TOM1L1;17;52976748;53039310;62562;0
6624;ENSG00000141219;C17orf80;17;71228372;71245091;16719;0
6625;ENSG00000141232;TOB1;17;48939584;48945339;5755;0
6626;ENSG00000141252;VPS53;17;411908;624957;213049;0
6627;ENSG00000141258;SGSM2;17;2240792;2284352;43560;0
6628;ENSG00000141279;NPEPPS;17;45600308;45700642;100334;0
6629;ENSG00000141294;LRRC46;17;45908993;45915079;6086;0
6630;ENSG00000141295;SCRN2;17;45915058;45918699;3641;0
6631;ENSG00000141298;SSH2;17;27952956;28257294;304338;0
6632;ENSG00000141314;RHBDL3;17;30593195;30651680;58485;0
6633;ENSG00000141337;ARSG;17;66255323;66418872;163549;0
6634;ENSG00000141338;ABCA8;17;66863433;66951533;88100;0
6635;ENSG00000141349;G6PC3;17;42148103;42153709;5606;0
6636;ENSG00000141367;CLTC;17;57697219;57773671;76452;0
6637;ENSG00000141376;BCAS3;17;58754814;59470199;715385;0
6638;ENSG00000141378;PTRH2;17;57751997;57784987;32990;0
6639;ENSG00000141380;SS18;18;23596578;23671181;74603;0
6640;ENSG00000141384;TAF4B;18;23805900;23971649;165749;1
6641;ENSG00000141385;AFG3L2;18;12328943;12377313;48370;0
6642;ENSG00000141391;SLMO1;18;12407895;12432237;24342;0
6643;ENSG00000141401;IMPA2;18;11981024;12030876;49852;0
6644;ENSG00000141404;GNAL;18;11688955;11885684;196729;0
6645;ENSG00000141424;SLC39A6;18;33688495;33709348;20853;0
6646;ENSG00000141425;RPRD1A;18;33564350;33647539;83189;0
6647;ENSG00000141428;C18orf21;18;33552046;33559241;7195;0
6648;ENSG00000141429;GALNT1;18;33161081;33291798;130717;0
6649;ENSG00000141431;ASXL3;18;31158579;31331156;172577;0
6650;ENSG00000141433;ADCYAP1;18;904944;912173;7229;0
6651;ENSG00000141441;GAREM;18;29704840;30050447;345607;0
6652;ENSG00000141446;ESCO1;18;19109242;19180845;71603;0
6653;ENSG00000141447;OSBPL1A;18;21742008;21977844;235836;0
6654;ENSG00000141449;GREB1L;18;18822203;19105378;283175;0
6655;ENSG00000141452;C18orf8;18;21083473;21111746;28273;0
6656;ENSG00000141456;PELP1;17;4574679;4607632;32953;0
6657;ENSG00000141458;NPC1;18;21086148;21166862;80714;0
6658;ENSG00000141480;ARRB2;17;4613784;4624794;11010;0
6659;ENSG00000141485;SLC13A5;17;6588032;6616886;28854;0
6660;ENSG00000141499;WRAP53;17;7589389;7606820;17431;0
6661;ENSG00000141503;MINK1;17;4736683;4801356;64673;0
6662;ENSG00000141504;SAT2;17;7529552;7531194;1642;0
6663;ENSG00000141505;ASGR1;17;7076750;7082883;6133;0
6664;ENSG00000141510;TP53;17;7565097;7590856;25759;0
6665;ENSG00000141519;CCDC40;17;78010435;78074412;63977;0
6666;ENSG00000141522;ARHGDIA;17;79825597;79829282;3685;0
6667;ENSG00000141524;TMC6;17;76106539;76128488;21949;0
6668;ENSG00000141527;CARD14;17;78143791;78183130;39339;0
6669;ENSG00000141540;TTYH2;17;72209653;72258155;48502;0
6670;ENSG00000141542;RAB40B;17;80612849;80656604;43755;0
6671;ENSG00000141543;EIF4A3;17;78109013;78120982;11969;0
6672;ENSG00000141551;CSNK1D;17;80196899;80231607;34708;0
6673;ENSG00000141552;ANAPC11;17;79848666;79858867;10201;0
6674;ENSG00000141556;TBCD;17;80709940;80900724;190784;0
6675;ENSG00000141560;FN3KRP;17;80674559;80688204;13645;0
6676;ENSG00000141562;NARF;17;80416056;80448413;32357;0
6677;ENSG00000141564;RPTOR;17;78518619;78940171;421552;0
6678;ENSG00000141568;FOXK2;17;80477589;80602538;124949;0
6679;ENSG00000141569;TRIM65;17;73876416;73893084;16668;0
6680;ENSG00000141570;CBX8;17;77765931;77775482;9551;0
6681;ENSG00000141576;RNF157;17;74138534;74236454;97920;0
6682;ENSG00000141577;AZI1;17;79163393;79196799;33406;0
6683;ENSG00000141580;WDR45B;17;80572438;80606429;33991;0
6684;ENSG00000141582;CBX4;17;77806955;77813228;6273;0
6685;ENSG00000141622;RNF165;18;43906772;44043103;136331;0
6686;ENSG00000141627;DYM;18;46570039;46987717;417678;0
6687;ENSG00000141639;MAPK4;18;48086448;48258194;171746;0
6688;ENSG00000141642;ELAC1;18;48494361;48514491;20130;0
6689;ENSG00000141644;MBD1;18;47793252;47808144;14892;0
6690;ENSG00000141646;SMAD4;18;48494410;48611415;117005;0
6691;ENSG00000141655;TNFRSF11A;18;59992520;60058516;65996;0
6692;ENSG00000141664;ZCCHC2;18;60190240;60254942;64702;0
6693;ENSG00000141665;FBXO15;18;71740588;71815100;74512;0
6694;ENSG00000141668;CBLN2;18;70203915;70305756;101841;1
6695;ENSG00000141682;PMAIP1;18;57567180;57571538;4358;0
6696;ENSG00000141696;LEPREL4;17;39958199;39968856;10657;0
6697;ENSG00000141698;NT5C3B;17;39981335;39992523;11188;0
6698;ENSG00000141699;FAM134C;17;40731531;40762641;31110;0
6699;ENSG00000141720;PIP4K2B;17;36921942;36956379;34437;0
6700;ENSG00000141736;ERBB2;17;37844167;37886679;42512;0
6701;ENSG00000141741;MIEN1;17;37884749;37887040;2291;0
6702;ENSG00000141750;STAC2;17;37366789;37382125;15336;0
6703;ENSG00000141753;IGFBP4;17;38599702;38613983;14281;0
6704;ENSG00000141756;FKBP10;17;39968932;39979465;10533;1
6705;ENSG00000141759;TXNL4A;18;77732867;77793949;61082;0
6706;ENSG00000141837;CACNA1A;19;13317256;13734804;417548;1
6707;ENSG00000141854;;19;14183348;14185874;2526;0
6708;ENSG00000141858;SAMD1;19;14198652;14201848;3196;0
6709;ENSG00000141867;BRD4;19;15347647;15443356;95709;0
6710;ENSG00000141873;SLC39A3;19;2732202;2740150;7948;0
6711;ENSG00000141905;NFIC;19;3359561;3469215;109654;0
6712;ENSG00000141933;TPGS1;19;507299;519654;12355;0
6713;ENSG00000141934;PPAP2C;19;281040;291393;10353;0
6714;ENSG00000141965;FEM1A;19;4791728;4795571;3843;0
6715;ENSG00000141968;VAV1;19;6772725;6857377;84652;1
6716;ENSG00000141971;MVB12A;19;17516531;17544533;28002;0
6717;ENSG00000141985;SH3GL1;19;4360367;4400544;40177;0
6718;ENSG00000141994;DUS3L;19;5784843;5791249;6406;0
6719;ENSG00000142002;DPP9;19;4675236;4724685;49449;0
6720;ENSG00000142039;CCDC97;19;41816094;41830788;14694;0
6721;ENSG00000142046;TMEM91;19;41856816;41889988;33172;1
6722;ENSG00000142065;ZFP14;19;36827162;36870101;42939;0
6723;ENSG00000142208;AKT1;14;105235686;105262088;26402;0
6724;ENSG00000142227;EMP3;19;48824766;48833810;9044;1
6725;ENSG00000142230;SAE1;19;47616531;47713886;97355;0
6726;ENSG00000142233;NTN5;19;49164664;49176338;11674;0
6727;ENSG00000142235;LMTK3;19;48988528;49016446;27918;0
6728;ENSG00000142252;GEMIN7;19;45582453;45594782;12329;0
6729;ENSG00000142279;WTIP;19;34971874;34997258;25384;0
6730;ENSG00000142303;ADAMTS10;19;8645126;8675620;30494;0
6731;ENSG00000142444;C19orf52;19;11039409;11044211;4802;0
6732;ENSG00000142449;FBN3;19;8130286;8214730;84444;0
6733;ENSG00000142453;CARM1;19;10982189;11033453;51264;0
6734;ENSG00000142459;EVI5L;19;7895119;7929862;34743;0
6735;ENSG00000142494;SLC47A1;17;19398698;19482347;83649;0
6736;ENSG00000142507;PSMB6;17;4699439;4701790;2351;0
6737;ENSG00000142528;ZNF473;19;50528971;50556671;27700;0
6738;ENSG00000142530;FAM71E1;19;50970042;50980010;9968;0
6739;ENSG00000142534;RPS11;19;49999622;50002946;3324;0
6740;ENSG00000142541;RPL13A;19;49990811;49995565;4754;0
6741;ENSG00000142544;CTU1;19;51600863;51611627;10764;0
6742;ENSG00000142546;NOSIP;19;50058968;50093519;34551;0
6743;ENSG00000142549;IGLON5;19;51815102;51833608;18506;0
6744;ENSG00000142552;RCN3;19;50030875;50050219;19344;0
6745;ENSG00000142556;ZNF614;19;52516018;52533493;17475;0
6746;ENSG00000146872;TLK2;17;60536019;60692842;156823;0
6747;ENSG00000149922;TBX6;16;30097114;30103208;6094;0
6748;ENSG00000149923;PPP4C;16;30087299;30096698;9399;0
6749;ENSG00000149925;ALDOA;16;30064411;30081778;17367;0
6750;ENSG00000149926;FAM57B;16;30035748;30064299;28551;0
6751;ENSG00000149927;DOC2A;16;30016830;30034591;17761;0
6752;ENSG00000149929;HIRIP3;16;30003645;30007757;4112;0
6753;ENSG00000149930;TAOK2;16;29984962;30003582;18620;0
6754;ENSG00000149932;TMEM219;16;29952206;29984373;32167;0
6755;ENSG00000150281;CTF1;16;30907928;30914881;6953;0
6756;ENSG00000150361;KLHL1;13;70274726;70682591;407865;0
6757;ENSG00000150394;CDH8;16;61681146;62070939;389793;0
6758;ENSG00000150401;DCUN1D2;13;114110134;114145267;35133;0
6759;ENSG00000150403;TMCO3;13;114145310;114204542;59232;0
6760;ENSG00000150477;KIAA1328;18;34409069;34812135;403066;0
6761;ENSG00000150527;CTAGE5;14;39734488;39856156;121668;0
6762;ENSG00000150636;CCDC102B;18;66382446;66722426;339980;0
6763;ENSG00000150637;CD226;18;67498394;67629039;130645;0
6764;ENSG00000150656;CNDP1;18;72201675;72254448;52773;0
6765;ENSG00000150667;FSIP1;15;39892232;40075031;182799;0
6766;ENSG00000151006;PRSS53;16;31094746;31100949;6203;0
6767;ENSG00000151287;TEX30;13;103418340;103426161;7821;0
6768;ENSG00000151320;AKAP6;14;32798479;33300567;502088;0
6769;ENSG00000151322;NPAS3;14;33404139;34273382;869243;0
6770;ENSG00000151327;FAM177A1;14;35514113;35582336;68223;0
6771;ENSG00000151332;MBIP;14;36767770;36789882;22112;0
6772;ENSG00000151338;MIPOL1;14;37667118;38021566;354448;0
6773;ENSG00000151413;NUBPL;14;31959162;32330430;371268;0
6774;ENSG00000151445;VIPAS39;14;77893018;77924295;31277;0
6775;ENSG00000151575;TEX9;15;56536207;56738195;201988;0
6776;ENSG00000151748;SAV1;14;51098776;51135049;36273;0
6777;ENSG00000151812;SLC35F4;14;58030640;58448912;418272;1
6778;ENSG00000151838;CCDC175;14;59971257;60043549;72292;0
6779;ENSG00000152192;POU4F1;13;79172497;79177673;5176;0
6780;ENSG00000152193;RNF219;13;79188426;79233314;44888;0
6781;ENSG00000152214;RIT2;18;40323192;40695657;372465;1
6782;ENSG00000152217;SETBP1;18;42260138;42648475;388337;0
6783;ENSG00000152223;EPG5;18;43427574;43547240;119666;0
6784;ENSG00000152229;PSTPIP2;18;43563502;43652238;88736;0
6785;ENSG00000152234;ATP5A1;18;43664110;43684300;20190;0
6786;ENSG00000152240;HAUS1;18;43684298;43708299;24001;0
6787;ENSG00000152242;C18orf25;18;43753519;43846949;93430;0
6788;ENSG00000152315;KCNK13;14;90528109;90652201;124092;0
6789;ENSG00000152749;GPR180;13;95254157;95286899;32742;0
6790;ENSG00000152767;FARP1;13;98794816;99102027;307211;0
6791;ENSG00000152910;CNTNAP4;16;76311176;76593135;281959;0
6792;ENSG00000153048;CARHSP1;16;8946799;8962866;16067;0
6793;ENSG00000153066;TXNDC11;16;11772936;11836734;63798;0
6794;ENSG00000153339;TRAPPC8;18;29409136;29533099;123963;0
6795;ENSG00000153391;INO80C;18;33032194;33077955;45761;0
6796;ENSG00000153406;NMRAL1;16;4511681;4545764;34083;0
6797;ENSG00000153443;UBALD1;16;4658884;4665028;6144;0
6798;ENSG00000153485;TMEM251;14;93651296;93653434;2138;0
6799;ENSG00000153487;ING1;13;111365083;111373421;8338;0
6800;ENSG00000153495;TEX29;13;111968531;111996596;28065;0
6801;ENSG00000153531;ADPRHL1;13;114076260;114107839;31579;0
6802;ENSG00000153575;TUBGCP5;15;22833395;22873892;40497;0
6803;ENSG00000153774;CFDP1;16;75327596;75467383;139787;0
6804;ENSG00000153786;ZDHHC7;16;85007787;85045141;37354;0
6805;ENSG00000153789;FAM92B;16;85131965;85146114;14149;0
6806;ENSG00000153815;CMIP;16;81478775;81745367;266592;0
6807;ENSG00000153822;KCNJ16;17;68049570;68131749;82179;0
6808;ENSG00000153879;CEBPG;19;33864236;33873592;9356;0
6809;ENSG00000153885;KCTD15;19;34286838;34306668;19830;0
6810;ENSG00000153896;ZNF599;19;35248981;35264134;15153;0
6811;ENSG00000153902;LGI4;19;35615417;35633355;17938;0
6812;ENSG00000153930;ANKFN1;17;54188319;54589020;400701;0
6813;ENSG00000153933;DGKE;17;54911460;54946036;34576;0
6814;ENSG00000153944;MSI2;17;55333212;55762046;428834;0
6815;ENSG00000153976;HS3ST3A1;17;13399006;13505244;106238;0
6816;ENSG00000153982;GDPD1;17;57297828;57353328;55500;0
6817;ENSG00000154001;PPP2R5E;14;63838075;64010092;172017;0
6818;ENSG00000154016;GRAP;17;18923986;18950950;26964;0
6819;ENSG00000154035;C17orf103;17;21142183;21156722;14539;0
6820;ENSG00000154040;CABYR;18;21718942;21741567;22625;0
6821;ENSG00000154059;IMPACT;18;22006580;22033499;26919;0
6822;ENSG00000154065;ANKRD29;18;21178890;21242849;63959;1
6823;ENSG00000154080;CHST9;18;24495595;24765281;269686;0
6824;ENSG00000154099;DNAAF1;16;84178865;84212373;33508;0
6825;ENSG00000154118;JPH3;16;87635441;87731762;96321;0
6826;ENSG00000154217;PITPNC1;17;65373575;65693372;319797;0
6827;ENSG00000154229;PRKCA;17;64298754;64806861;508107;0
6828;ENSG00000154237;LRRK1;15;101459420;101610317;150897;0
6829;ENSG00000154240;CEP112;17;63631656;64188202;556546;0
6830;ENSG00000154258;ABCA9;17;66970629;67057205;86576;1
6831;ENSG00000154262;ABCA6;17;67074843;67138029;63186;0
6832;ENSG00000154263;ABCA10;17;67143355;67240987;97632;1
6833;ENSG00000154265;ABCA5;17;67240452;67323385;82933;0
6834;ENSG00000154655;L3MBTL4;18;5954705;6415236;460531;0
6835;ENSG00000154803;FLCN;17;17115526;17140502;24976;0
6836;ENSG00000154832;CXXC1;18;47808713;47814674;5961;0
6837;ENSG00000154839;SKA1;18;47901365;47920543;19178;1
6838;ENSG00000154845;PPP4R1;18;9546789;9615238;68449;0
6839;ENSG00000154856;APCDD1;18;10454625;10489945;35320;0
6840;ENSG00000154864;PIEZO2;18;10666480;11148587;482107;0
6841;ENSG00000154874;CCDC144B;17;18441117;18528930;87813;0
6842;ENSG00000154889;MPPE1;18;11882621;11909222;26601;0
6843;ENSG00000154898;CCDC144CP;17;20224477;20306870;82393;0
6844;ENSG00000154914;USP43;17;9548015;9633008;84993;0
6845;ENSG00000154920;EME1;17;48450581;48458844;8263;0
6846;ENSG00000154945;ANKRD40;17;48770551;48785285;14734;0
6847;ENSG00000154957;ZNF18;17;11880756;11900827;20071;0
6848;ENSG00000154975;CA10;17;49707674;50237377;529703;0
6849;ENSG00000155330;C16orf87;16;46830519;46865323;34804;0
6850;ENSG00000155393;HEATR3;16;50099852;50140298;40446;1
6851;ENSG00000155463;OXA1L;14;23235731;23241007;5276;0
6852;ENSG00000155465;SLC7A7;14;23242431;23299029;56598;0
6853;ENSG00000155592;ZKSCAN2;16;25247322;25269252;21930;0
6854;ENSG00000155666;KDM8;16;27214807;27233089;18282;0
6855;ENSG00000155719;OTOA;16;21689835;21772050;82215;0
6856;ENSG00000156030;ELMSAN1;14;74181825;74256988;75163;1
6857;ENSG00000156050;FAM161B;14;74398204;74417117;18913;0
6858;ENSG00000156218;ADAMTSL3;15;84322838;84708594;385756;0
6859;ENSG00000156232;WHAMM;15;83478380;83503611;25231;0
6860;ENSG00000156381;ANKRD9;14;102973179;102976136;2957;0
6861;ENSG00000156411;C14orf2;14;104378625;104394606;15981;0
6862;ENSG00000156642;NPTN;15;73852355;73926475;74120;0
6863;ENSG00000156853;ZNF689;16;30613879;30635333;21454;0
6864;ENSG00000156858;PRR14;16;30662038;30667761;5723;0
6865;ENSG00000156860;FBRS;16;30669752;30682135;12383;0
6866;ENSG00000156873;PHKG2;16;30759591;30772490;12899;0
6867;ENSG00000156958;GALK2;15;49447853;49660066;212213;0
6868;ENSG00000156968;MPV17L;16;15489611;15507125;17514;0
6869;ENSG00000156970;BUB1B;15;40453224;40513337;60113;0
6870;ENSG00000157045;NTAN1;16;15131710;15149921;18211;0
6871;ENSG00000157106;SMG1;16;18816175;18937776;121601;0
6872;ENSG00000157227;MMP14;14;23305766;23318236;12470;1
6873;ENSG00000157306;;14;23980969;24029987;49018;0
6874;ENSG00000157322;CLEC18A;16;69984810;69998141;13331;0
6875;ENSG00000157326;DHRS4;14;24422795;24438488;15693;0
6876;ENSG00000157349;DDX19B;16;70323566;70369186;45620;0
6877;ENSG00000157350;ST3GAL2;16;70413338;70473140;59802;0
6878;ENSG00000157353;FUK;16;70488324;70514177;25853;0
6879;ENSG00000157368;IL34;16;70613798;70694585;80787;0
6880;ENSG00000157379;DHRS1;14;24759804;24769039;9235;0
6881;ENSG00000157423;HYDIN;16;70841281;71264625;423344;0
6882;ENSG00000157429;ZNF19;16;71498453;71598992;100539;0
6883;ENSG00000157450;RNF111;15;59157374;59389618;232244;0
6884;ENSG00000157456;CCNB2;15;59397277;59417244;19967;0
6885;ENSG00000157470;FAM81A;15;59664892;59815748;150856;0
6886;ENSG00000157483;MYO1E;15;59427113;59665099;237986;0
6887;ENSG00000157637;SLC38A10;17;79218800;79269347;50547;0
6888;ENSG00000157734;SNX22;15;64443914;64449680;5766;0
6889;ENSG00000157823;AP3S2;15;90373831;90437574;63743;0
6890;ENSG00000157890;MEGF11;15;66187417;66546085;358668;0
6891;ENSG00000158201;ABHD3;18;19230858;19284766;53908;0
6892;ENSG00000158270;COLEC12;18;319361;500722;181361;0
6893;ENSG00000158545;ZC3H18;16;88636789;88698374;61585;0
6894;ENSG00000158717;RNF166;16;88762903;88772829;9926;0
6895;ENSG00000158792;SPATA2L;16;89762751;89768113;5362;0
6896;ENSG00000158805;ZNF276;16;89786808;89807311;20503;0
6897;ENSG00000158865;SLC5A11;16;24857162;24922949;65787;1
6898;ENSG00000158955;WNT9B;17;44910567;44964096;53529;0
6899;ENSG00000159111;MRPL10;17;45900638;45908900;8262;0
6900;ENSG00000159199;ATP5G1;17;46970127;46973233;3106;0
6901;ENSG00000159202;UBE2Z;17;46985731;47006418;20687;0
6902;ENSG00000159210;SNF8;17;47006678;47022479;15801;0
6903;ENSG00000159217;IGF2BP1;17;47074774;47133012;58238;0
6904;ENSG00000159248;GJD2;15;35043233;35047166;3933;0
6905;ENSG00000159314;ARHGAP27;17;43471275;43511787;40512;0
6906;ENSG00000159322;ADPGK;15;73043710;73078187;34477;0
6907;ENSG00000159387;IRX6;16;55357672;55364672;7000;0
6908;ENSG00000159433;STARD9;15;42867857;43013179;145322;0
6909;ENSG00000159459;UBR1;15;43235095;43398311;163216;0
6910;ENSG00000159461;AMFR;16;56395364;56459450;64086;0
6911;ENSG00000159579;RSPRY1;16;57220049;57274387;54338;0
6912;ENSG00000159593;NAE1;16;66836778;66907159;70381;0
6913;ENSG00000159625;CCDC135;16;57728705;57765717;37012;0
6914;ENSG00000159640;ACE;17;61554422;61599205;44783;0
6915;ENSG00000159648;TEPP;16;58010339;58022020;11681;0
6916;ENSG00000159708;LRRC36;16;67360701;67419106;58405;0
6917;ENSG00000159713;TPPP3;16;67423712;67427438;3726;0
6918;ENSG00000159714;ZDHHC1;16;67428322;67450736;22414;0
6919;ENSG00000159720;ATP6V0D1;16;67471917;67515140;43223;0
6920;ENSG00000159753;RLTPR;16;67678822;67691472;12650;0
6921;ENSG00000159761;C16orf86;16;67700719;67702661;1942;0
6922;ENSG00000159792;PSKH1;16;67927175;67963581;36406;0
6923;ENSG00000159842;ABR;17;906758;1132315;225557;0
6924;ENSG00000159871;LYPD5;19;44300081;44331358;31277;0
6925;ENSG00000159882;ZNF230;19;44507100;44518078;10978;0
6926;ENSG00000159885;ZNF222;19;44529494;44537265;7771;0
6927;ENSG00000159905;ZNF221;19;44455375;44471861;16486;0
6928;ENSG00000159915;ZNF233;19;44754318;44779470;25152;0
6929;ENSG00000159917;ZNF235;19;44732882;44809199;76317;0
6930;ENSG00000160007;ARHGAP35;19;47421933;47508334;86401;0
6931;ENSG00000160014;CALM3;19;47104331;47114050;9719;0
6932;ENSG00000160111;CPAMD8;19;17003758;17137625;133867;0
6933;ENSG00000160113;NR2F6;19;17342692;17356749;14057;0
6934;ENSG00000160117;ANKLE1;19;17392454;17398455;6001;0
6935;ENSG00000160161;CILP2;19;19649057;19657468;8411;0
6936;ENSG00000160229;ZNF66;19;20959110;20991922;32812;0
6937;ENSG00000160321;ZNF208;19;22115760;22193751;77991;0
6938;ENSG00000160336;ZNF761;19;53935227;53961515;26288;0
6939;ENSG00000160352;ZNF714;19;21264965;21308073;43108;0
6940;ENSG00000160392;C19orf47;19;40825443;40854434;28991;0
6941;ENSG00000160410;SHKBP1;19;41082757;41097305;14548;0
6942;ENSG00000160460;SPTBN4;19;40972148;41082370;110222;0
6943;ENSG00000160551;TAOK1;17;27717482;27878922;161440;0
6944;ENSG00000160570;DEDD2;19;42702750;42724292;21542;0
6945;ENSG00000160602;NEK8;17;27052915;27070473;17558;0
6946;ENSG00000160606;TLCD1;17;27051366;27054953;3587;0
6947;ENSG00000160633;SAFB;19;5623046;5668489;45443;0
6948;ENSG00000160877;NACC1;19;13228917;13251955;23038;0
6949;ENSG00000160888;IER2;19;13261229;13265722;4493;0
6950;ENSG00000160953;MUM1;19;1285890;1378430;92540;0
6951;ENSG00000160961;ZNF333;19;14800613;14844558;43945;0
6952;ENSG00000161082;CELF5;19;3224701;3297074;72373;0
6953;ENSG00000161091;MFSD12;19;3538259;3574288;36029;0
6954;ENSG00000161243;FBXO27;19;39481354;39523425;42071;0
6955;ENSG00000161249;DMKN;19;35988122;36004560;16438;0
6956;ENSG00000161265;U2AF1L4;19;36233365;36236346;2981;0
6957;ENSG00000161270;NPHS1;19;36316866;36360189;43323;0
6958;ENSG00000161277;THAP8;19;36525887;36545664;19777;0
6959;ENSG00000161298;ZNF382;19;37095719;37119499;23780;0
6960;ENSG00000161326;DUSP14;17;35849937;35873603;23666;0
6961;ENSG00000161381;PLXDC1;17;37219556;37310647;91091;0
6962;ENSG00000161395;PGAP3;17;37827375;37853050;25675;0
6963;ENSG00000161509;GRIN2C;17;72838162;72857627;19465;0
6964;ENSG00000161513;FDXR;17;72858619;72869156;10537;0
6965;ENSG00000161526;SAP30BP;17;73663196;73704142;40946;0
6966;ENSG00000161533;ACOX1;17;73937588;73975515;37927;0
6967;ENSG00000161542;PRPSAP1;17;74305567;74380602;75035;0
6968;ENSG00000161544;CYGB;17;74523438;74547257;23819;0
6969;ENSG00000161547;SRSF2;17;74730197;74733456;3259;0
6970;ENSG00000161551;ZNF577;19;52359055;52394203;35148;0
6971;ENSG00000161558;TMEM143;19;48835613;48867494;31881;0
6972;ENSG00000161618;ALDH16A1;19;49956426;49974305;17879;0
6973;ENSG00000161647;MPP3;17;41878167;41910538;32371;0
6974;ENSG00000161653;NAGS;17;42081914;42086431;4517;0
6975;ENSG00000161654;LSM12;17;42112003;42144987;32984;0
6976;ENSG00000161671;EMC10;19;50979657;50986608;6951;0
6977;ENSG00000161677;JOSD2;19;51009255;51014610;5355;0
6978;ENSG00000161681;SHANK1;19;51165084;51222707;57623;0
6979;ENSG00000161682;FAM171A2;17;42430583;42441243;10660;0
6980;ENSG00000161692;DBF4B;17;42785976;42829632;43656;0
6981;ENSG00000161714;PLCD3;17;43186335;43210721;24386;0
6982;ENSG00000161847;RAVER1;19;10426888;10444316;17428;0
6983;ENSG00000161860;SYCE2;19;13009600;13030090;20490;0
6984;ENSG00000161888;SPC24;19;11242196;11266484;24288;1
6985;ENSG00000161905;ALOX15;17;4534197;4545589;11392;0
6986;ENSG00000161914;ZNF653;19;11594242;11616738;22496;0
6987;ENSG00000161920;MED11;17;4634723;4636905;2182;0
6988;ENSG00000161921;CXCL16;17;4636821;4643217;6396;0
6989;ENSG00000161956;SENP3;17;7465192;7475287;10095;0
6990;ENSG00000161958;FGF11;17;7341592;7348256;6664;0
6991;ENSG00000161960;EIF4A1;17;7476024;7482323;6299;0
6992;ENSG00000161970;RPL26;17;8280838;8286531;5693;0
6993;ENSG00000161980;POLR3K;16;96407;103628;7221;0
6994;ENSG00000161981;SNRNP25;16;103010;107669;4659;0
6995;ENSG00000161996;WDR90;16;699311;717833;18522;0
6996;ENSG00000161999;JMJD8;16;731671;734529;2858;0
6997;ENSG00000162004;CCDC78;16;772582;776954;4372;0
6998;ENSG00000162032;SPSB3;16;1826713;1843701;16988;0
6999;ENSG00000162062;C16orf59;16;2510081;2514964;4883;0
7000;ENSG00000162063;CCNF;16;2479395;2508855;29460;0
7001;ENSG00000162065;TBC1D24;16;2525147;2555735;30588;0
7002;ENSG00000162066;AMDHD2;16;2570358;2581423;11065;0
7003;ENSG00000162068;NTN3;16;2521500;2524146;2646;0
7004;ENSG00000162073;PAQR4;16;3019246;3023490;4244;0
7005;ENSG00000162076;FLYWCH2;16;2933187;2949383;16196;0
7006;ENSG00000162086;ZNF75A;16;3355406;3368852;13446;0
7007;ENSG00000162104;ADCY9;16;4003388;4166186;162798;0
7008;ENSG00000163597;SNHG16;17;74553848;74561430;7582;0
7009;ENSG00000165300;SLITRK5;13;88324870;88331871;7001;1
7010;ENSG00000165355;FBXO33;14;39866873;39901704;34831;0
7011;ENSG00000165379;LRFN5;14;42076773;42373752;296979;0
7012;ENSG00000165389;SPTSSA;14;34901995;34931562;29567;0
7013;ENSG00000165410;CFL2;14;35179593;35184029;4436;0
7014;ENSG00000165417;GTF2A1;14;81641796;81687721;45925;0
7015;ENSG00000165501;LRR1;14;50065415;50081390;15975;0
7016;ENSG00000165502;RPL36AL;14;50085237;50087403;2166;0
7017;ENSG00000165506;DNAAF2;14;50091892;50101948;10056;0
7018;ENSG00000165516;KLHDC2;14;50234326;50249909;15583;0
7019;ENSG00000165521;EML5;14;89078775;89259096;180321;0
7020;ENSG00000165525;NEMF;14;50249997;50319921;69924;0
7021;ENSG00000165527;ARF6;14;50359810;50361490;1680;0
7022;ENSG00000165533;TTC8;14;89290497;89344335;53838;0
7023;ENSG00000165548;TMEM63C;14;77582911;77725838;142927;0
7024;ENSG00000165553;NGB;14;77731826;77737655;5829;0
7025;ENSG00000165555;NOXRED1;14;77860364;77889860;29496;0
7026;ENSG00000165617;DACT1;14;59100685;59115039;14354;0
7027;ENSG00000165659;DACH1;13;72012098;72441330;429232;0
7028;ENSG00000165782;TMEM55B;14;20925878;20929771;3893;0
7029;ENSG00000165792;METTL17;14;21457929;21465189;7260;0
7030;ENSG00000165795;NDRG2;14;21484922;21539031;54109;0
7031;ENSG00000165801;ARHGEF40;14;21538429;21558399;19970;0
7032;ENSG00000165804;ZNF219;14;21558205;21572881;14676;0
7033;ENSG00000165807;PPP1R36;14;65016620;65056098;39478;0
7034;ENSG00000165819;METTL3;14;21966277;21979517;13240;0
7035;ENSG00000165821;SALL2;14;21989232;22005350;16118;0
7036;ENSG00000165861;ZFYVE1;14;73436159;73493920;57761;0
7037;ENSG00000165898;ISCA2;14;74960423;74963809;3386;0
7038;ENSG00000165914;TTC7B;14;91006932;91282823;275891;0
7039;ENSG00000165929;TC2N;14;92246095;92333880;87785;0
7040;ENSG00000165934;CPSF2;14;92588281;92630755;42474;0
7041;ENSG00000165943;MOAP1;14;93648541;93651273;2732;0
7042;ENSG00000165948;IFI27L1;14;94547628;94570192;22564;0
7043;ENSG00000165949;IFI27;14;94571182;94583033;11851;0
7044;ENSG00000165959;CLMN;14;95648277;95786243;137966;0
7045;ENSG00000166068;SPRED1;15;38544527;38649450;104923;0
7046;ENSG00000166073;GPR176;15;40091233;40213093;121860;0
7047;ENSG00000166104;;15;62520095;62545434;25339;0
7048;ENSG00000166123;GPT2;16;46918290;46965209;46919;0
7049;ENSG00000166126;AMN;14;103388993;103399933;10940;0
7050;ENSG00000166128;RAB8B;15;63481668;63559981;78313;0
7051;ENSG00000166133;RPUSD2;15;40861499;40866659;5160;0
7052;ENSG00000166140;ZFYVE19;15;41099284;41106767;7483;0
7053;ENSG00000166145;SPINT1;15;41136216;41150405;14189;0
7054;ENSG00000166147;FBN1;15;48700503;48938046;237543;0
7055;ENSG00000166164;BRD7;16;50347398;50402845;55447;0
7056;ENSG00000166165;CKB;14;103985996;103989448;3452;0
7057;ENSG00000166166;TRMT61A;14;103995521;104003410;7889;0
7058;ENSG00000166170;BAG5;14;104022881;104029168;6287;0
7059;ENSG00000166173;LARP6;15;71123863;71146498;22635;0
7060;ENSG00000166188;ZNF319;16;58028572;58034357;5785;0
7061;ENSG00000166192;SENP8;15;72406599;72433311;26712;0
7062;ENSG00000166200;COPS2;15;49398268;49447858;49590;0
7063;ENSG00000166206;GABRB3;15;26788693;27184686;395993;0
7064;ENSG00000166233;ARIH1;15;72766667;72879692;113025;0
7065;ENSG00000166246;C16orf71;16;4784273;4799397;15124;0
7066;ENSG00000166260;COX11;17;53029263;53046146;16883;0
7067;ENSG00000166262;FAM227B;15;49619159;49913128;293969;0
7068;ENSG00000166263;STXBP4;17;53046088;53241646;195558;0
7069;ENSG00000166292;TMEM100;17;53796988;53809482;12494;1
7070;ENSG00000166342;NETO1;18;70409549;70535381;125832;0
7071;ENSG00000166347;CYB5A;18;71920530;71959251;38721;0
7072;ENSG00000166359;WDR88;19;33622996;33666701;43705;0
7073;ENSG00000166377;ATP9B;18;76829285;77138283;308998;0
7074;ENSG00000166398;KIAA0355;19;34745442;34846491;101049;0
7075;ENSG00000166401;SERPINB8;18;61637159;61672278;35119;0
7076;ENSG00000166411;IDH3A;15;78423840;78464291;40451;0
7077;ENSG00000166415;WDR72;15;53805938;54055075;249137;0
7078;ENSG00000166426;CRABP1;15;78632666;78640572;7906;0
7079;ENSG00000166446;CDYL2;16;80631803;80838226;206423;0
7080;ENSG00000166450;PRTG;15;55903744;56035288;131544;0
7081;ENSG00000166451;CENPN;16;81040103;81066719;26616;0
7082;ENSG00000166454;ATMIN;16;81069452;81080963;11511;0
7083;ENSG00000166455;C16orf46;16;81087102;81110872;23770;0
7084;ENSG00000166473;PKD1L2;16;81134480;81253975;119495;0
7085;ENSG00000166477;LEO1;15;52230222;52264003;33781;0
7086;ENSG00000166479;TMX3;18;66340925;66382535;41610;0
7087;ENSG00000166482;MFAP4;17;19286755;19290553;3798;0
7088;ENSG00000166484;MAPK7;17;19281034;19286857;5823;0
7089;ENSG00000166501;PRKCB;16;23847322;24231932;384610;0
7090;ENSG00000166503;;15;83784320;83876770;92450;0
7091;ENSG00000166546;BEAN1;16;66461200;66527432;66232;0
7092;ENSG00000166548;TK2;16;66541906;66586447;44541;0
7093;ENSG00000166557;TMED3;15;79603404;79704334;100930;0
7094;ENSG00000166562;SEC11C;18;56806709;56826068;19359;0
7095;ENSG00000166569;CPLX4;18;56942388;56985881;43493;1
7096;ENSG00000166579;NDEL1;17;8316449;8393729;77280;0
7097;ENSG00000166582;CENPV;17;16245848;16256970;11122;0
7098;ENSG00000166592;RRAD;16;66955582;66959547;3965;0
7099;ENSG00000166595;FAM96B;16;66965959;66968326;2367;0
7100;ENSG00000166596;WDR16;17;9479944;9546776;66832;0
7101;ENSG00000166603;MC4R;18;58038564;58040001;1437;1
7102;ENSG00000166664;CHRFAM7A;15;30653443;30686052;32609;0
7103;ENSG00000166669;ATF7IP2;16;10420291;10577495;157204;0
7104;ENSG00000166676;TVP23A;16;10854776;10912651;57875;0
7105;ENSG00000166685;COG1;17;71189129;71204646;15517;0
7106;ENSG00000166710;B2M;15;45003675;45011075;7400;0
7107;ENSG00000166716;ZNF592;15;85291866;85349659;57793;0
7108;ENSG00000166734;CASC4;15;44580927;44707956;127029;0
7109;ENSG00000166747;AP1G1;16;71762913;71843104;80191;0
7110;ENSG00000166750;SLFN5;17;33570055;33600674;30619;0
7111;ENSG00000166762;CATSPER2;15;43920701;43960316;39615;0
7112;ENSG00000166780;C16orf45;16;15528152;15718885;190733;0
7113;ENSG00000166783;KIAA0430;16;15688243;15737023;48780;0
7114;ENSG00000166794;PPIB;15;64448011;64455404;7393;0
7115;ENSG00000166797;FAM96A;15;64364758;64386217;21459;0
7116;ENSG00000166803;KIAA0101;15;64657193;64679886;22693;0
7117;ENSG00000166813;KIF7;15;90152020;90198682;46662;0
7118;ENSG00000166816;LDHD;16;75145758;75150669;4911;0
7119;ENSG00000166821;PEX11A;15;90220995;90234014;13019;0
7120;ENSG00000166822;TMEM170A;16;75476952;75499395;22443;0
7121;ENSG00000166823;MESP1;15;90291892;90294541;2649;0
7122;ENSG00000166831;RBPMS2;15;65032091;65067786;35695;0
7123;ENSG00000166839;ANKDD1A;15;65204101;65251042;46941;0
7124;ENSG00000166845;C18orf54;18;51884287;51911588;27301;0
7125;ENSG00000166847;DCTN5;16;23652713;23681195;28482;0
7126;ENSG00000166848;TERF2IP;16;75681684;75795770;114086;0
7127;ENSG00000166851;PLK1;16;23688977;23701688;12711;0
7128;ENSG00000166855;CLPX;15;65440557;65477680;37123;0
7129;ENSG00000166887;VPS39;15;42450899;42500514;49615;0
7130;ENSG00000166912;MTMR10;15;31231144;31283810;52666;0
7131;ENSG00000166922;SCG5;15;32933877;32989299;55422;0
7132;ENSG00000166938;DIS3L;15;66585555;66626236;40681;0
7133;ENSG00000166946;CCNDBP1;15;43477316;43487396;10080;0
7134;ENSG00000166947;EPB42;15;43398423;43513481;115058;0
7135;ENSG00000166949;SMAD3;15;67356101;67487533;131432;0
7136;ENSG00000166960;CCDC178;18;30517366;31021065;503699;0
7137;ENSG00000166963;MAP1A;15;43803156;43823818;20662;0
7138;ENSG00000166965;RCCD1;15;91498100;91506349;8249;0
7139;ENSG00000166971;AKTIP;16;53524952;53538323;13371;0
7140;ENSG00000166974;MAPRE2;18;32556892;32723434;166542;0
7141;ENSG00000167004;PDIA3;15;44038590;44065477;26887;0
7142;ENSG00000167005;NUDT21;16;56463045;56486111;23066;0
7143;ENSG00000167085;PHB;17;47481414;47492246;10832;0
7144;ENSG00000167088;SNRPD1;18;19192228;19210417;18189;0
7145;ENSG00000167100;SAMD14;17;48187404;48207246;19842;0
7146;ENSG00000167107;ACSF2;17;48503519;48552206;48687;0
7147;ENSG00000167173;C15orf39;15;75487984;75504510;16526;0
7148;ENSG00000167178;ISLR2;15;74392652;74430881;38229;0
7149;ENSG00000167182;SP2;17;45973516;46006323;32807;1
7150;ENSG00000167186;COQ7;16;19078921;19091417;12496;0
7151;ENSG00000167191;GPRC5B;16;19868616;19897489;28873;0
7152;ENSG00000167193;CRK;17;1323983;1366456;42473;0
7153;ENSG00000167196;FBXO22;15;76196200;76227609;31409;0
7154;ENSG00000167202;TBC1D2B;15;78276378;78370066;93688;0
7155;ENSG00000167216;KATNAL2;18;44497455;44627658;130203;0
7156;ENSG00000167220;HDHD2;18;44633774;44676891;43117;0
7157;ENSG00000167232;ZNF91;19;23487793;23578362;90569;0
7158;ENSG00000167258;CDK12;17;37617764;37721160;103396;0
7159;ENSG00000167264;DUS2;16;68021649;68113223;91574;0
7160;ENSG00000167280;ENGASE;17;77071021;77084681;13660;0
7161;ENSG00000167281;RBFOX3;17;77085427;77613550;528123;0
7162;ENSG00000167291;TBC1D16;17;77906142;78009647;103505;0
7163;ENSG00000167302;ENTHD2;17;79202077;79212891;10814;0
7164;ENSG00000167306;MYO5B;18;47349183;47721463;372280;0
7165;ENSG00000167315;ACAA2;18;47309869;47340330;30461;0
7166;ENSG00000167363;FN3K;17;80693451;80709073;15622;0
7167;ENSG00000167371;PRRT2;16;29823177;29827201;4024;0
7168;ENSG00000167377;ZNF23;16;71481500;71496998;15498;0
7169;ENSG00000167378;IRGQ;19;44088521;44100287;11766;0
7170;ENSG00000167380;ZNF226;19;44669226;44682534;13308;0
7171;ENSG00000167383;ZNF229;19;44921685;44952766;31081;0
7172;ENSG00000167384;ZNF180;19;44979854;45004576;24722;0
7173;ENSG00000167394;ZNF668;16;31072164;31085641;13477;0
7174;ENSG00000167395;ZNF646;16;31085743;31095517;9774;0
7175;ENSG00000167397;VKORC1;16;31102163;31107301;5138;0
7176;ENSG00000167414;GNG8;19;47137333;47137942;609;0
7177;ENSG00000167434;CA4;17;58227297;58248260;20963;0
7178;ENSG00000167447;SMG8;17;57286761;57292608;5847;0
7179;ENSG00000167460;TPM4;19;16177831;16213813;35982;0
7180;ENSG00000167461;RAB8A;19;16222439;16245044;22605;0
7181;ENSG00000167468;GPX4;19;1103936;1106787;2851;0
7182;ENSG00000167470;MIDN;19;1248552;1259142;10590;0
7183;ENSG00000167483;FAM129C;19;17634110;17664648;30538;0
7184;ENSG00000167487;KLHL26;19;18747775;18781309;33534;0
7185;ENSG00000167491;GATAD2A;19;19496635;19619740;123105;0
7186;ENSG00000167508;MVD;16;88718343;88729569;11226;0
7187;ENSG00000167513;CDT1;16;88869621;88875666;6045;0
7188;ENSG00000167515;TRAPPC2L;16;88922628;88929094;6466;0
7189;ENSG00000167522;ANKRD11;16;89334038;89556969;222931;0
7190;ENSG00000167523;SPATA33;16;89724210;89737680;13470;0
7191;ENSG00000167524;;17;26934982;26941218;6236;0
7192;ENSG00000167525;PROCA1;17;27030215;27038872;8657;0
7193;ENSG00000167526;RPL13;16;89627065;89630950;3885;0
7194;ENSG00000167536;DHRS13;17;27224799;27230089;5290;0
7195;ENSG00000167543;TP53I13;17;27893070;27900175;7105;0
7196;ENSG00000167549;CORO6;17;27941774;27949925;8151;0
7197;ENSG00000167554;ZNF610;19;52839498;52871031;31533;0
7198;ENSG00000167555;ZNF528;19;52901102;52921665;20563;0
7199;ENSG00000167562;ZNF701;19;53059075;53090427;31352;0
7200;ENSG00000167565;SERTAD3;19;40946751;40950612;3861;0
7201;ENSG00000167578;RAB4B;19;41284121;41302847;18726;0
7202;ENSG00000167595;C19orf55;19;36249044;36261930;12886;0
7203;ENSG00000167601;AXL;19;41725108;41767671;42563;0
7204;ENSG00000167604;NFKBID;19;36378555;36393205;14650;0
7205;ENSG00000167619;TMEM145;19;42817477;42829214;11737;0
7206;ENSG00000167625;ZNF526;19;42724423;42732353;7930;0
7207;ENSG00000167635;ZNF146;19;36705504;36729676;24172;0
7208;ENSG00000167637;ZNF283;19;44331444;44353307;21863;0
7209;ENSG00000167642;SPINT2;19;38734675;38783254;48579;0
7210;ENSG00000167645;YIF1B;19;38795753;38807913;12160;0
7211;ENSG00000167654;ATCAY;19;3879862;3928077;48215;0
7212;ENSG00000167657;DAPK3;19;3958451;3971121;12670;0
7213;ENSG00000167658;EEF2;19;3976054;3985467;9413;0
7214;ENSG00000167670;CHAF1A;19;4402659;4445015;42356;0
7215;ENSG00000167671;UBXN6;19;4444996;4457819;12823;0
7216;ENSG00000167674;;19;4472284;4502223;29939;0
7217;ENSG00000167676;PLIN4;19;4502204;4517716;15512;0
7218;ENSG00000167680;SEMA6B;19;4542600;4559820;17220;0
7219;ENSG00000167693;NXN;17;702553;883010;180457;0
7220;ENSG00000167695;FAM57A;17;635652;646206;10554;0
7221;ENSG00000167699;GLOD4;17;660337;685581;25244;0
7222;ENSG00000167703;SLC43A2;17;1472561;1532180;59619;0
7223;ENSG00000167705;RILP;17;1549444;1553371;3927;0
7224;ENSG00000167711;SERPINF2;17;1646130;1658562;12432;0
7225;ENSG00000167716;WDR81;17;1619817;1641893;22076;0
7226;ENSG00000167720;SRR;17;2206677;2228554;21877;0
7227;ENSG00000167721;TSR1;17;2225797;2240801;15004;0
7228;ENSG00000167723;TRPV3;17;3413796;3461289;47493;0
7229;ENSG00000167733;HSD11B1L;19;5680615;5688533;7918;0
7230;ENSG00000167740;CYB5D2;17;4046462;4090605;44143;0
7231;ENSG00000167747;C19orf48;19;51300961;51308186;7225;0
7232;ENSG00000167765;;19;52095036;52097630;2594;0
7233;ENSG00000167766;ZNF83;19;53097313;53193749;96436;0
7234;ENSG00000167775;CD320;19;8367011;8373240;6229;0
7235;ENSG00000167785;ZNF558;19;8920380;8943004;22624;0
7236;ENSG00000167815;PRDX2;19;12907634;12912694;5060;0
7237;ENSG00000167840;ZNF232;17;5008836;5026411;17575;0
7238;ENSG00000167842;MIS12;17;5389605;5394134;4529;0
7239;ENSG00000167858;TEKT1;17;6692452;6735080;42628;0
7240;ENSG00000167861;HID1;17;72946838;72969261;22423;0
7241;ENSG00000167862;ICT1;17;73008765;73017356;8591;0
7242;ENSG00000167863;ATP5H;17;73034958;73043080;8122;0
7243;ENSG00000167874;TMEM88;17;7758383;7759417;1034;0
7244;ENSG00000167881;SRP68;17;74035184;74068734;33550;0
7245;ENSG00000167889;MGAT5B;17;74864538;74946475;81937;0
7246;ENSG00000167895;TMC8;17;76126851;76139049;12198;0
7247;ENSG00000167900;TK1;17;76170160;76183314;13154;0
7248;ENSG00000167920;TMEM99;17;38975358;38992522;17164;0
7249;ENSG00000167925;GHDC;17;40340817;40346531;5714;0
7250;ENSG00000167930;ITFG3;16;284545;319942;35397;0
7251;ENSG00000167962;ZNF598;16;2047655;2059824;12169;0
7252;ENSG00000167964;RAB26;16;2190804;2204166;13362;0
7253;ENSG00000167965;MLST8;16;2254249;2259417;5168;0
7254;ENSG00000167967;E4F1;16;2273567;2285743;12176;0
7255;ENSG00000167968;DNASE1L2;16;2285817;2288712;2895;0
7256;ENSG00000167969;ECI1;16;2289396;2302301;12905;0
7257;ENSG00000167971;CASKIN1;16;2227184;2246526;19342;0
7258;ENSG00000167972;ABCA3;16;2325882;2390747;64865;0
7259;ENSG00000167977;KCTD5;16;2732476;2759031;26555;0
7260;ENSG00000167978;SRRM2;16;2802330;2822539;20209;0
7261;ENSG00000167981;ZNF597;16;3486104;3493542;7438;0
7262;ENSG00000167984;NLRC3;16;3589033;3627401;38368;0
7263;ENSG00000168096;ANKS3;16;4746513;4784379;37866;0
7264;ENSG00000168101;NUDT16L1;16;4743695;4745860;2165;0
7265;ENSG00000168124;OR1F1;16;3254247;3255188;941;0
7266;ENSG00000168140;VASN;16;4421849;4433529;11680;0
7267;ENSG00000168175;MAPK1IP1L;14;55518349;55536910;18561;0
7268;ENSG00000168234;TTC39C;18;21572737;21715574;142837;0
7269;ENSG00000168256;NKIRAS2;17;40163400;40177659;14259;0
7270;ENSG00000168259;DNAJC7;17;40128451;40173394;44943;0
7271;ENSG00000168282;MGAT2;14;50087489;50090198;2709;0
7272;ENSG00000168286;THAP11;16;67876213;67878097;1884;0
7273;ENSG00000168398;BDKRB2;14;96671016;96710666;39650;1
7274;ENSG00000168411;RFWD3;16;74655292;74700779;45487;0
7275;ENSG00000168434;COG7;16;23399814;23464501;64687;0
7276;ENSG00000168461;RAB31;18;9708162;9862548;154386;0
7277;ENSG00000168488;ATXN2L;16;28834356;28848558;14202;0
7278;ENSG00000168502;SOGA2;18;8705659;8832776;127117;0
7279;ENSG00000168517;HEXIM2;17;43238067;43247407;9340;0
7280;ENSG00000168591;TMUB2;17;42264338;42269099;4761;0
7281;ENSG00000168610;STAT3;17;40465342;40540586;75244;0
7282;ENSG00000168646;AXIN2;17;63524681;63557765;33084;0
7283;ENSG00000168661;ZNF30;19;35417807;35436074;18267;0
7284;ENSG00000168675;LDLRAD4;18;13217497;13652754;435257;0
7285;ENSG00000168676;KCTD19;16;67323331;67360666;37335;0
7286;ENSG00000168701;TMEM208;16;67261006;67263181;2175;0
7287;ENSG00000168748;CA7;16;66878282;66888056;9774;0
7288;ENSG00000168781;PPIP5K1;15;43825660;43882430;56770;0
7289;ENSG00000168792;ABHD15;17;27887565;27894155;6590;0
7290;ENSG00000168802;CHTF8;16;69151913;69166487;14574;0
7291;ENSG00000168803;ADAL;15;43622872;43646096;23224;0
7292;ENSG00000168806;LCMT2;15;43619974;43622803;2829;0
7293;ENSG00000168807;SNTB2;16;69221032;69342955;121923;0
7294;ENSG00000168813;ZNF507;19;32836500;32878573;42073;0
7295;ENSG00000168872;DDX19A;16;70380732;70407286;26554;0
7296;ENSG00000168904;LRRC28;15;99791567;99930934;139367;1
7297;ENSG00000168952;STXBP6;14;25278862;25519503;240641;0
7298;ENSG00000168961;LGALS9;17;25956824;25976586;19762;0
7299;ENSG00000168970;JMJD7-PLA2G4B;15;42120293;42140353;20060;0
7300;ENSG00000169018;FEM1B;15;68570141;68588203;18062;0
7301;ENSG00000169021;UQCRFS1;19;29698173;29704448;6275;0
7302;ENSG00000169032;MAP2K1;15;66679155;66784650;105495;0
7303;ENSG00000169062;UPF3A;13;115047059;115071283;24224;0
7304;ENSG00000169105;CHST14;15;40763160;40765353;2193;0
7305;ENSG00000169118;CSNK1G1;15;64457716;64648442;190726;0
7306;ENSG00000169136;ATF5;19;50431959;50437192;5233;0
7307;ENSG00000169169;CPT1C;19;50194155;50216988;22833;0
7308;ENSG00000169180;XPO6;16;28109300;28223241;113941;0
7309;ENSG00000169181;GSG1L;16;27798850;28074830;275980;0
7310;ENSG00000169189;NSMCE1;16;27236312;27280115;43803;0
7311;ENSG00000169203;;16;29495010;29517320;22310;0
7312;ENSG00000169217;CD2BP2;16;30362087;30366682;4595;0
7313;ENSG00000169221;TBC1D10B;16;30368423;30381585;13162;0
7314;ENSG00000169246;NPIPB3;16;21413558;21459888;46330;0
7315;ENSG00000169330;KIAA1024;15;79724858;79764632;39774;1
7316;ENSG00000169371;SNUPN;15;75890424;75918810;28386;0
7317;ENSG00000169375;SIN3A;15;75661720;75748183;86463;0
7318;ENSG00000169410;PTPN9;15;75759462;75871630;112168;0
7319;ENSG00000169515;CCDC8;19;46913629;46916841;3212;0
7320;ENSG00000169592;INO80E;16;30006615;30017114;10499;0
7321;ENSG00000169609;C15orf40;15;83657193;83680393;23200;0
7322;ENSG00000169612;FAM103A1;15;83654959;83659809;4850;0
7323;ENSG00000169660;HEXDC;17;80376194;80400521;24327;0
7324;ENSG00000169682;SPNS1;16;28985542;28995869;10327;0
7325;ENSG00000169683;LRRC45;17;79981178;79989027;7849;0
7326;ENSG00000169684;CHRNA5;15;78857862;78887611;29749;0
7327;ENSG00000169689;STRA13;17;79976578;79981983;5405;0
7328;ENSG00000169696;ASPSCR1;17;79934683;79975282;40599;0
7329;ENSG00000169710;FASN;17;80036214;80056208;19994;0
7330;ENSG00000169718;DUS1L;17;80015382;80023763;8381;0
7331;ENSG00000169727;GPS1;17;80008567;80015346;6779;0
7332;ENSG00000169733;RFNG;17;80005778;80009707;3929;0
7333;ENSG00000169738;DCXR;17;79993012;79995608;2596;0
7334;ENSG00000169750;RAC3;17;79989500;79992080;2580;0
7335;ENSG00000169752;NRG4;15;76228310;76352136;123826;0
7336;ENSG00000169758;C15orf27;15;76352178;76521462;169284;0
7337;ENSG00000169783;LINGO1;15;77905369;78113242;207873;0
7338;ENSG00000169856;ONECUT1;15;53049637;53083273;33636;0
7339;ENSG00000169857;AVEN;15;34158428;34331377;172949;0
7340;ENSG00000169918;OTUD7A;15;31775329;32162992;387663;0
7341;ENSG00000169926;KLF13;15;31619058;31727868;108810;0
7342;ENSG00000169951;ZNF764;16;30565085;30569819;4734;0
7343;ENSG00000169955;ZNF747;16;30537244;30546668;9424;0
7344;ENSG00000169957;ZNF768;16;30535325;30538142;2817;0
7345;ENSG00000169992;NLGN2;17;7308193;7323179;14986;0
7346;ENSG00000170004;CHD3;17;7788124;7816078;27954;0
7347;ENSG00000170037;CNTROB;17;7835419;7853236;17817;0
7348;ENSG00000170043;TRAPPC1;17;7833663;7835441;1778;0
7349;ENSG00000170049;KCNAB3;17;7825177;7833121;7944;1
7350;ENSG00000170100;ZNF778;16;89284118;89295363;11245;0
7351;ENSG00000170113;NIPA1;15;23043277;23100005;56728;0
7352;ENSG00000170160;CCDC144A;17;16592851;16707767;114916;0
7353;ENSG00000170175;CHRNB1;17;7348380;7361026;12646;0
7354;ENSG00000170222;ADPRM;17;10600911;10614550;13639;0
7355;ENSG00000170270;C14orf142;14;93669239;93673439;4200;0
7356;ENSG00000170291;ELP5;17;7154735;7163259;8524;0
7357;ENSG00000170296;GABARAP;17;7143333;7146089;2756;0
7358;ENSG00000170310;STX8;17;9153788;9479908;326120;0
7359;ENSG00000170315;UBB;17;16284112;16286059;1947;0
7360;ENSG00000170345;FOS;14;75745477;75748933;3456;0
7361;ENSG00000170348;TMED10;14;75598173;75643334;45161;0
7362;ENSG00000170412;GPRC5C;17;72420990;72447792;26802;0
7363;ENSG00000170425;ADORA2B;17;15848231;15879060;30829;0
7364;ENSG00000170537;TMC7;16;18995256;19075264;80008;0
7365;ENSG00000170540;ARL6IP1;16;18802991;18813000;10009;0
7366;ENSG00000170558;CDH2;18;25530930;25757410;226480;0
7367;ENSG00000170579;DLGAP1;18;3496030;4455335;959305;0
7368;ENSG00000170604;IRF2BP1;19;46386866;46389376;2510;0
7369;ENSG00000170677;SOCS6;18;67956137;67997436;41299;0
7370;ENSG00000170684;ZNF296;19;45574758;45579846;5088;0
7371;ENSG00000170776;AKAP13;15;85923802;86292586;368784;0
7372;ENSG00000170779;CDCA4;14;105475910;105487485;11575;0
7373;ENSG00000170832;USP32;17;58256455;58499831;243376;0
7374;ENSG00000170836;PPM1D;17;58677544;58741849;64305;0
7375;ENSG00000170921;TANC2;17;61086917;61505060;418143;0
7376;ENSG00000170949;ZNF160;19;53569859;53606689;36830;0
7377;ENSG00000170954;ZNF415;19;53611132;53636330;25198;0
7378;ENSG00000171016;PYGO1;15;55831088;55881145;50057;0
7379;ENSG00000171105;INSR;19;7112266;7294045;181779;0
7380;ENSG00000171124;FUT3;19;5842899;5851485;8586;0
7381;ENSG00000171208;NETO2;16;47111614;47177908;66294;0
7382;ENSG00000171223;JUNB;19;12902310;12904124;1814;0
7383;ENSG00000171241;SHCBP1;16;46614466;46655538;41072;0
7384;ENSG00000171246;NPTX1;17;78440948;78451643;10695;0
7385;ENSG00000171262;FAM98B;15;38746328;38779911;33583;0
7386;ENSG00000171282;;17;79373540;79433357;59817;0
7387;ENSG00000171291;ZNF439;19;11959541;11994565;35024;0
7388;ENSG00000171295;ZNF440;19;11925099;11946016;20917;0
7389;ENSG00000171298;GAA;17;78075355;78093678;18323;0
7390;ENSG00000171302;CANT1;17;76987799;77005949;18150;0
7391;ENSG00000171451;DSEL;18;65173819;65184217;10398;0
7392;ENSG00000171466;ZNF562;19;9759330;9785776;26446;0
7393;ENSG00000171469;ZNF561;19;9715356;9732075;16719;0
7394;ENSG00000171475;WIPF2;17;38375556;38440388;64832;0
7395;ENSG00000171490;RSL1D1;16;11929056;11945442;16386;0
7396;ENSG00000171532;NEUROD2;17;37759789;37766030;6241;1
7397;ENSG00000171634;BPTF;17;65821640;65980494;158854;0
7398;ENSG00000171723;GPHN;14;66974125;67648520;674395;0
7399;ENSG00000171724;VAT1L;16;77822427;78014004;191577;0
7400;ENSG00000171747;LGALS4;19;39292311;39304004;11693;0
7401;ENSG00000171763;SPATA5L1;15;45694529;45713617;19088;0
7402;ENSG00000171766;GATM;15;45653322;45694525;41203;1
7403;ENSG00000171791;BCL2;18;60790579;60987361;196782;0
7404;ENSG00000171817;ZNF540;19;38042308;38104998;62690;0
7405;ENSG00000171827;ZNF570;19;37958487;37976260;17773;0
7406;ENSG00000171861;RNMTL1;17;685513;695749;10236;0
7407;ENSG00000171877;FRMD5;15;44162962;44487450;324488;0
7408;ENSG00000171885;AQP4;18;24432002;24445782;13780;0
7409;ENSG00000171914;TLN2;15;62682725;63136830;454105;1
7410;ENSG00000171928;TVP23B;17;18684308;18710027;25719;0
7411;ENSG00000171931;FBXW10;17;18647326;18682662;35336;0
7412;ENSG00000171953;ATPAF2;17;17880723;17942523;61800;0
7413;ENSG00000171956;FOXB1;15;60296421;60353929;57508;0
7414;ENSG00000171962;LRRC48;17;17876127;17920203;44076;0
7415;ENSG00000171970;ZNF57;19;2900896;2918474;17578;0
7416;ENSG00000172000;ZNF556;19;2867333;2878515;11182;0
7417;ENSG00000172006;ZNF554;19;2819872;2835771;15899;0
7418;ENSG00000172009;THOP1;19;2785458;2813599;28141;0
7419;ENSG00000172057;ORMDL3;17;38077294;38083854;6560;0
7420;ENSG00000172081;MOB3A;19;2071037;2096672;25635;0
7421;ENSG00000172123;SLFN12;17;33738079;33760302;22223;1
7422;ENSG00000172137;CALB2;16;71392616;71424341;31725;0
7423;ENSG00000172171;TEFM;17;29224354;29233838;9484;0
7424;ENSG00000172175;MALT1;18;56338618;56417371;78753;0
7425;ENSG00000172183;ISG20;15;89179384;89199714;20330;0
7426;ENSG00000172232;AZU1;19;825097;832017;6920;0
7427;ENSG00000172270;BSG;19;571297;583493;12196;0
7428;ENSG00000172301;COPRS;17;30178883;30186356;7473;0
7429;ENSG00000172345;STARD5;15;81601394;81616524;15130;1
7430;ENSG00000172349;IL16;15;81451916;81605104;153188;0
7431;ENSG00000172361;CCDC11;18;47753563;47792892;39329;0
7432;ENSG00000172366;FAM195A;16;691813;698474;6661;0
7433;ENSG00000172379;ARNT2;15;80696692;80890278;193586;0
7434;ENSG00000172382;PRSS27;16;2762419;2770552;8133;0
7435;ENSG00000172466;ZNF24;18;32912176;32925446;13270;0
7436;ENSG00000172530;BANP;16;87982850;88110924;128074;0
7437;ENSG00000172575;RASGRP1;15;38780304;38857776;77472;0
7438;ENSG00000172590;MRPL52;14;23299088;23304246;5158;0
7439;ENSG00000172660;TAF15;17;34136459;34191619;55160;0
7440;ENSG00000172687;ZNF738;19;21541732;21562104;20372;0
7441;ENSG00000172717;FAM71D;14;67656110;67695267;39157;0
7442;ENSG00000172775;FAM192A;16;57186378;57220028;33650;0
7443;ENSG00000172782;FADS6;17;72873428;72889708;16280;0
7444;ENSG00000172794;RAB37;17;72666717;72743474;76757;1
7445;ENSG00000172809;RPL38;17;72199721;72206794;7073;0
7446;ENSG00000172824;CES4A;16;67022492;67043661;21169;0
7447;ENSG00000172828;CES3;16;66995140;67009051;13911;0
7448;ENSG00000172831;CES2;16;66968347;66978999;10652;0
7449;ENSG00000172840;PDP2;16;66912492;66929657;17165;0
7450;ENSG00000172992;DCAKD;17;43100708;43138473;37765;0
7451;ENSG00000173065;FAM222B;17;27082996;27182250;99254;0
7452;ENSG00000173482;PTPRM;18;7566780;8406859;840079;0
7453;ENSG00000173517;PEAK1;15;77400471;77712486;312015;0
7454;ENSG00000173548;SNX33;15;75940247;75954642;14395;0
7455;ENSG00000173575;CHD2;15;93426526;93571237;144711;0
7456;ENSG00000173714;WFIKKN2;17;48912011;48919709;7698;0
7457;ENSG00000173757;STAT5B;17;40351186;40428725;77539;0
7458;ENSG00000173786;CNP;17;40118759;40129749;10990;0
7459;ENSG00000173801;JUP;17;39775692;39943183;167491;0
7460;ENSG00000173805;HAP1;17;39873994;39890896;16902;0
7461;ENSG00000173809;TDRD12;19;33210659;33320483;109824;0
7462;ENSG00000173812;EIF1;17;39845137;39848920;3783;0
7463;ENSG00000173818;ENDOV;17;78388965;78411886;22921;0
7464;ENSG00000173821;RNF213;17;78234665;78372586;137921;0
7465;ENSG00000173838;10-Mar;17;60778675;60885705;107030;0
7466;ENSG00000173867;;15;89002948;89055760;52812;0
7467;ENSG00000173875;ZNF791;19;12721732;12742735;21003;0
7468;ENSG00000173894;CBX2;17;77751931;77761782;9851;0
7469;ENSG00000173928;SWSAP1;19;11485361;11487627;2266;0
7470;ENSG00000173991;TCAP;17;37820440;37822808;2368;0
7471;ENSG00000174093;;17;36337717;36421858;84141;0
7472;ENSG00000174100;MRPL45;17;36452989;36479101;26112;0
7473;ENSG00000174109;C16orf91;16;1469745;1479345;9600;0
7474;ENSG00000174111;SOCS7;17;36508111;36556019;47908;0
7475;ENSG00000174177;CTU2;16;88772871;88781794;8923;0
7476;ENSG00000174197;MGA;15;41913422;42062141;148719;0
7477;ENSG00000174231;PRPF8;17;1553923;1588176;34253;0
7478;ENSG00000174238;PITPNA;17;1421012;1466110;45098;0
7479;ENSG00000174282;ZBTB4;17;7362685;7387582;24897;0
7480;ENSG00000174292;TNK1;17;7283853;7293093;9240;0
7481;ENSG00000174327;SLC16A13;17;6939394;6943440;4046;0
7482;ENSG00000174373;RALGAPA1;14;36007558;36278510;270952;0
7483;ENSG00000174405;LIG4;13;108859787;108870716;10929;0
7484;ENSG00000174442;ZWILCH;15;66797297;66842115;44818;0
7485;ENSG00000174444;RPL4;15;66790355;66816870;26515;0
7486;ENSG00000174446;SNAPC5;15;66782473;66790151;7678;0
7487;ENSG00000174448;STARD6;18;51850728;51884334;33606;0
7488;ENSG00000174450;GOLGA6L2;15;23684645;23692381;7736;0
7489;ENSG00000174485;DENND4A;15;65950384;66084631;134247;0
7490;ENSG00000174498;IGDCC3;15;65619465;65670378;50913;0
7491;ENSG00000174521;TTC9B;19;40721965;40724306;2341;0
7492;ENSG00000174628;IQCK;16;19727778;19868907;141129;0
7493;ENSG00000174652;ZNF266;19;9523272;9546254;22982;0
7494;ENSG00000174886;NDUFA11;19;5891287;5904017;12730;0
7495;ENSG00000174917;C19orf70;19;5678432;5680907;2475;0
7496;ENSG00000174938;SEZ6L2;16;29882480;29910868;28388;0
7497;ENSG00000174939;ASPHD1;16;29911696;29931185;19489;0
7498;ENSG00000174943;KCTD13;16;29916333;29938356;22023;0
7499;ENSG00000174951;FUT1;19;49251268;49258647;7379;0
7500;ENSG00000174977;;17;18553508;18554855;1347;0
7501;ENSG00000175061;FAM211A-AS1;17;16342136;16381992;39856;0
7502;ENSG00000175106;TVP23C;17;15341205;15466909;125704;0
7503;ENSG00000175155;YPEL2;17;57409050;57479090;70040;0
7504;ENSG00000175175;PPM1E;17;56833230;57058983;225753;0
7505;ENSG00000175198;PCCA;13;100741269;101182686;441417;0
7506;ENSG00000175221;MED16;19;867962;893218;25256;0
7507;ENSG00000175265;GOLGA8A;15;34671269;34880704;209435;1
7508;ENSG00000175267;VWA3A;16;22103859;22168287;64428;1
7509;ENSG00000175318;GRAMD2;15;72452148;72490126;37978;0
7510;ENSG00000175322;ZNF519;18;14057456;14132489;75033;0
7511;ENSG00000175344;CHRNA7;15;32322691;32464722;142031;0
7512;ENSG00000175354;PTPN2;18;12785477;12929642;144165;0
7513;ENSG00000175387;SMAD2;18;45357922;45457515;99593;0
7514;ENSG00000175595;ERCC4;16;14014014;14046202;32188;0
7515;ENSG00000175643;RMI2;16;11343476;11445619;102143;0
7516;ENSG00000175662;TOM1L2;17;17746828;17875736;128908;0
7517;ENSG00000175691;ZNF77;19;2933216;2944969;11753;0
7518;ENSG00000175711;B3GNTL1;17;80900031;81009686;109655;0
7519;ENSG00000175785;PRIMA1;14;94184644;94254827;70183;0
7520;ENSG00000175820;CCDC168;13;103381801;103389159;7358;0
7521;ENSG00000175826;CTDNEP1;17;7146910;7155810;8900;0
7522;ENSG00000175832;ETV4;17;41605212;41656988;51776;0
7523;ENSG00000175866;BAIAP2;17;79008948;79091232;82284;0
7524;ENSG00000175898;;19;10332111;10333870;1759;0
7525;ENSG00000175906;ARL4D;17;41476327;41478505;2178;0
7526;ENSG00000175911;;17;78977135;78978932;1797;0
7527;ENSG00000175931;UBE2O;17;74385532;74449288;63756;0
7528;ENSG00000175938;ORAI3;16;30960387;30967782;7395;0
7529;ENSG00000175985;PLEKHD1;14;69951409;69995215;43806;0
7530;ENSG00000176014;TUBB6;18;12307668;12344319;36651;0
7531;ENSG00000176024;ZNF613;19;52430400;52452012;21612;0
7532;ENSG00000176105;YES1;18;721588;812547;90959;0
7533;ENSG00000176108;CHMP6;17;78965398;78983317;17919;0
7534;ENSG00000176155;CCDC57;17;80059336;80170706;111370;0
7535;ENSG00000176160;HSF5;17;56497528;56565745;68217;0
7536;ENSG00000176170;SPHK1;17;74372665;74383941;11276;0
7537;ENSG00000176182;MYPOP;19;46393278;46405862;12584;0
7538;ENSG00000176208;ATAD5;17;29158988;29222887;63899;0
7539;ENSG00000176222;ZNF404;19;44376515;44405537;29022;0
7540;ENSG00000176225;RTTN;18;67671029;67873181;202152;0
7541;ENSG00000176371;ZSCAN2;15;85144217;85171027;26810;0
7542;ENSG00000176387;HSD11B2;16;67464555;67471456;6901;0
7543;ENSG00000176390;CRLF3;17;29096406;29151794;55388;0
7544;ENSG00000176396;EID2;19;40028890;40030870;1980;0
7545;ENSG00000176401;EID2B;19;40021630;40023494;1864;0
7546;ENSG00000176438;SYNE3;14;95883831;95942173;58342;0
7547;ENSG00000176454;LPCAT4;15;34651106;34659479;8373;0
7548;ENSG00000176463;SLCO3A1;15;92396925;92715665;318740;0
7549;ENSG00000176472;ZNF575;19;44029649;44040282;10633;0
7550;ENSG00000176473;WDR25;14;100842755;100996640;153885;0
7551;ENSG00000176476;CCDC101;16;28565236;28603111;37875;0
7552;ENSG00000176490;DIRAS1;19;2714565;2721416;6851;0
7553;ENSG00000176531;PHLDB3;19;43979106;44009087;29981;0
7554;ENSG00000176533;GNG7;19;2511217;2702707;191490;1
7555;ENSG00000176563;CNTD1;17;40950810;40963605;12795;0
7556;ENSG00000176619;LMNB2;19;2427636;2456994;29358;0
7557;ENSG00000176624;MEX3C;18;48700920;48744674;43754;0
7558;ENSG00000176641;RNF152;18;59475296;59561480;86184;0
7559;ENSG00000176658;MYO1D;17;30819540;31204195;384655;0
7560;ENSG00000176681;LRRC37A;17;44370099;44415160;45061;0
7561;ENSG00000176700;SCAND2P;15;85174682;85185695;11013;0
7562;ENSG00000176715;ACSF3;16;89154783;89222254;67471;0
7563;ENSG00000176723;ZNF843;16;31445569;31454346;8777;0
7564;ENSG00000176749;CDK5R1;17;30813637;30818274;4637;0
7565;ENSG00000176809;LRRC37A3;17;62850430;62915598;65168;0
7566;ENSG00000176840;MIR7-3HG;19;4769117;4772545;3428;1
7567;ENSG00000176842;IRX5;16;54964774;54968397;3623;0
7568;ENSG00000176845;METRNL;17;81037567;81052864;15297;0
7569;ENSG00000176890;TYMS;18;657604;673578;15974;0
7570;ENSG00000176903;PNMA1;14;74178494;74181128;2634;0
7571;ENSG00000176909;MAMSTR;19;49215999;49222978;6979;0
7572;ENSG00000176912;C18orf56;18;641320;658340;17020;0
7573;ENSG00000176927;EFCAB5;17;28256218;28435470;179252;0
7574;ENSG00000176953;NFATC2IP;16;28962128;28978418;16290;0
7575;ENSG00000176974;SHMT1;17;18231187;18266856;35669;0
7576;ENSG00000176994;SMCR8;17;18218624;18226517;7893;0
7577;ENSG00000177045;SIX5;19;46268043;46272484;4441;0
7578;ENSG00000177051;FBXO46;19;46213887;46234162;20275;0
7579;ENSG00000177082;WDR73;15;85185999;85197574;11575;0
7580;ENSG00000177108;ZDHHC22;14;77597613;77609077;11464;0
7581;ENSG00000177150;FAM210A;18;13663346;13726662;63316;0
7582;ENSG00000177200;CHD9;16;53088945;53363062;274117;0
7583;ENSG00000177302;TOP3A;17;18174742;18218321;43579;0
7584;ENSG00000177303;CASKIN2;17;73496342;73511664;15322;0
7585;ENSG00000177337;DLGAP1-AS1;18;3593730;3598350;4620;1
7586;ENSG00000177370;TIMM22;17;900357;906911;6554;0
7587;ENSG00000177374;HIC1;17;1957448;1962981;5533;0
7588;ENSG00000177380;PPFIA3;19;49622646;49654283;31637;0
7589;ENSG00000177426;TGIF1;18;3411606;3458409;46803;0
7590;ENSG00000177427;MIEF2;17;18163848;18169866;6018;0
7591;ENSG00000177469;PTRF;17;40554470;40575535;21065;1
7592;ENSG00000177508;IRX3;16;54317216;54320675;3459;0
7593;ENSG00000177511;ST8SIA3;18;55018044;55038962;20918;0
7594;ENSG00000177548;RABEP2;16;28915742;28947847;32105;0
7595;ENSG00000177576;C18orf32;18;47008028;47013622;5594;0
7596;ENSG00000177599;ZNF491;19;11908482;11920437;11955;0
7597;ENSG00000177602;GSG2;17;3627211;3630067;2856;0
7598;ENSG00000177728;KIAA0195;17;73437240;73496171;58931;0
7599;ENSG00000177731;FLII;17;18148150;18162230;14080;0
7600;ENSG00000177885;GRB2;17;73314157;73401790;87633;0
7601;ENSG00000177946;CENPBD1;16;90036206;90038942;2736;0
7602;ENSG00000177971;IMP3;15;75931426;75941047;9621;0
7603;ENSG00000178078;STAP2;19;4324040;4342783;18743;0
7604;ENSG00000178081;ULK4P3;15;30395923;30423960;28037;0
7605;ENSG00000178093;TSSK6;19;19623227;19626838;3611;0
7606;ENSG00000178127;NDUFV2;18;9102628;9134343;31715;0
7607;ENSG00000178150;ZNF114;19;48675575;48790865;115290;0
7608;ENSG00000178184;PARD6G;18;77915115;78005429;90314;0
7609;ENSG00000178188;SH2B1;16;28857921;28885526;27605;0
7610;ENSG00000178226;PRSS36;16;31150246;31161415;11169;0
7611;ENSG00000178235;SLITRK1;13;84451344;84456528;5184;0
7612;ENSG00000178307;TMEM11;17;21100593;21117937;17344;0
7613;ENSG00000178386;ZNF223;19;44555520;44572144;16624;0
7614;ENSG00000178404;;17;76866992;76899299;32307;0
7615;ENSG00000178430;;16;3725411;3727060;1649;0
7616;ENSG00000178464;;19;12754089;12754733;644;0
7617;ENSG00000178502;KLHL11;17;40009797;40021684;11887;0
7618;ENSG00000178531;CTXN1;19;7989372;7991051;1679;0
7619;ENSG00000178573;MAF;16;79619740;79634611;14871;0
7620;ENSG00000178607;ERN1;17;62116502;62208179;91677;0
7621;ENSG00000178691;SUZ12;17;30264037;30328064;64027;0
7622;ENSG00000178695;KCTD12;13;77454312;77460540;6228;0
7623;ENSG00000178718;RPP25;15;75246757;75249805;3048;1
7624;ENSG00000178741;COX5A;15;75212132;75230509;18377;0
7625;ENSG00000178761;FAM219B;15;75192328;75199462;7134;0
7626;ENSG00000178773;CPNE7;16;89642176;89663654;21478;0
7627;ENSG00000178802;MPI;15;75182346;75191798;9452;0
7628;ENSG00000178852;EFCAB13;17;45400656;45518678;118022;0
7629;ENSG00000178904;DPY19L3;19;32896449;32976801;80352;1
7630;ENSG00000178921;PFAS;17;8150936;8173809;22873;0
7631;ENSG00000178927;C17orf62;17;80400465;80408705;8240;0
7632;ENSG00000178951;ZBTB7A;19;4044362;4066943;22581;0
7633;ENSG00000178952;TUFM;16;28853732;28857729;3997;0
7634;ENSG00000178971;CTC1;17;8130191;8151362;21171;0
7635;ENSG00000178974;FBXO34;14;55738021;55828636;90615;0
7636;ENSG00000178977;LINC00324;17;8123960;8127361;3401;0
7637;ENSG00000178980;SEPW1;19;48281829;48287943;6114;0
7638;ENSG00000178982;EIF3K;19;39109735;39127595;17860;0
7639;ENSG00000178999;AURKB;17;8108056;8113918;5862;1
7640;ENSG00000179029;TMEM107;17;8076555;8079717;3162;0
7641;ENSG00000179094;PER1;17;8043790;8059824;16034;0
7642;ENSG00000179111;HES7;17;8023908;8027410;3502;0
7643;ENSG00000179115;FARSA;19;13033293;13044851;11558;0
7644;ENSG00000179134;SAMD4B;19;39833036;39876350;43314;0
7645;ENSG00000179148;ALOXE3;17;7999218;8022365;23147;0
7646;ENSG00000179151;EDC3;15;74922899;74988633;65734;0
7647;ENSG00000179168;GGN;19;38874905;38878722;3817;0
7648;ENSG00000179218;CALR;19;13049392;13055303;5911;0
7649;ENSG00000179262;RAD23A;19;13056669;13064456;7787;0
7650;ENSG00000179271;GADD45GIP1;19;13064972;13068050;3078;0
7651;ENSG00000179277;MEIS3P1;17;15689932;15690889;957;0
7652;ENSG00000179284;DAND5;19;13075973;13085567;9594;0
7653;ENSG00000179294;C17orf96;17;36827961;36831187;3226;0
7654;ENSG00000179314;WSCD1;17;5675554;6027747;352193;0
7655;ENSG00000179335;CLK3;15;74890841;74932057;41216;0
7656;ENSG00000179361;ARID3B;15;74833518;74890472;56954;0
7657;ENSG00000179364;PACS2;14;105766900;105864484;97584;0
7658;ENSG00000179399;GPC5;13;92050929;93519490;1468561;0
7659;ENSG00000179409;GEMIN4;17;647654;657239;9585;0
7660;ENSG00000179454;KLHL28;14;45393522;45511525;118003;0
7661;ENSG00000179455;MKRN3;15;23810454;23873064;62610;0
7662;ENSG00000179476;C14orf28;14;45366498;45376460;9962;0
7663;ENSG00000179477;ALOX12B;17;7975954;7991021;15067;0
7664;ENSG00000179523;EIF3J-AS1;15;44819455;44829121;9666;0
7665;ENSG00000179588;ZFPM1;16;88519725;88603424;83699;0
7666;ENSG00000179598;PLD6;17;17104309;17109629;5320;0
7667;ENSG00000179604;CDC42EP4;17;71279763;71308314;28551;0
7668;ENSG00000179627;ZBTB42;14;105266933;105271049;4116;0
7669;ENSG00000179673;RPRML;17;45055523;45056614;1091;0
7670;ENSG00000179761;PIPOX;17;27277531;27384234;106703;0
7671;ENSG00000179820;MYADM;19;54369477;54379691;10214;0
7672;ENSG00000179841;AKAP5;14;64932217;64941221;9004;0
7673;ENSG00000179846;NKPD1;19;45653008;45663408;10400;0
7674;ENSG00000179859;;17;7816642;7819271;2629;0
7675;ENSG00000179889;PDXDC1;16;15068448;15233196;164748;0
7676;ENSG00000179918;SEPHS2;16;30454952;30457502;2550;0
7677;ENSG00000179933;C14orf119;14;23563974;23569665;5691;0
7678;ENSG00000179958;DCTPP1;16;30434940;30441396;6456;0
7679;ENSG00000179965;ZNF771;16;30418618;30440920;22302;0
7680;ENSG00000179981;TSHZ1;18;72922710;73001905;79195;0
7681;ENSG00000180008;SOCS4;14;55493948;55516206;22258;0
7682;ENSG00000180011;ZADH2;18;72907063;72921303;14240;0
7683;ENSG00000180035;ZNF48;16;30389427;30411429;22002;0
7684;ENSG00000180096;01-Sep;16;30389454;30407312;17858;0
7685;ENSG00000180185;FAHD1;16;1876968;1890208;13240;0
7686;ENSG00000180229;HERC2P3;15;20587869;20711433;123564;0
7687;ENSG00000180257;ZNF816;19;53430388;53466164;35776;0
7688;ENSG00000180304;OAZ2;15;64979772;64995480;15708;0
7689;ENSG00000180329;CCDC43;17;42750437;42767147;16710;0
7690;ENSG00000180336;C17orf104;17;42733762;42767676;33914;0
7691;ENSG00000180340;FZD2;17;42634925;42636907;1982;1
7692;ENSG00000180357;ZNF609;15;64752941;64978264;225323;0
7693;ENSG00000180422;LINC00304;16;89225554;89230653;5099;0
7694;ENSG00000180458;;19;38036372;38040073;3701;0
7695;ENSG00000180479;ZNF571;19;38045684;38085673;39989;0
7696;ENSG00000180616;SSTR2;17;71161151;71167185;6034;1
7697;ENSG00000180626;ZNF594;17;5082831;5095178;12347;0
7698;ENSG00000180747;;16;21458004;21531765;73761;0
7699;ENSG00000180855;ZNF443;19;12540521;12551926;11405;0
7700;ENSG00000180884;ZNF792;19;35447258;35454953;7695;0
7701;ENSG00000180891;CUEDC1;17;55938604;56032684;94080;0
7702;ENSG00000180901;KCTD2;17;73028670;73061984;33314;0
7703;ENSG00000180917;CMTR2;16;71315292;71323618;8326;0
7704;ENSG00000180953;ST20;15;80191182;80216044;24862;0
7705;ENSG00000180979;LRRC57;15;42834720;42841000;6280;0
7706;ENSG00000180998;GPR137C;14;53019866;53104431;84565;0
7707;ENSG00000181007;ZFP82;19;36874022;36909558;35536;0
7708;ENSG00000181019;NQO1;16;69740899;69760854;19955;0
7709;ENSG00000181026;AEN;15;89164527;89175513;10986;0
7710;ENSG00000181027;FKRP;19;47249303;47280245;30942;0
7711;ENSG00000181031;RPH3AL;17;62293;236045;173752;0
7712;ENSG00000181035;SLC25A42;19;19174808;19223697;48889;0
7713;ENSG00000181038;METTL23;17;74722912;74730018;7106;0
7714;ENSG00000181045;SLC26A11;17;78193498;78227299;33801;0
7715;ENSG00000181222;POLR2A;17;7387685;7417933;30248;0
7716;ENSG00000181240;SLC25A41;19;6426048;6433790;7742;0
7717;ENSG00000181284;TMEM102;17;7338762;7340998;2236;0
7718;ENSG00000181291;TMEM132E;17;32907768;32966337;58569;0
7719;ENSG00000181350;FAM211A;17;16344891;16395467;50576;0
7720;ENSG00000181392;SYNE4;19;36494209;36499695;5486;0
7721;ENSG00000181396;OGFOD3;17;80347099;80376513;29414;0
7722;ENSG00000181409;AATK;17;79091095;79139877;48782;0
7723;ENSG00000181481;RNF135;17;29295803;29326929;31126;0
7724;ENSG00000181513;ACBD4;17;43209967;43221548;11581;0
7725;ENSG00000181523;SGSH;17;78180515;78194722;14207;0
7726;ENSG00000181588;MEX3D;19;1554668;1568057;13389;0
7727;ENSG00000181610;MRPS23;17;55916842;55927417;10575;0
7728;ENSG00000181619;GPR135;14;59895740;59932060;36320;0
7729;ENSG00000181666;HKR1;19;37803739;37860267;56528;0
7730;ENSG00000181827;RFX7;15;56379478;56535483;156005;0
7731;ENSG00000181896;ZNF101;19;19779605;19794318;14713;0
7732;ENSG00000181938;GINS3;16;58328984;58440048;111064;0
7733;ENSG00000181991;MRPS11;15;89010684;89022222;11538;0
7734;ENSG00000182013;PNMAL1;19;46969748;46974820;5072;0
7735;ENSG00000182040;USH1G;17;72912176;72919351;7175;0
7736;ENSG00000182054;IDH2;15;90626277;90645736;19459;0
7737;ENSG00000182087;TMEM259;19;1009647;1021117;11470;0
7738;ENSG00000182108;DEXI;16;11022748;11036317;13569;0
7739;ENSG00000182117;NOP10;15;34633917;34635378;1461;0
7740;ENSG00000182141;ZNF708;19;21473962;21512227;38265;0
7741;ENSG00000182149;IST1;16;71879899;71962913;83014;0
7742;ENSG00000182173;TSEN54;17;73512141;73520820;8679;0
7743;ENSG00000182175;RGMA;15;93586636;93632433;45797;0
7744;ENSG00000182185;RAD51B;14;68286496;69196935;910439;0
7745;ENSG00000182218;HHIPL1;14;100111447;100146906;35459;0
7746;ENSG00000182224;CYB5D1;17;7761064;7765600;4536;0
7747;ENSG00000182253;SYNM;15;99638420;99675798;37378;0
7748;ENSG00000182256;GABRG3;15;27216429;27778373;561944;0
7749;ENSG00000182264;IZUMO1;19;49244109;49250166;6057;0
7750;ENSG00000182310;SPACA6P;19;52196593;52215640;19047;0
7751;ENSG00000182324;KCNJ14;19;48958766;48969367;10601;0
7752;ENSG00000182376;;16;88809175;88812156;2981;0
7753;ENSG00000182397;DNM1P46;15;100330361;100347132;16771;0
7754;ENSG00000182400;TRAPPC6B;14;39617015;39639736;22721;0
7755;ENSG00000182405;PGBD4;15;34394274;34396591;2317;0
7756;ENSG00000182446;NPLOC4;17;79523913;79615495;91582;0
7757;ENSG00000182473;EXOC7;17;74077087;74117657;40570;0
7758;ENSG00000182481;KPNA2;17;66031635;66042958;11323;0
7759;ENSG00000182512;GLRX5;14;95999840;96011061;11221;0
7760;ENSG00000182534;MXRA7;17;74668633;74707098;38465;0
7761;ENSG00000182575;NXPH3;17;47653220;47661189;7969;0
7762;ENSG00000182601;HS3ST4;16;25703347;26149009;445662;0
7763;ENSG00000182612;TSPAN10;17;79604197;79615779;11582;0
7764;ENSG00000182628;SKA2;17;57187312;57232630;45318;0
7765;ENSG00000182636;NDN;15;23930565;23932450;1885;0
7766;ENSG00000182685;BRICD5;16;2259254;2261951;2697;0
7767;ENSG00000182718;ANXA2;15;60639333;60695082;55749;1
7768;ENSG00000182732;RGS6;14;72399156;73030654;631498;0
7769;ENSG00000182768;NGRN;15;90808891;90816463;7572;0
7770;ENSG00000182809;CRIP2;14;105939299;105946499;7200;0
7771;ENSG00000182810;DDX28;16;68055179;68057770;2591;0
7772;ENSG00000182831;C16orf72;16;9185505;9215497;29992;0
7773;ENSG00000182853;VMO1;17;4688580;4689728;1148;0
7774;ENSG00000182885;GPR97;16;57702099;57723975;21876;0
7775;ENSG00000182950;ODF3L1;15;76016318;76020029;3711;0
7776;ENSG00000182963;GJC1;17;42875816;42908184;32368;0
7777;ENSG00000182968;SOX1;13;112721913;112726020;4107;0
7778;ENSG00000182979;MTA1;14;105886159;105937066;50907;0
7779;ENSG00000182986;ZNF320;19;53367043;53400946;33903;0
7780;ENSG00000183010;PYCR1;17;79890260;79900288;10028;0
7781;ENSG00000183011;LSMD1;17;7760003;7788556;28553;0
7782;ENSG00000183018;SPNS2;17;4402133;4442330;40197;0
7783;ENSG00000183032;SLC25A21;14;37147636;37642071;494435;0
7784;ENSG00000183044;ABAT;16;8768422;8878432;110010;0
7785;ENSG00000183048;SLC25A10;17;79670404;79688042;17638;0
7786;ENSG00000183060;LYSMD4;15;100255902;100273766;17864;0
7787;ENSG00000183077;AFMID;17;76183398;76203782;20384;0
7788;ENSG00000183087;GAS6;13;114523522;114567046;43524;0
7789;ENSG00000183092;BEGAIN;14;101003486;101053750;50264;0
7790;ENSG00000183098;GPC6;13;93879095;95059655;1180560;1
7791;ENSG00000183153;GJD3;17;38517235;38520067;2832;0
7792;ENSG00000183186;C2CD4C;19;405438;409139;3701;0
7793;ENSG00000183196;CHST6;16;75510949;75529282;18333;0
7794;ENSG00000183207;RUVBL2;19;49496705;49519252;22547;0
7795;ENSG00000183208;GDPGP1;15;90777040;90785315;8275;0
7796;ENSG00000183248;;19;7933605;7939326;5721;0
7797;ENSG00000183397;C19orf71;19;3539152;3544028;4876;0
7798;ENSG00000183401;CCDC159;19;11455360;11465620;10260;0
7799;ENSG00000183405;RPS7P1;17;26794814;26795460;646;0
7800;ENSG00000183426;NPIPA1;16;15016659;15045915;29256;0
7801;ENSG00000183454;GRIN2A;16;9852376;10276611;424235;0
7802;ENSG00000183458;;16;15005408;15029565;24157;0
7803;ENSG00000183475;ASB7;15;101142739;101191910;49171;0
7804;ENSG00000183496;MEX3B;15;82334119;82338482;4363;0
7805;ENSG00000183576;SETD3;14;99864083;99947216;83133;0
7806;ENSG00000183578;TNFAIP8L3;15;51348795;51397473;48678;0
7807;ENSG00000183604;;16;30234230;30346695;112465;0
7808;ENSG00000183617;MRPL54;19;3762662;3768573;5911;0
7809;ENSG00000183648;NDUFB1;14;92582466;92588261;5795;0
7810;ENSG00000183655;KLHL25;15;86302554;86338261;35707;0
7811;ENSG00000183684;ALYREF;17;79845713;79849462;3749;0
7812;ENSG00000183688;FAM101B;17;289769;295730;5961;0
7813;ENSG00000183691;NOG;17;54671060;54672951;1891;0
7814;ENSG00000183723;CMTM4;16;66648653;66730610;81957;0
7815;ENSG00000183751;TBL3;16;2022038;2032934;10896;0
7816;ENSG00000183793;NPIPA5;16;15457516;15474904;17388;0
7817;ENSG00000183828;NUDT14;14;105639275;105647660;8385;0
7818;ENSG00000183850;ZNF730;19;23258012;23330021;72009;0
7819;ENSG00000183889;;16;16411301;16444447;33146;0
7820;ENSG00000183914;DNAH2;17;7620672;7737062;116390;0
7821;ENSG00000183978;COA3;17;40947165;40950722;3557;0
7822;ENSG00000183979;NPB;17;79858621;79860781;2160;0
7823;ENSG00000184009;ACTG1;17;79476997;79490873;13876;0
7824;ENSG00000184056;VPS33B;15;91541646;91565833;24187;0
7825;ENSG00000184060;ADAP2;17;29233362;29286340;52978;0
7826;ENSG00000184110;EIF3C;16;28699879;28747051;47172;0
7827;ENSG00000184162;NR2C2AP;19;19312225;19314233;2008;0
7828;ENSG00000184185;KCNJ12;17;21279509;21323179;43670;0
7829;ENSG00000184206;GOLGA6L4;15;84904525;84914120;9595;0
7830;ENSG00000184207;PGP;16;2261998;2264808;2810;0
7831;ENSG00000184226;PCDH9;13;66876967;67804468;927501;0
7832;ENSG00000184227;ACOT1;14;74003818;74010498;6680;0
7833;ENSG00000184277;TM2D3;15;102161847;102192594;30747;0
7834;ENSG00000184304;PRKD1;14;30045687;30661104;615417;0
7835;ENSG00000184451;CCR10;17;40830907;40835935;5028;0
7836;ENSG00000184508;HDDC3;15;91474148;91475799;1651;0
7837;ENSG00000184517;ZFP1;16;75182390;75206134;23744;0
7838;ENSG00000184557;SOCS3;17;76352864;76356158;3294;0
7839;ENSG00000184560;C17orf74;17;7328934;7330887;1953;0
7840;ENSG00000184564;SLITRK6;13;86366925;86373623;6698;0
7841;ENSG00000184602;SNN;16;11762270;11773015;10745;0
7842;ENSG00000184619;KRBA2;17;8271955;8280029;8074;0
7843;ENSG00000184635;ZNF93;19;20011722;20046384;34662;0
7844;ENSG00000184640;09-Sep;17;75276651;75496678;220027;0
7845;ENSG00000184697;CLDN6;16;3064713;3070072;5359;0
7846;ENSG00000184716;SERINC4;15;44086360;44092419;6059;0
7847;ENSG00000184828;ZBTB7C;18;45553044;45937123;384079;0
7848;ENSG00000184857;TMEM186;16;8874241;8891505;17264;0
7849;ENSG00000184886;PIGW;17;34890847;34895159;4312;0
7850;ENSG00000184887;BTBD6;14;105714827;105717430;2603;0
7851;ENSG00000184916;JAG2;14;105607318;105635161;27843;0
7852;ENSG00000184922;FMNL1;17;43298811;43324687;25876;0
7853;ENSG00000184939;ZFP90;16;68563993;68609975;45982;0
7854;ENSG00000184984;CHRM5;15;34260921;34357291;96370;0
7855;ENSG00000184986;TMEM121;14;105992940;105996539;3599;0
7856;ENSG00000184988;TMEM106A;17;41363854;41372061;8207;0
7857;ENSG00000184990;SIVA1;14;105219437;105234831;15394;0
7858;ENSG00000185024;BRF1;14;105675623;105781926;106303;0
7859;ENSG00000185033;SEMA4B;15;90703836;90772911;69075;0
7860;ENSG00000185043;CIB1;15;90773207;90777279;4072;0
7861;ENSG00000185070;FLRT2;14;85996488;86095034;98546;0
7862;ENSG00000185088;RPS27L;15;63418071;63450220;32149;0
7863;ENSG00000185100;ADSSL1;14;105190523;105213662;23139;0
7864;ENSG00000185115;NDNL2;15;29560353;29562033;1680;0
7865;ENSG00000185128;TBC1D3F;17;36283971;36294915;10944;0
7866;ENSG00000185158;LRRC37B;17;30334891;30380523;45632;0
7867;ENSG00000185164;NOMO2;16;18511182;18573533;62351;0
7868;ENSG00000185215;TNFAIP2;14;103589779;103603776;13997;0
7869;ENSG00000185236;RAB11B;19;8454865;8469318;14453;0
7870;ENSG00000185246;PRPF39;14;45553302;45585485;32183;0
7871;ENSG00000185262;UBALD2;17;74261283;74267375;6092;0
7872;ENSG00000185298;CCDC137;17;79633394;79640934;7540;0
7873;ENSG00000185324;CDK10;16;89747145;89762772;15627;0
7874;ENSG00000185332;TMEM105;17;79285074;79304474;19400;0
7875;ENSG00000185347;C14orf80;14;105956192;105965912;9720;0
7876;ENSG00000185352;HS6ST3;13;96743093;97485671;742578;1
7877;ENSG00000185359;HGS;17;79650356;79670168;19812;0
7878;ENSG00000185361;TNFAIP8L1;19;4639530;4655580;16050;0
7879;ENSG00000185379;RAD51D;17;33426811;33448541;21730;0
7880;ENSG00000185418;TARSL2;15;102193801;102264807;71006;0
7881;ENSG00000185442;FAM174B;15;93160673;93353114;192441;0
7882;ENSG00000185453;C19orf68;19;48673949;48700877;26928;0
7883;ENSG00000185504;C17orf70;17;79506911;79520987;14076;0
7884;ENSG00000185518;SV2B;15;91643180;91844539;201359;0
7885;ENSG00000185527;PDE6G;17;79617489;79630142;12653;0
7886;ENSG00000185551;NR2F2;15;96869167;96883492;14325;0
7887;ENSG00000185559;DLK1;14;101192042;101201539;9497;0
7888;ENSG00000185561;TLCD2;17;1611064;1613732;2668;0
7889;ENSG00000185567;AHNAK2;14;105403581;105444694;41113;0
7890;ENSG00000185594;SPATA8;15;97326619;97328845;2226;0
7891;ENSG00000185596;WASH3P;15;102501356;102516768;15412;0
7892;ENSG00000185615;PDIA2;16;333152;337215;4063;0
7893;ENSG00000185624;P4HB;17;79801035;79818570;17535;0
7894;ENSG00000185634;SHC4;15;49115932;49255641;139709;0
7895;ENSG00000185650;ZFP36L1;14;69254377;69263190;8813;0
7896;ENSG00000185716;C16orf52;16;22018959;22098855;79896;0
7897;ENSG00000185722;ANKFY1;17;4067201;4167274;100073;0
7898;ENSG00000185739;SRL;16;4239375;4292081;52706;0
7899;ENSG00000185787;MORF4L1;15;79102829;79190475;87646;0
7900;ENSG00000185800;DMWD;19;46286205;46296060;9855;0
7901;ENSG00000185813;PCYT2;17;79858841;79869340;10499;0
7902;ENSG00000185823;NPAP1;15;24920541;24928593;8052;0
7903;ENSG00000185829;ARL17A;17;44594068;44657088;63020;0
7904;ENSG00000185864;NPIPB4;16;21845890;21892148;46258;0
7905;ENSG00000185869;ZNF829;19;37379026;37407193;28167;0
7906;ENSG00000185880;TRIM69;15;45021186;45060027;38841;0
7907;ENSG00000185883;ATP6V0C;16;2563871;2570219;6348;0
7908;ENSG00000185896;LAMP1;13;113951556;113977987;26431;0
7909;ENSG00000185924;RTN4RL1;17;1837971;1928639;90668;0
7910;ENSG00000185928;PAGR1;16;29827285;29841948;14663;0
7911;ENSG00000185947;ZNF267;16;31885079;31928668;43589;0
7912;ENSG00000185950;IRS2;13;110406184;110438915;32731;0
7913;ENSG00000185988;PLK5;19;1524073;1535455;11382;0
7914;ENSG00000185989;RASA3;13;114747194;114898086;150892;0
7915;ENSG00000186010;NDUFA13;19;19626545;19644285;17740;0
7916;ENSG00000186017;ZNF566;19;36936021;36980804;44783;0
7917;ENSG00000186019;;19;44609616;44617298;7682;0
7918;ENSG00000186020;ZNF529;19;37025676;37096178;70502;0
7919;ENSG00000186026;ZNF284;19;44576297;44593766;17469;0
7920;ENSG00000186073;C15orf41;15;36871812;37102449;230637;0
7921;ENSG00000186111;PIP5K1C;19;3630181;3700477;70296;0
7922;ENSG00000186153;WWOX;16;78133310;79246564;1113254;0
7923;ENSG00000186185;KIF18B;17;43002077;43025082;23005;1
7924;ENSG00000186187;ZNRF1;16;75032928;75144892;111964;0
7925;ENSG00000186198;SLC51B;15;65337708;65345734;8026;0
7926;ENSG00000186260;MKL2;16;14165178;14360630;195452;0
7927;ENSG00000186297;GABRA5;15;27111510;27194354;82844;0
7928;ENSG00000186300;ZNF555;19;2841433;2860482;19049;0
7929;ENSG00000186322;GOLGA6L17P;15;82804003;82810874;6871;0
7930;ENSG00000186326;RGS9BP;19;33166313;33169206;2893;0
7931;ENSG00000186369;LINC00643;14;62584197;62596352;12155;0
7932;ENSG00000186395;KRT10;17;38974369;38978847;4478;0
7933;ENSG00000186399;GOLGA8R;15;30695943;30706463;10520;0
7934;ENSG00000186417;GLDN;15;51633826;51700210;66384;0
7935;ENSG00000186469;GNG2;14;52292913;52446060;153147;0
7936;ENSG00000186496;ZNF396;18;32946661;32957301;10640;0
7937;ENSG00000186532;SMYD4;17;1682779;1733928;51149;0
7938;ENSG00000186566;GPATCH8;17;42472652;42580798;108146;0
7939;ENSG00000186567;CEACAM19;19;45165545;45187631;22086;0
7940;ENSG00000186594;MIR22HG;17;1614805;1620468;5663;0
7941;ENSG00000186615;KTN1-AS1;14;55965996;56046828;80832;0
7942;ENSG00000186648;LRRC16B;14;24521206;24538937;17731;0
7943;ENSG00000186665;C17orf58;17;65987217;65989765;2548;0
7944;ENSG00000186765;FSCN2;17;79495422;79504156;8734;0
7945;ENSG00000186806;VSIG10L;19;51834790;51845378;10588;0
7946;ENSG00000186812;ZNF397;18;32820994;32847097;26103;0
7947;ENSG00000186814;ZSCAN30;18;32831032;32870196;39164;0
7948;ENSG00000186834;HEXIM1;17;43224684;43229468;4784;0
7949;ENSG00000186868;MAPT;17;43971748;44105700;133952;0
7950;ENSG00000186994;KANK3;19;8387468;8408146;20678;0
7951;ENSG00000187097;ENTPD5;14;74424713;74486102;61389;0
7952;ENSG00000187105;HEATR4;14;73945189;74025651;80462;0
7953;ENSG00000187187;ZNF546;19;40490041;40523514;33473;0
7954;ENSG00000187244;BCAM;19;45312328;45324673;12345;0
7955;ENSG00000187266;EPOR;19;11488236;11495018;6782;0
7956;ENSG00000187323;DCC;18;49866542;51057784;1191242;0
7957;ENSG00000187446;CHP1;15;41523037;41574043;51006;0
7958;ENSG00000187456;RDM1;17;34245070;34257777;12707;0
7959;ENSG00000187498;COL4A1;13;110801318;110959496;158178;1
7960;ENSG00000187531;SIRT7;17;79869815;79879199;9384;0
7961;ENSG00000187534;;19;40448563;40449634;1071;0
7962;ENSG00000187535;IFT140;16;1560428;1662111;101683;0
7963;ENSG00000187555;USP7;16;8985951;9058371;72420;0
7964;ENSG00000187556;NANOS3;19;13972877;13991571;18694;0
7965;ENSG00000187595;ZNF385C;17;40177594;40217383;39789;0
7966;ENSG00000187607;;17;15602891;15640874;37983;0
7967;ENSG00000187624;C17orf97;17;260118;273510;13392;1
7968;ENSG00000187630;DHRS4L2;14;24439148;24475617;36469;0
7969;ENSG00000187650;VMAC;19;5904869;5910864;5995;0
7970;ENSG00000187667;WHAMMP3;15;23187728;23208737;21009;0
7971;ENSG00000187720;THSD4;15;71389291;72075722;686431;0
7972;ENSG00000187741;FANCA;16;89803957;89883065;79108;0
7973;ENSG00000187773;FAM69C;18;72102963;72125179;22216;0
7974;ENSG00000187790;FANCM;14;45605143;45670093;64950;0
7975;ENSG00000187838;TMEM256-PLSCR3;17;7293046;7307416;14370;0
7976;ENSG00000187867;PALM3;19;14164177;14169971;5794;0
7977;ENSG00000187870;RNFT1P3;17;20646646;20657814;11168;0
7978;ENSG00000187951;ARHGAP11B;15;30916697;31065196;148499;0
7979;ENSG00000187959;CPSF4L;17;71244588;71258491;13903;0
7980;ENSG00000187994;RINL;19;39358470;39368919;10449;0
7981;ENSG00000188013;MEIS3P2;17;20492371;20494013;1642;0
7982;ENSG00000188033;ZNF490;19;12688775;12750912;62137;0
7983;ENSG00000188039;NWD1;19;16830787;16928774;97987;0
7984;ENSG00000188051;TMEM221;19;17546318;17559376;13058;0
7985;ENSG00000188171;ZNF626;19;20802867;20844402;41535;0
7986;ENSG00000188176;SMTNL2;17;4487294;4511614;24320;0
7987;ENSG00000188215;DCUN1D3;16;20866247;20911706;45459;0
7988;ENSG00000188227;ZNF793;19;37997841;38039664;41823;0
7989;ENSG00000188243;COMMD6;13;76099350;76123575;24225;0
7990;ENSG00000188266;HYKK;15;78799906;78829714;29808;0
7991;ENSG00000188277;C15orf62;15;41062159;41064643;2484;0
7992;ENSG00000188283;ZNF383;19;37708828;37734828;26000;0
7993;ENSG00000188321;ZNF559;19;9434448;9461838;27390;0
7994;ENSG00000188322;SBK1;16;28303840;28335170;31330;0
7995;ENSG00000188368;PRR19;19;42806250;42814973;8723;0
7996;ENSG00000188388;GOLGA6L3;15;85783703;85790410;6707;0
7997;ENSG00000188493;C19orf54;19;41246761;41257458;10697;0
7998;ENSG00000188501;LCTL;15;66839517;66858317;18800;0
7999;ENSG00000188522;FAM83G;17;18872102;18908117;36015;1
8000;ENSG00000188549;C15orf52;15;40623653;40633168;9515;0
8001;ENSG00000188554;NBR1;17;41322498;41363708;41210;0
8002;ENSG00000188599;NPIPP1;16;15198178;15225458;27280;0
8003;ENSG00000188603;CLN3;16;28477983;28506896;28913;0
8004;ENSG00000188612;SUMO2;17;73163408;73179078;15670;0
8005;ENSG00000188659;FAM154B;15;82555151;82577271;22120;0
8006;ENSG00000188766;SPRED3;19;38879061;38886881;7820;0
8007;ENSG00000188779;SKOR1;15;68112042;68126899;14857;1
8008;ENSG00000188825;LINC00910;17;41447213;41466567;19354;0
8009;ENSG00000188827;SLX4;16;3631182;3661599;30417;0
8010;ENSG00000188868;ZNF563;19;12428291;12444534;16243;0
8011;ENSG00000188869;TMC3;15;81623558;81666554;42996;0
8012;ENSG00000188878;FBF1;17;73905655;73937221;31566;0
8013;ENSG00000188888;GPR179;17;36481413;36499730;18317;0
8014;ENSG00000188895;MSL1;17;38278551;38293042;14491;0
8015;ENSG00000188897;;16;11453702;11617444;163742;0
8016;ENSG00000188985;DHFRP1;18;23749724;23751313;1589;0
8017;ENSG00000189042;ZNF567;19;37178514;37218603;40089;0
8018;ENSG00000189050;RNFT1;17;58029601;58042122;12521;0
8019;ENSG00000189067;LITAF;16;11641853;11730237;88384;0
8020;ENSG00000189091;SF3B3;16;70557691;70608820;51129;0
8021;ENSG00000189114;BLOC1S3;19;45682003;45685059;3056;0
8022;ENSG00000189120;SP6;17;45922279;45933240;10961;0
8023;ENSG00000189136;UBE2Q2P1;15;85070012;85114447;44435;0
8024;ENSG00000189144;ZNF573;19;38226734;38307940;81206;0
8025;ENSG00000189159;HN1;17;73131343;73164376;33033;0
8026;ENSG00000189164;ZNF527;19;37861963;37883968;22005;0
8027;ENSG00000189190;ZNF600;19;53267448;53290044;22596;0
8028;ENSG00000189227;C15orf61;15;67813406;67819628;6222;0
8029;ENSG00000189343;RPS2P46;17;19349246;19350169;923;0
8030;ENSG00000189423;USP32P3;17;20318860;20334321;15461;1
8031;ENSG00000196081;ZNF724P;19;23404401;23433192;28791;0
8032;ENSG00000196110;ZNF699;19;9404951;9420514;15563;0
8033;ENSG00000196118;C16orf93;16;30768744;30774031;5287;0
8034;ENSG00000196123;KIAA0895L;16;67209505;67217943;8438;0
8035;ENSG00000196155;PLEKHG4;16;67311413;67323402;11989;0
8036;ENSG00000196172;ZNF681;19;23921997;23941693;19696;0
8037;ENSG00000196214;ZNF766;19;52772824;52795977;23153;0
8038;ENSG00000196218;RYR1;19;38924339;39078204;153865;0
8039;ENSG00000196235;SUPT5H;19;39926796;39967310;40514;0
8040;ENSG00000196267;ZNF836;19;52657117;52674896;17779;0
8041;ENSG00000196268;ZNF493;19;21579921;21610375;30454;0
8042;ENSG00000196296;ATP2A1;16;28889726;28915830;26104;0
8043;ENSG00000196357;ZNF565;19;36673188;36737159;63971;0
8044;ENSG00000196361;ELAVL3;19;11562141;11591861;29720;0
8045;ENSG00000196365;LONP1;19;5691845;5720583;28738;0
8046;ENSG00000196381;ZNF781;19;38158652;38183223;24571;0
8047;ENSG00000196388;INCA1;17;4891425;4900905;9480;0
8048;ENSG00000196391;ZNF774;15;90895477;90909324;13847;0
8049;ENSG00000196405;EVL;14;100437786;100610573;172787;0
8050;ENSG00000196408;NOXO1;16;2028918;2034193;5275;0
8051;ENSG00000196417;ZNF765;19;53893046;53930574;37528;0
8052;ENSG00000196436;NPIPB15;16;74411776;74425978;14202;0
8053;ENSG00000196437;ZNF569;19;37902057;37960177;58120;0
8054;ENSG00000196466;ZNF799;19;12500830;12512085;11255;0
8055;ENSG00000196470;SIAH1;16;48390275;48482313;92038;0
8056;ENSG00000196497;IPO4;14;24649425;24658170;8745;0
8057;ENSG00000196535;MYO18A;17;27400528;27507430;106902;0
8058;ENSG00000196544;C17orf59;17;8091652;8093564;1912;0
8059;ENSG00000196547;MAN2A2;15;91445448;91465814;20366;0
8060;ENSG00000196557;CACNA1H;16;1203241;1271771;68530;0
8061;ENSG00000196605;ZNF846;19;9862669;9903856;41187;0
8062;ENSG00000196628;TCF4;18;52889562;53332018;442456;0
8063;ENSG00000196646;ZNF136;19;12273879;12300064;26185;0
8064;ENSG00000196648;GOLGA6L20;15;83098710;83108085;9375;0
8065;ENSG00000196663;TECPR2;14;102829300;102968818;139518;0
8066;ENSG00000196674;;16;653555;653904;349;0
8067;ENSG00000196678;ERI2;16;20791515;20911671;120156;0
8068;ENSG00000196689;TRPV1;17;3468738;3500392;31654;0
8069;ENSG00000196696;PDXDC2P;16;70010200;70099851;89651;0
8070;ENSG00000196704;AMZ2;17;66243715;66253297;9582;0
8071;ENSG00000196705;ZNF431;19;21324827;21373034;48207;0
8072;ENSG00000196712;NF1;17;29421945;29709134;287189;0
8073;ENSG00000196757;ZNF700;19;12035883;12061588;25705;0
8074;ENSG00000196792;STRN3;14;31363005;31495607;132602;0
8075;ENSG00000196943;NOP9;14;24769068;24778330;9262;0
8076;ENSG00000196961;AP2A1;19;50270225;50310370;40145;0
8077;ENSG00000196967;ZNF585A;19;37597636;37663643;66007;0
8078;ENSG00000197006;METTL9;16;21608539;21668794;60255;0
8079;ENSG00000197013;ZNF429;19;21679484;21739072;59588;0
8080;ENSG00000197019;SERTAD1;19;40927499;40931932;4433;0
8081;ENSG00000197020;ZNF100;19;21905568;21950430;44862;0
8082;ENSG00000197044;ZNF441;19;11877815;11894893;17078;0
8083;ENSG00000197045;GMFB;14;54941202;54955914;14712;0
8084;ENSG00000197050;ZNF420;19;37498759;37621216;122457;0
8085;ENSG00000197054;ZNF763;19;12035890;12091196;55306;0
8086;ENSG00000197063;MAFG;17;79876146;79885590;9444;0
8087;ENSG00000197102;DYNC1H1;14;102430865;102517129;86264;0
8088;ENSG00000197119;SLC25A29;14;100757448;100772884;15436;0
8089;ENSG00000197124;ZNF682;19;20107867;20150315;42448;0
8090;ENSG00000197162;ZNF785;16;30585061;30597092;12031;0
8091;ENSG00000197170;PSMD12;17;65334032;65362743;28711;0
8092;ENSG00000197256;KANK2;19;11274943;11308467;33524;0
8093;ENSG00000197291;RAMP2-AS1;17;40905932;40913275;7343;0
8094;ENSG00000197299;BLM;15;91260558;91358859;98301;0
8095;ENSG00000197302;ZNF720;16;31724550;31806190;81640;0
8096;ENSG00000197322;C17orf102;17;32901142;32906388;5246;0
8097;ENSG00000197324;LRP10;14;23340822;23350789;9967;0
8098;ENSG00000197332;ZNF833P;19;11750591;11797382;46791;0
8099;ENSG00000197361;FBXL22;15;63889552;63894627;5075;0
8100;ENSG00000197372;ZNF675;19;23708433;23870022;161589;0
8101;ENSG00000197380;DACT3;19;47150869;47164395;13526;0
8102;ENSG00000197405;C5AR1;19;47793280;47825323;32043;0
8103;ENSG00000197406;DIO3;14;102027688;102029789;2101;0
8104;ENSG00000197417;SHPK;17;3511556;3539616;28060;0
8105;ENSG00000197445;C16orf47;16;73160536;73178346;17810;0
8106;ENSG00000197497;ZNF665;19;53662466;53696639;34173;1
8107;ENSG00000197535;MYO5A;15;52599480;52821247;221767;0
8108;ENSG00000197540;GZMM;19;544034;549919;5885;0
8109;ENSG00000197555;SIPA1L1;14;71787166;72207946;420780;0
8110;ENSG00000197562;RAB40C;16;639357;679272;39915;0
8111;ENSG00000197563;PIGN;18;59710800;59854351;143551;0
8112;ENSG00000197566;ZNF624;17;16524051;16557170;33119;0
8113;ENSG00000197599;CCDC154;16;1484384;1494557;10173;0
8114;ENSG00000197608;ZNF841;19;52567719;52599018;31299;0
8115;ENSG00000197619;ZNF615;19;52494585;52511483;16898;0
8116;ENSG00000197647;ZNF433;19;12125547;12146556;21009;0
8117;ENSG00000197681;TBC1D3;17;36337711;36358166;20455;0
8118;ENSG00000197696;NMB;15;85198360;85201794;3434;0
8119;ENSG00000197705;KLHL14;18;30252634;30353025;100391;0
8120;ENSG00000197766;CFD;19;859453;863453;4000;0
8121;ENSG00000197774;EME2;16;1823208;1831709;8501;0
8122;ENSG00000197776;KLHDC1;14;50159823;50219870;60047;0
8123;ENSG00000197782;ZNF780A;19;40575059;40596845;21786;0
8124;ENSG00000197808;ZNF461;19;37128094;37157755;29661;0
8125;ENSG00000197813;;19;49834874;49843865;8991;0
8126;ENSG00000197841;ZNF181;19;35225060;35233777;8717;0
8127;ENSG00000197857;ZNF44;19;12335501;12405702;70201;0
8128;ENSG00000197863;ZNF790;19;37308330;37341689;33359;0
8129;ENSG00000197879;MYO1C;17;1367392;1396106;28714;0
8130;ENSG00000197912;SPG7;16;89557325;89624176;66851;0
8131;ENSG00000197928;ZNF677;19;53731577;53758151;26574;0
8132;ENSG00000197930;ERO1L;14;53106634;53162618;55984;0
8133;ENSG00000197933;ZNF823;19;11832080;11849824;17744;0
8134;ENSG00000197937;ZNF347;19;53627325;53662328;35003;0
8135;ENSG00000197943;PLCG2;16;81772702;81991899;219197;0
8136;ENSG00000197961;ZNF121;19;9671029;9695209;24180;0
8137;ENSG00000197971;MBP;18;74690783;74845639;154856;0
8138;ENSG00000197991;PCDH20;13;61983818;62002220;18402;0
8139;ENSG00000198003;CCDC151;19;11531272;11546603;15331;1
8140;ENSG00000198028;ZNF560;19;9577183;9609283;32100;1
8141;ENSG00000198081;ZBTB14;18;5289018;5297052;8034;0
8142;ENSG00000198093;ZNF649;19;52392477;52408293;15816;0
8143;ENSG00000198133;TMEM229B;14;67913801;68000456;86655;0
8144;ENSG00000198146;ZNF770;15;35270542;35280488;9946;0
8145;ENSG00000198150;;17;8261731;8263538;1807;0
8146;ENSG00000198156;NPIPB6;16;28353876;28374829;20953;0
8147;ENSG00000198176;TFDP1;13;114239013;114295785;56772;0
8148;ENSG00000198182;ZNF607;19;38187264;38210691;23427;0
8149;ENSG00000198208;RPS6KL1;14;75370657;75390099;19442;0
8150;ENSG00000198231;DDX42;17;61850963;61896677;45714;0
8151;ENSG00000198242;RPL23A;17;27046411;27051377;4966;0
8152;ENSG00000198252;STYX;14;53196898;53241716;44818;0
8153;ENSG00000198258;UBL5;19;9938568;9940791;2223;0
8154;ENSG00000198265;HELZ;17;65066554;65242105;175551;0
8155;ENSG00000198342;ZNF442;19;12460185;12476719;16534;1
8156;ENSG00000198346;ZNF813;19;53970989;54006950;35961;0
8157;ENSG00000198356;ASNA1;19;12847953;12859137;11184;0
8158;ENSG00000198373;WWP2;16;69796209;69975644;179435;0
8159;ENSG00000198417;MT1F;16;56691606;56694610;3004;0
8160;ENSG00000198429;ZNF69;19;11998599;12025144;26545;0
8161;ENSG00000198453;ZNF568;19;37407231;37489602;82371;0
8162;ENSG00000198464;ZNF480;19;52800430;52829175;28745;0
8163;ENSG00000198482;ZNF808;19;53030905;53067717;36812;0
8164;ENSG00000198496;NBR2;17;41277627;41305688;28061;0
8165;ENSG00000198513;ATL1;14;50999227;51099786;100559;0
8166;ENSG00000198521;ZNF43;19;21987752;22034927;47175;0
8167;ENSG00000198538;ZNF28;19;53300662;53360853;60191;0
8168;ENSG00000198542;ITGBL1;13;102104966;102375456;270490;0
8169;ENSG00000198551;ZNF627;19;11670189;11729950;59761;0
8170;ENSG00000198554;WDHD1;14;55405668;55493823;88155;0
8171;ENSG00000198555;;16;33778506;33790097;11591;0
8172;ENSG00000198597;ZNF536;19;30719197;31204445;485248;0
8173;ENSG00000198604;BAZ1A;14;35221937;35344853;122916;0
8174;ENSG00000198633;ZNF534;19;52932440;52955568;23128;0
8175;ENSG00000198668;CALM1;14;90862846;90874605;11759;0
8176;ENSG00000198690;FAN1;15;31196055;31235311;39256;0
8177;ENSG00000198718;FAM179B;14;45431411;45543634;112223;0
8178;ENSG00000198720;ANKRD13B;17;27916787;27941779;24992;0
8179;ENSG00000198723;C19orf45;19;7557862;7573336;15474;0
8180;ENSG00000198732;SMOC1;14;70320848;70499083;178235;0
8181;ENSG00000198736;MSRB1;16;1988211;1993327;5116;0
8182;ENSG00000198740;ZNF652;17;47366568;47439835;73267;0
8183;ENSG00000198752;CDC42BPB;14;103398716;103523799;125083;0
8184;ENSG00000198783;ZNF830;17;33288549;33290205;1656;0
8185;ENSG00000198794;SCAMP5;15;75249560;75313837;64277;0
8186;ENSG00000198795;ZNF521;18;22641890;22932154;290264;0
8187;ENSG00000198796;ALPK2;18;56148479;56296189;147710;0
8188;ENSG00000198805;PNP;14;20937113;20945253;8140;0
8189;ENSG00000198816;ZNF358;19;7580178;7585912;5734;0
8190;ENSG00000198824;CHAMP1;13;115079988;115092796;12808;0
8191;ENSG00000198826;ARHGAP11A;15;32907345;32932150;24805;0
8192;ENSG00000198838;RYR3;15;33603163;34158303;555140;1
8193;ENSG00000198858;R3HDM4;19;896503;913240;16737;0
8194;ENSG00000198863;RUNDC1;17;41132582;41145707;13125;0
8195;ENSG00000198894;CIPC;14;77564440;77583630;19190;0
8196;ENSG00000198901;PRC1;15;91509270;91538859;29589;1
8197;ENSG00000198909;MAP3K3;17;61699775;61773663;73888;0
8198;ENSG00000198920;KIAA0753;17;6481468;6544247;62779;0
8199;ENSG00000198931;APRT;16;88875747;88878352;2605;0
8200;ENSG00000198933;TBKBP1;17;45771447;45789416;17969;0
8201;ENSG00000199804;RNA5SP383;14;24627812;24627931;119;0
8202;ENSG00000199833;SNORD115-21;15;25453230;25453310;80;0
8203;ENSG00000199977;;18;19397585;19397789;204;0
8204;ENSG00000200120;;15;49429959;49430060;101;0
8205;ENSG00000200237;;19;9930630;9930770;140;0
8206;ENSG00000201136;RNU6-353P;15;43994561;43994668;107;0
8207;ENSG00000201700;SNORD113-3;14;101396256;101396328;72;1
8208;ENSG00000201969;SNORD115-20;15;25451409;25451490;81;0
8209;ENSG00000202337;RNU6-8;14;32672369;32672475;106;0
8210;ENSG00000203326;ZNF525;19;53868946;53895470;26524;0
8211;ENSG00000203392;;15;75970672;75973093;2421;0
8212;ENSG00000203401;;16;67466595;67468931;2336;0
8213;ENSG00000203403;;19;35628549;35630484;1935;0
8214;ENSG00000203441;LINC00449;13;100151981;100153306;1325;0
8215;ENSG00000203485;INF2;14;105155943;105185942;29999;0
8216;ENSG00000203546;;14;31803518;31926647;123129;0
8217;ENSG00000204237;OXLD1;17;79632066;79633665;1599;0
8218;ENSG00000204316;MRPL38;17;73894724;73905899;11175;0
8219;ENSG00000204323;SMIM5;17;73629514;73637484;7970;0
8220;ENSG00000204347;BTBD17;17;72352555;72358085;5530;0
8221;ENSG00000204442;FAM155A;13;107820883;108519083;698200;0
8222;ENSG00000204604;ZNF468;19;53341261;53360902;19641;0
8223;ENSG00000204611;ZNF616;19;52616344;52643175;26831;0
8224;ENSG00000204650;CRHR1-IT1;17;43697694;43725582;27888;0
8225;ENSG00000204666;;19;50553846;50570050;16204;0
8226;ENSG00000204673;AKT1S1;19;50372295;50381716;9421;0
8227;ENSG00000204815;TTC25;17;40086888;40117648;30760;0
8228;ENSG00000204851;PNMAL2;19;46990163;46999755;9592;0
8229;ENSG00000204869;IGFL4;19;46543006;46580376;37370;0
8230;ENSG00000204899;MZT1;13;73282495;73301825;19330;0
8231;ENSG00000204920;ZNF155;19;44472014;44502477;30463;0
8232;ENSG00000204991;SPIRE2;16;89884587;89937727;53140;0
8233;ENSG00000205018;;16;89006197;89017932;11735;0
8234;ENSG00000205041;;19;40779396;40781386;1990;0
8235;ENSG00000205047;;16;87731749;87739290;7541;0
8236;ENSG00000205078;SYCE1L;16;77233294;77247112;13818;0
8237;ENSG00000205084;TMEM231;16;75572015;75590184;18169;0
8238;ENSG00000205138;SDHAF1;19;36486090;36487220;1130;0
8239;ENSG00000205155;PSENEN;19;36236015;36237911;1896;0
8240;ENSG00000205209;SCGB2B2;19;35084234;35166604;82370;0
8241;ENSG00000205212;CCDC144NL;17;20739760;20799453;59693;1
8242;ENSG00000205217;FAM106B;17;20320741;20322363;1622;0
8243;ENSG00000205220;PSMB10;16;67968405;67970990;2585;0
8244;ENSG00000205246;RPSAP58;19;23945807;24010937;65130;0
8245;ENSG00000205250;E2F4;16;67226072;67232821;6749;0
8246;ENSG00000205275;CSPG4P9;15;82970479;82988374;17895;0
8247;ENSG00000205281;GOLGA6L10;15;82635130;82641706;6576;0
8248;ENSG00000205309;NT5M;17;17206649;17250977;44328;0
8249;ENSG00000205336;GPR56;16;57644564;57698944;54380;0
8250;ENSG00000205363;C15orf59;15;74032141;74045088;12947;0
8251;ENSG00000205423;CNEP1R1;16;50058321;50070999;12678;0
8252;ENSG00000205476;CCDC85C;14;99977603;100070363;92760;0
8253;ENSG00000205534;;16;29538889;29606395;67506;0
8254;ENSG00000205544;TMEM256;17;7306294;7307456;1162;0
8255;ENSG00000205562;;14;85991477;85996332;4855;0
8256;ENSG00000205609;EIF3CL;16;28390900;28415200;24300;0
8257;ENSG00000205629;LCMT1;16;25123050;25189552;66502;0
8258;ENSG00000205659;LIN52;14;74551499;74667936;116437;0
8259;ENSG00000205683;DPF3;14;73086004;73360809;274805;0
8260;ENSG00000205710;C17orf107;17;4802713;4806227;3514;0
8261;ENSG00000205730;ITPRIPL2;16;19125254;19132946;7692;1
8262;ENSG00000205746;;16;18428257;18488396;60139;0
8263;ENSG00000205771;CATSPER2P1;15;44019116;44039292;20176;0
8264;ENSG00000205832;C16orf96;16;4606491;4650715;44224;0
8265;ENSG00000205871;RPS3AP47;15;43407897;43408691;794;0
8266;ENSG00000205913;SRRM2-AS1;16;2787077;2802601;15524;0
8267;ENSG00000205922;ONECUT3;19;1752372;1780987;28615;0
8268;ENSG00000205937;RNPS1;16;2303117;2318413;15296;0
8269;ENSG00000205978;NYNRIN;14;24867992;24888494;20502;0
8270;ENSG00000206052;DOK6;18;67068291;67516323;448032;0
8271;ENSG00000206053;HN1L;16;1728257;1752281;24024;0
8272;ENSG00000206082;LINC01002;19;200460;205074;4614;0
8273;ENSG00000206127;GOLGA8O;15;32737307;32747835;10528;0
8274;ENSG00000206149;HERC2P9;15;28834638;28930410;95772;0
8275;ENSG00000206418;RAB12;18;8609443;8639379;29936;0
8276;ENSG00000206432;TMEM200C;18;5882071;5895954;13883;0
8277;ENSG00000206674;RNU6-945P;19;40805385;40805491;106;0
8278;ENSG00000206859;RNU6-767P;17;17073397;17073503;106;0
8279;ENSG00000206991;RNU6-610P;15;43929830;43929936;106;0
8280;ENSG00000207001;SNORD116-2;15;25299357;25299451;94;0
8281;ENSG00000207003;RNU6-611P;19;45550716;45550819;103;0
8282;ENSG00000207063;SNORD116-1;15;25296624;25296718;94;0
8283;ENSG00000207133;SNORD116-7;15;25312935;25313029;94;0
8284;ENSG00000207279;SNORD116-24;15;25339184;25339275;91;0
8285;ENSG00000207342;;14;89306509;89306607;98;0
8286;ENSG00000207357;RNU6-2;19;1021521;1021627;106;0
8287;ENSG00000207425;;16;15009314;15009413;99;0
8288;ENSG00000207442;SNORD116-6;15;25310173;25310268;95;0
8289;ENSG00000207561;MIR635;17;66420592;66420689;97;0
8290;ENSG00000207585;MIR181D;19;13985689;13985825;136;0
8291;ENSG00000207631;MIR641;19;40788450;40788548;98;0
8292;ENSG00000207636;MIR631;15;75645952;75646026;74;0
8293;ENSG00000207964;MIR628;15;55665138;55665232;94;1
8294;ENSG00000211448;DIO2;14;80663873;80854100;190227;0
8295;ENSG00000211574;MIR770;14;101318727;101318824;97;0
8296;ENSG00000211829;TRDC;14;22931924;22934779;2855;0
8297;ENSG00000212123;PRR22;19;5782971;5784776;1805;0
8298;ENSG00000212380;SNORD115-45;15;25509657;25509737;80;0
8299;ENSG00000212664;;15;71633466;71634086;620;0
8300;ENSG00000212719;C17orf51;17;21428051;21477722;49671;0
8301;ENSG00000212766;LINC00277;15;69365266;69388160;22894;0
8302;ENSG00000213020;ZNF611;19;53206066;53238326;32260;0
8303;ENSG00000213023;SYT3;19;51124564;51171651;47087;0
8304;ENSG00000213024;NUP62;19;50410082;50433020;22938;0
8305;ENSG00000213077;FAM106A;17;18427880;18430160;2280;0
8306;ENSG00000213096;ZNF254;19;24216276;24312654;96378;0
8307;ENSG00000213246;SUPT4H1;17;56422539;56430454;7915;0
8308;ENSG00000213290;PGK1P2;19;12670385;12671919;1534;0
8309;ENSG00000213339;QTRT1;19;10812106;10824113;12007;0
8310;ENSG00000213380;COG8;16;69354043;69373570;19527;0
8311;ENSG00000213398;LCAT;16;67973653;67978034;4381;0
8312;ENSG00000213424;KRT222;17;38810917;38821433;10516;0
8313;ENSG00000213463;SYNJ2BP;14;70838148;70883778;45630;0
8314;ENSG00000213614;HEXA;15;72635775;72668817;33042;0
8315;ENSG00000213638;ADAT3;19;1905377;1913444;8067;0
8316;ENSG00000213658;LAT;16;28996147;29002104;5957;0
8317;ENSG00000213741;RPS29;14;50043390;50065408;22018;0
8318;ENSG00000213777;;19;54006646;54015941;9295;0
8319;ENSG00000213793;ZNF888;19;53418449;53426723;8274;0
8320;ENSG00000213799;ZNF845;19;53837002;53858122;21120;0
8321;ENSG00000213853;EMP2;16;10622279;10674555;52276;0
8322;ENSG00000213859;KCTD11;17;7255208;7258258;3050;0
8323;ENSG00000213889;PPM1N;19;45992035;46005768;13733;0
8324;ENSG00000213903;LTB4R;14;24780656;24787242;6586;0
8325;ENSG00000213904;LIPE-AS1;19;42901280;43156507;255227;0
8326;ENSG00000213918;DNASE1;16;3661729;3730144;68415;0
8327;ENSG00000213928;IRF9;14;24630262;24635774;5512;0
8328;ENSG00000213965;NUDT19;19;33182867;33204702;21835;0
8329;ENSG00000213967;ZNF726;19;24097678;24127961;30283;0
8330;ENSG00000213971;;19;23442708;23457053;14345;0
8331;ENSG00000213976;;19;21565667;21569979;4312;0
8332;ENSG00000213977;TAX1BP3;17;3566196;3571976;5780;0
8333;ENSG00000213983;AP1G2;14;24028774;24037279;8505;0
8334;ENSG00000213988;ZNF90;19;20188803;20237885;49082;0
8335;ENSG00000213995;CARKD;13;111267881;111292340;24459;0
8336;ENSG00000213996;TM6SF2;19;19375173;19384200;9027;0
8337;ENSG00000214013;GANC;15;42565431;42645864;80433;0
8338;ENSG00000214046;SMIM7;19;16741562;16771253;29691;0
8339;ENSG00000214087;ARL16;17;79648204;79650954;2750;0
8340;ENSG00000214140;PRCD;17;74523668;74549660;25992;0
8341;ENSG00000214174;AMZ2P1;17;62962668;62971694;9026;0
8342;ENSG00000214176;PLEKHM1P;17;62775377;62833272;57895;0
8343;ENSG00000214182;PTMAP5;13;82264046;82265207;1161;0
8344;ENSG00000214189;ZNF788;19;12203078;12248050;44972;0
8345;ENSG00000214212;C19orf38;19;10947251;10980466;33215;0
8346;ENSG00000214223;HNRNPA1P10;19;11776884;11777845;961;0
8347;ENSG00000214226;C17orf67;17;54869274;54916134;46860;0
8348;ENSG00000214331;;16;74366300;74402138;35838;0
8349;ENSG00000214353;VAC14-AS1;16;70789001;70807154;18153;0
8350;ENSG00000214401;KANSL1-AS1;17;44270942;44274089;3147;0
8351;ENSG00000214425;LRRC37A4P;17;43578685;43627701;49016;0
8352;ENSG00000214432;;15;91565849;91579841;13992;0
8353;ENSG00000214433;;15;90835194;90838915;3721;0
8354;ENSG00000214456;PLIN5;19;4522543;4535236;12693;1
8355;ENSG00000214548;MEG3;14;101245747;101327368;81621;0
8356;ENSG00000214575;CPEB1;15;83211951;83317612;105661;0
8357;ENSG00000214578;HMGN2P15;17;40904898;40905817;919;0
8358;ENSG00000214708;;17;30468245;30470154;1909;0
8359;ENSG00000214719;;17;28903482;28999807;96325;0
8360;ENSG00000214725;CDIPT-AS1;16;29874914;29879371;4457;0
8361;ENSG00000214770;;14;64796149;64805317;9168;0
8362;ENSG00000214832;UPF3AP2;17;20278682;20280153;1471;0
8363;ENSG00000214900;C14orf182;14;50448430;50474238;25808;0
8364;ENSG00000214941;ZSWIM7;17;15879874;15903031;23157;0
8365;ENSG00000214946;TBC1D26;17;15635561;15649476;13915;0
8366;ENSG00000214999;;17;7982800;7984883;2083;0
8367;ENSG00000215030;RPL13P12;17;17286691;17287326;635;0
8368;ENSG00000215041;NEURL4;17;7218947;7232712;13765;0
8369;ENSG00000215067;;17;6779954;6915668;135714;0
8370;ENSG00000215154;;16;2653351;2680495;27144;0
8371;ENSG00000215252;GOLGA8B;15;34817408;34880704;63296;1
8372;ENSG00000215256;DHRS4-AS1;14;24407940;24458048;50108;0
8373;ENSG00000215271;HOMEZ;14;23741666;23768656;26990;0
8374;ENSG00000215302;;15;30762982;30799826;36844;0
8375;ENSG00000215417;MIR17HG;13;92000074;92006833;6759;0
8376;ENSG00000215421;ZNF407;18;72265106;72777627;512521;0
8377;ENSG00000215474;SKOR2;18;44746293;44775554;29261;1
8378;ENSG00000215492;HNRNPA1P7;18;29991471;29993167;1696;0
8379;ENSG00000215527;;18;12658042;12663470;5428;0
8380;ENSG00000215769;;17;62745781;62778117;32336;0
8381;ENSG00000217555;CKLF;16;66586466;66600154;13688;0
8382;ENSG00000217930;PAM16;16;4381550;4405608;24058;0
8383;ENSG00000219200;RNASEK;17;6915736;6917851;2115;0
8384;ENSG00000219665;;19;12098432;12157090;58658;0
8385;ENSG00000220032;;18;74207477;74210045;2568;0
8386;ENSG00000220161;;17;18314473;18317694;3221;0
8387;ENSG00000220201;ZGLP1;19;10415479;10420556;5077;0
8388;ENSG00000220205;VAMP2;17;8062467;8066864;4397;0
8389;ENSG00000221044;;17;42102389;42102591;202;0
8390;ENSG00000221051;;19;40710019;40710106;87;0
8391;ENSG00000221916;C19orf73;19;49621655;49622397;742;0
8392;ENSG00000221923;ZNF880;19;52873170;52889048;15878;0
8393;ENSG00000221926;TRIM16;17;15531274;15587625;56351;0
8394;ENSG00000221946;FXYD7;19;35634154;35645204;11050;0
8395;ENSG00000221983;UBA52;19;18682540;18688360;5820;0
8396;ENSG00000221995;TIAF1;17;27400537;27418537;18000;0
8397;ENSG00000222301;RNY5P8;13;103472343;103472419;76;0
8398;ENSG00000223403;MEG9;14;101536248;101539274;3026;0
8399;ENSG00000223496;EXOSC6;16;70284134;70285833;1699;0
8400;ENSG00000223509;;15;32812049;32829127;17078;0
8401;ENSG00000223547;ZNF844;19;12175514;12192380;16866;0
8402;ENSG00000223572;CKMT1A;15;43985084;43991420;6336;0
8403;ENSG00000223573;TINCR;19;5558178;5568045;9867;0
8404;ENSG00000223802;CERS1;19;18979361;19007536;28175;0
8405;ENSG00000223959;AFG3L1P;16;90038994;90068569;29575;0
8406;ENSG00000223979;SMCR2;17;17577340;17581002;3662;0
8407;ENSG00000224078;SNHG14;15;25223730;25664609;440879;0
8408;ENSG00000224113;;17;33332107;33336762;4655;0
8409;ENSG00000224226;TBC1D3B;17;34493061;34503996;10935;0
8410;ENSG00000224243;LINC00403;13;112761433;112762329;896;0
8411;ENSG00000224356;;13;101187995;101232371;44376;0
8412;ENSG00000224383;C17orf72;17;62075711;62081664;5953;0
8413;ENSG00000224418;STK24-AS1;13;99229498;99231084;1586;0
8414;ENSG00000224420;ADM5;19;50191921;50193832;1911;0
8415;ENSG00000224470;ATXN1L;16;71879894;71919171;39277;0
8416;ENSG00000224505;;17;43227767;43238877;11110;0
8417;ENSG00000224578;HNRNPA1P48;16;51679667;51681043;1376;0
8418;ENSG00000224631;;16;61089303;61089868;565;0
8419;ENSG00000224738;;17;57183959;57195628;11669;0
8420;ENSG00000224861;YBX1P1;14;66479548;66480507;959;0
8421;ENSG00000224877;C17orf89;17;79213039;79215081;2042;0
8422;ENSG00000224888;;16;88797588;88807826;10238;0
8423;ENSG00000224997;;14;104177607;104179149;1542;0
8424;ENSG00000225151;GOLGA2P7;15;84867600;84898888;31288;0
8425;ENSG00000225190;PLEKHM1;17;43513266;43568115;54849;0
8426;ENSG00000225193;RPS12P26;15;90749804;90750199;395;0
8427;ENSG00000225200;;14;106444607;106445233;626;0
8428;ENSG00000225373;WASH5P;19;60105;71626;11521;0
8429;ENSG00000225485;ARHGAP23;17;36584662;36668628;83966;0
8430;ENSG00000225614;ZNF469;16;88493879;88507165;13286;0
8431;ENSG00000225663;FAM195B;17;79780287;79791178;10891;0
8432;ENSG00000225746;;14;101403738;101426536;22798;1
8433;ENSG00000225760;LINC00431;13;111635654;111642911;7257;0
8434;ENSG00000225930;;15;30488239;30506743;18504;0
8435;ENSG00000225973;;15;55609382;55611359;1977;0
8436;ENSG00000225975;;19;37176342;37178351;2009;0
8437;ENSG00000226049;TLK2P1;17;32363700;32366891;3191;0
8438;ENSG00000226137;BAIAP2-AS1;17;79002933;79008501;5568;0
8439;ENSG00000226158;CLCP2;13;115072121;115072541;420;0
8440;ENSG00000226174;TEX22;14;105864916;105916443;51527;0
8441;ENSG00000226180;;16;87727144;87729753;2609;0
8442;ENSG00000226377;;17;31203777;31205655;1878;0
8443;ENSG00000226686;;19;37742814;37756437;13623;0
8444;ENSG00000226742;HSBP1L1;18;77724561;77730822;6261;0
8445;ENSG00000226746;SMCR5;17;17680000;17682843;2843;1
8446;ENSG00000226763;SRRM5;19;44100769;44118649;17880;0
8447;ENSG00000227036;LINC00511;17;70319264;70636611;317347;0
8448;ENSG00000227051;C14orf132;14;96505661;96560417;54756;0
8449;ENSG00000227115;;18;48872619;49088939;216320;0
8450;ENSG00000227354;RBM26-AS1;13;79980444;79998463;18019;0
8451;ENSG00000227450;;17;36905613;36906969;1356;0
8452;ENSG00000227500;SCAMP4;19;1905213;1926016;20803;0
8453;ENSG00000227543;SPAG5-AS1;17;26925808;26944393;18585;0
8454;ENSG00000227640;SOX21-AS1;13;95364970;95368500;3530;0
8455;ENSG00000227782;;17;15943505;15943994;489;0
8456;ENSG00000227827;;16;16450081;16471364;21283;0
8457;ENSG00000227973;PIN4P1;15;44168047;44168442;395;0
8458;ENSG00000228201;;16;698473;699200;727;0
8459;ENSG00000228300;C19orf24;19;1275026;1279248;4222;0
8460;ENSG00000228313;;14;23064715;23067855;3140;0
8461;ENSG00000228444;;13;76205407;76206271;864;0
8462;ENSG00000228629;;19;37019220;37026137;6917;0
8463;ENSG00000228696;ARL17B;17;44352150;44439130;86980;0
8464;ENSG00000228782;MRPL45P2;17;45527934;45569858;41924;0
8465;ENSG00000228824;MIR4500HG;13;88079469;88323514;244045;0
8466;ENSG00000228889;UBAC2-AS1;13;99848631;99852964;4333;1
8467;ENSG00000228998;;15;90818266;90820841;2575;0
8468;ENSG00000229152;ANKRD10-IT1;13;111547406;111551519;4113;1
8469;ENSG00000229164;TRAC;14;23016447;23021097;4650;1
8470;ENSG00000229212;;15;85747141;85778026;30885;0
8471;ENSG00000229474;PATL2;15;44957930;45003514;45584;0
8472;ENSG00000229481;;19;38320191;38322797;2606;0
8473;ENSG00000229520;LINC00404;13;112760409;112761196;787;0
8474;ENSG00000229521;MYCBP2-AS2;13;77654646;77655325;679;0
8475;ENSG00000229645;LINC00341;14;95873606;95876427;2821;0
8476;ENSG00000229782;;17;4400689;4402969;2280;0
8477;ENSG00000229809;ZNF688;16;30580667;30584055;3388;0
8478;ENSG00000229833;PET100;19;7694623;7696842;2219;0
8479;ENSG00000229848;;17;79481073;79494802;13729;0
8480;ENSG00000229944;;17;47500970;47502298;1328;0
8481;ENSG00000229980;TOB1-AS1;17;48944040;48987098;43058;0
8482;ENSG00000230055;CISD3;17;36886488;36891297;4809;0
8483;ENSG00000230183;CNOT6LP1;15;56297911;56299374;1463;0
8484;ENSG00000230223;ATXN8OS;13;70681345;70713561;32216;0
8485;ENSG00000230267;HERC2P4;16;32114566;32199434;84868;0
8486;ENSG00000230310;;19;12663411;12664458;1047;0
8487;ENSG00000230330;HMGN2P3;16;26043860;26044132;272;0
8488;ENSG00000230373;GOLGA6L5P;15;85051116;85060045;8929;0
8489;ENSG00000230510;PPP5D1;19;46984053;47104457;120404;0
8490;ENSG00000230532;;17;47009153;47014462;5309;0
8491;ENSG00000230805;;14;101540206;101544247;4041;0
8492;ENSG00000230989;HSBP1;16;83841448;83853342;11894;0
8493;ENSG00000231205;ZNF826P;19;20451078;20607775;156697;0
8494;ENSG00000231256;C17orf105;17;41857803;41864980;7177;1
8495;ENSG00000231544;RSL24D1P11;18;55505708;55506198;490;0
8496;ENSG00000231561;CEACAMP5;19;43158352;43173228;14876;0
8497;ENSG00000231595;;17;14113805;14121239;7434;0
8498;ENSG00000231784;DBIL5P;17;655900;658576;2676;0
8499;ENSG00000232018;;14;101426846;101433377;6531;0
8500;ENSG00000232070;TMEM253;14;21567096;21571883;4787;0
8501;ENSG00000232300;FAM215B;17;44636196;44640161;3965;0
8502;ENSG00000232573;RPL3P4;14;99439216;99439638;422;0
8503;ENSG00000232653;GOLGA8N;15;32885657;32896179;10522;0
8504;ENSG00000232677;LINC00665;19;36803969;36822620;18651;0
8505;ENSG00000232859;LYRM9;17;26205340;26221778;16438;1
8506;ENSG00000233098;;17;20771746;20905589;133843;0
8507;ENSG00000233175;;17;43315395;43319101;3706;1
8508;ENSG00000233223;;17;7485282;7487390;2108;0
8509;ENSG00000233232;NPIPB7;16;28467693;28481868;14175;0
8510;ENSG00000233270;SNRPEP4;19;5576671;5576949;278;0
8511;ENSG00000233527;;19;37063972;37085610;21638;0
8512;ENSG00000233836;;19;23945746;24016116;70370;0
8513;ENSG00000233927;RPS28;19;8386042;8388224;2182;0
8514;ENSG00000233932;CTXN2;15;48483736;48495953;12217;0
8515;ENSG00000233966;UBE2SP1;17;15607546;15608214;668;0
8516;ENSG00000234327;;17;5014763;5017674;2911;0
8517;ENSG00000234377;RNF219-AS1;13;78493824;79191463;697639;0
8518;ENSG00000234465;PINLYP;19;44080952;44088116;7164;0
8519;ENSG00000234494;;17;45974696;46018776;44080;0
8520;ENSG00000234664;HMGN2P5;15;30022917;30023189;272;0
8521;ENSG00000234719;;16;12021230;12070500;49270;0
8522;ENSG00000234769;WASH4P;16;64043;69452;5409;0
8523;ENSG00000234773;;19;12305830;12348582;42752;0
8524;ENSG00000234797;RPS3AP6;15;60060543;60061347;804;0
8525;ENSG00000234899;SOX9-AS1;17;70033455;70217977;184522;0
8526;ENSG00000234911;TEX21P;14;64812889;64841384;28495;0
8527;ENSG00000234912;LINC00338;17;75082798;75091068;8270;0
8528;ENSG00000234972;TBC1D3C;17;34580902;34757050;176148;0
8529;ENSG00000235194;PPP1R3E;14;23764852;23772057;7205;0
8530;ENSG00000235280;MCF2L-AS1;13;113621798;113623138;1340;0
8531;ENSG00000235296;;17;79899745;79905477;5732;0
8532;ENSG00000235370;DNM1P51;15;84953014;84966399;13385;0
8533;ENSG00000235530;;17;21117644;21133348;15704;1
8534;ENSG00000235552;RPL6P27;18;6462143;6463014;871;0
8535;ENSG00000235560;;16;30546073;30548465;2392;0
8536;ENSG00000235706;DICER1-AS1;14;95623982;95646263;22281;0
8537;ENSG00000235875;ARHGEF7-AS2;13;111766159;111768025;1866;0
8538;ENSG00000236088;COX10-AS1;17;13659795;13972812;313017;0
8539;ENSG00000236144;;19;36031640;36036931;5291;0
8540;ENSG00000236194;;17;40422535;40424701;2166;0
8541;ENSG00000236565;HNRNPA3P5;13;66362064;66362896;832;0
8542;ENSG00000236618;PITPNA-AS1;17;1420225;1421390;1165;0
8543;ENSG00000236914;;15;38361682;38365160;3478;0
8544;ENSG00000237082;COX5BP6;13;101276129;101276683;554;0
8545;ENSG00000237161;;15;21936560;21938111;1551;0
8546;ENSG00000237172;B3GNT9;16;67182008;67185117;3109;1
8547;ENSG00000237289;CKMT1B;15;43885252;43897099;11847;0
8548;ENSG00000237296;SMG1P1;16;22448329;22503541;55212;0
8549;ENSG00000237356;;14;53635772;54153976;518204;0
8550;ENSG00000237440;ZNF737;19;20718631;20748615;29984;0
8551;ENSG00000237515;SHISA9;16;12995477;13334272;338795;1
8552;ENSG00000237575;PYY2;17;26553589;26555091;1502;0
8553;ENSG00000237854;LINC00674;17;66098049;66111659;13610;0
8554;ENSG00000238045;;16;29819966;29823306;3340;0
8555;ENSG00000238083;LRRC37A2;17;44588877;44633016;44139;0
8556;ENSG00000238098;ABCA17P;16;2389151;2476700;87549;0
8557;ENSG00000238793;SNORD124;17;38183795;38183898;103;0
8558;ENSG00000239014;SNORD108;15;25232072;25232142;70;0
8559;ENSG00000239100;;15;58892331;58892434;103;0
8560;ENSG00000239197;;15;92960777;92960919;142;0
8561;ENSG00000239382;ALKBH6;19;36500022;36505141;5119;0
8562;ENSG00000239542;RN7SL399P;17;39886381;39886657;276;0
8563;ENSG00000239672;NME1;17;49230897;49239789;8892;0
8564;ENSG00000239697;TNFSF12;17;7452208;7464925;12717;0
8565;ENSG00000239704;CDRT4;17;15339332;15406922;67590;1
8566;ENSG00000239763;;16;74346507;74347288;781;0
8567;ENSG00000239884;RN7SL608P;17;2584242;2584528;286;0
8568;ENSG00000240445;FOXO3B;17;18574259;18576186;1927;0
8569;ENSG00000240463;RPS19P3;14;35037895;35038335;440;0
8570;ENSG00000240616;;19;13004947;13005694;747;0
8571;ENSG00000240820;RN7SL695P;18;48633124;48633416;292;0
8572;ENSG00000241015;TPM3P9;19;53935237;53947923;12686;0
8573;ENSG00000241362;RPL36AP43;15;90231168;90231474;306;0
8574;ENSG00000241839;PLEKHO2;15;65134088;65160206;26118;0
8575;ENSG00000241983;RN7SL566P;19;39859793;39860086;293;0
8576;ENSG00000242028;HYPK;15;44088340;44095241;6901;0
8577;ENSG00000242071;RPL7AP6;14;70352057;70352869;812;0
8578;ENSG00000242085;RPS20P33;14;105840955;105841308;353;0
8579;ENSG00000242173;ARHGDIG;16;318726;333003;14277;0
8580;ENSG00000242498;C15orf38;15;90443159;90456188;13029;0
8581;ENSG00000242612;DECR2;16;451826;462487;10661;0
8582;ENSG00000242615;;19;12252621;12254137;1516;0
8583;ENSG00000242779;ZNF702P;19;53471504;53541151;69647;1
8584;ENSG00000242852;ZNF709;19;12571998;12624668;52670;0
8585;ENSG00000242866;STRC;15;43891596;44010458;118862;1
8586;ENSG00000243297;RPL31P61;19;37392644;37393019;375;0
8587;ENSG00000243319;FGF14-IT1;13;102944677;103046869;102192;0
8588;ENSG00000243445;;16;2382314;2382733;419;0
8589;ENSG00000243678;NME1-NME2;17;49230920;49249108;18188;0
8590;ENSG00000243708;PLA2G4B;15;42120283;42140345;20062;0
8591;ENSG00000243716;NPIPB5;16;22490442;22547842;57400;0
8592;ENSG00000243789;JMJD7;15;42120283;42129779;9496;0
8593;ENSG00000244045;TMEM199;17;26684604;26708716;24112;0
8594;ENSG00000244165;P2RY11;19;10222214;10226048;3834;0
8595;ENSG00000244257;PKD1P1;16;16404198;16428047;23849;0
8596;ENSG00000244879;GABPB1-AS1;15;50647525;50659636;12111;0
8597;ENSG00000245466;;14;71075515;71108015;32500;0
8598;ENSG00000245534;;15;60771377;60922836;151459;1
8599;ENSG00000245598;DACT3-AS1;19;47163621;47180704;17083;0
8600;ENSG00000245680;ZNF585B;19;37672481;37709055;36574;0
8601;ENSG00000245694;CRNDE;16;54952775;54963101;10326;0
8602;ENSG00000245750;;15;69755365;69863775;108410;1
8603;ENSG00000245849;RAD51-AS1;15;40978922;40987305;8383;0
8604;ENSG00000245888;;16;27279526;27301813;22287;0
8605;ENSG00000245975;;15;59060271;59063173;2902;0
8606;ENSG00000246283;;15;43031316;43035400;4084;0
8607;ENSG00000246379;;16;56126899;56225006;98107;0
8608;ENSG00000246465;;16;28296206;28303385;7179;0
8609;ENSG00000246548;;14;77507407;77535846;28439;0
8610;ENSG00000246640;;17;48127713;48133103;5390;0
8611;ENSG00000246731;;17;72206119;72209481;3362;0
8612;ENSG00000246777;;16;66785655;66788643;2988;0
8613;ENSG00000246877;DNM1P35;15;76020011;76030964;10953;0
8614;ENSG00000246898;LINC00920;16;66442427;66446038;3611;0
8615;ENSG00000246922;UBAP1L;15;65385338;65407535;22197;0
8616;ENSG00000247092;SNHG10;14;95998634;96001209;2575;0
8617;ENSG00000247240;UBL7-AS1;15;74753606;74773643;20037;0
8618;ENSG00000247270;;16;66516775;66519747;2972;0
8619;ENSG00000247324;;16;71496181;71499844;3663;0
8620;ENSG00000247400;DNAJC3-AS1;13;96300987;96329179;28192;0
8621;ENSG00000247556;OIP5-AS1;15;41576188;41601901;25713;0
8622;ENSG00000247728;;15;30909201;30917976;8775;1
8623;ENSG00000247735;;16;29938157;29940254;2097;0
8624;ENSG00000247765;;15;21941147;21968151;27004;0
8625;ENSG00000247809;NR2F2-AS1;15;96670598;96870590;199992;0
8626;ENSG00000247970;;14;100070893;100092077;21184;0
8627;ENSG00000247982;LINC00926;15;57592563;57599959;7396;0
8628;ENSG00000248015;;19;1392169;1396466;4297;0
8629;ENSG00000248124;RRN3P1;16;21807951;21831731;23780;0
8630;ENSG00000248278;SUMO2P17;17;46952222;46986345;34123;0
8631;ENSG00000248334;WHAMMP2;15;28982729;29002537;19808;0
8632;ENSG00000248441;;15;95819690;95870358;50668;0
8633;ENSG00000248508;SRP14-AS1;15;40331512;40359491;27979;0
8634;ENSG00000248540;;15;74418256;74421619;3363;0
8635;ENSG00000248714;;17;47438527;47447360;8833;0
8636;ENSG00000248830;ZNF807;19;35033367;35036300;2933;0
8637;ENSG00000248905;FMN1;15;33057747;33486897;429150;0
8638;ENSG00000249115;HAUS5;19;36103646;36116251;12605;0
8639;ENSG00000249214;;15;83684154;83684448;294;0
8640;ENSG00000249459;ZNF286B;17;18561742;18585575;23833;0
8641;ENSG00000249487;;15;89128802;89148341;19539;0
8642;ENSG00000249709;ZNF564;19;12636184;12662356;26172;0
8643;ENSG00000249839;;15;43955852;43976537;20685;0
8644;ENSG00000249931;GOLGA8K;15;32684983;32695396;10413;0
8645;ENSG00000250067;YJEFN3;19;19627036;19648390;21354;0
8646;ENSG00000250107;CACNA1G-AS1;17;48633568;48639469;5901;0
8647;ENSG00000250251;PKD1P6;16;15219099;15248421;29322;0
8648;ENSG00000250286;;17;48614655;48616115;1460;0
8649;ENSG00000250365;;14;31889492;31922089;32597;0
8650;ENSG00000250366;LINC00617;14;96342729;96391908;49179;0
8651;ENSG00000250462;LRRC37BP1;17;28956698;28964482;7784;0
8652;ENSG00000250506;CDK3;17;73996987;74002080;5093;0
8653;ENSG00000250616;;16;30107751;30115437;7686;0
8654;ENSG00000250731;TPM3P6;19;53982604;53983345;741;0
8655;ENSG00000250878;METTL21EP;13;103532449;103548383;15934;0
8656;ENSG00000250948;;17;47452742;47457456;4714;1
8657;ENSG00000250982;;16;28251014;28251989;975;0
8658;ENSG00000250988;;15;83419316;83425958;6642;0
8659;ENSG00000251002;;14;22849083;22951948;102865;0
8660;ENSG00000251161;;15;41199009;41201540;2531;0
8661;ENSG00000251247;ZNF345;19;37341263;37403931;62668;0
8662;ENSG00000251363;;14;41424103;41445082;20979;0
8663;ENSG00000251537;;17;15474805;15554967;80162;0
8664;ENSG00000251602;;14;105883221;105886076;2855;0
8665;ENSG00000251815;SNORD116-26;15;25344646;25344741;95;0
8666;ENSG00000251819;RNU6-322P;15;101092025;101092127;102;0
8667;ENSG00000251858;;14;42063666;42063794;128;0
8668;ENSG00000251896;SNORD116-27;15;25346722;25346813;91;0
8669;ENSG00000252026;RNU6-1262P;16;68318126;68318221;95;0
8670;ENSG00000252034;;18;43656970;43657065;95;0
8671;ENSG00000252311;RNU1-103P;16;85815381;85815505;124;0
8672;ENSG00000252328;;17;33424579;33424676;97;0
8673;ENSG00000252481;SCARNA13;14;95999692;95999966;274;0
8674;ENSG00000252690;SCARNA15;15;83421636;83425960;4324;0
8675;ENSG00000252973;RNU6-1028P;19;19343664;19343756;92;1
8676;ENSG00000252995;RNU6-667P;15;80109691;80109792;101;0
8677;ENSG00000253347;;17;45486688;45500892;14204;0
8678;ENSG00000253730;;17;48235694;48238637;2943;0
8679;ENSG00000253954;HMGN1P38;15;93254977;93256105;1128;0
8680;ENSG00000254004;ZNF260;19;37001597;37019562;17965;0
8681;ENSG00000254206;NPIPB11;16;29392675;29415350;22675;0
8682;ENSG00000254374;GOLGA6L21P;15;83188579;83195251;6672;0
8683;ENSG00000254414;;15;85175129;85177218;2089;0
8684;ENSG00000254505;CHMP4A;14;24678789;24683075;4286;0
8685;ENSG00000254585;MAGEL2;15;23888691;23891175;2484;0
8686;ENSG00000254634;;16;29437121;29465435;28314;0
8687;ENSG00000254656;RTL1;14;101346992;101351184;4192;0
8688;ENSG00000254681;PKD1P5;16;18458147;18495797;37650;0
8689;ENSG00000254744;;15;100510420;100514215;3795;0
8690;ENSG00000254858;MPV17L2;19;18303992;18307758;3766;0
8691;ENSG00000254901;MEF2BNB;19;19287712;19303400;15688;0
8692;ENSG00000254912;;15;32786204;32792547;6343;0
8693;ENSG00000255112;CHMP1B;18;11851395;11854448;3053;0
8694;ENSG00000255198;SNHG9;16;2014960;2015510;550;0
8695;ENSG00000255302;EID1;15;49170083;49172380;2297;0
8696;ENSG00000255509;;17;35218935;35293960;75025;1
8697;ENSG00000255529;POLR2M;15;57884231;58074960;190729;0
8698;ENSG00000255571;LINC00925;15;89904810;89939471;34661;0
8699;ENSG00000255994;CCDC177;14;70037483;70038032;549;0
8700;ENSG00000256053;APOPT1;14;104029299;104073860;44561;0
8701;ENSG00000256061;DYX1C1;15;55702723;55800432;97709;0
8702;ENSG00000256087;ZNF432;19;52534632;52598991;64359;0
8703;ENSG00000256210;;19;14903121;14903589;468;0
8704;ENSG00000256229;ZNF486;19;20278037;20311299;33262;0
8705;ENSG00000256294;ZNF225;19;44616334;44637027;20693;0
8706;ENSG00000256323;;16;542366;542567;201;0
8707;ENSG00000256383;;19;35166998;35168486;1488;0
8708;ENSG00000256463;SALL3;18;76740275;76762677;22402;0
8709;ENSG00000256525;POLG2;17;62473902;62493154;19252;0
8710;ENSG00000256612;CYP2B7P;19;41430124;41456565;26441;0
8711;ENSG00000256616;;18;12073231;12076653;3422;0
8712;ENSG00000256683;ZNF350;19;52467596;52490109;22513;0
8713;ENSG00000256762;STH;17;44076616;44077060;444;0
8714;ENSG00000256771;ZNF253;19;19976695;20005483;28788;0
8715;ENSG00000256802;;15;29967194;29973161;5967;0
8716;ENSG00000257060;;15;93855786;94112712;256926;0
8717;ENSG00000257103;LSM14A;19;34663409;34720420;57011;0
8718;ENSG00000257122;RRN3P3;16;22430090;22449036;18946;0
8719;ENSG00000257151;PWAR6;15;25277020;25281637;4617;0
8720;ENSG00000257185;;14;27278623;27305664;27041;0
8721;ENSG00000257267;ZNF271;18;32870246;32890730;20484;0
8722;ENSG00000257272;;14;36343063;36344509;1446;0
8723;ENSG00000257365;FNTB;14;65381203;65529368;148165;0
8724;ENSG00000257556;;14;105559946;105565341;5395;0
8725;ENSG00000257591;ZNF625;19;12251032;12267546;16514;0
8726;ENSG00000257621;;14;58732083;58764852;32769;0
8727;ENSG00000257704;PRR24;19;47778142;47778979;837;0
8728;ENSG00000257842;NOVA1-AS1;14;27067618;27275673;208055;0
8729;ENSG00000257950;P2RX5-TAX1BP3;17;3566357;3599488;33131;0
8730;ENSG00000258289;CHURC1;14;65381079;65411309;30230;0
8731;ENSG00000258301;;14;77248083;77253067;4984;0
8732;ENSG00000258315;C17orf49;17;6917814;6920844;3030;0
8733;ENSG00000258377;;14;50087533;50090198;2665;0
8734;ENSG00000258399;MEG8;14;101361107;101402336;41229;0
8735;ENSG00000258405;ZNF578;19;52956829;53015407;58578;1
8736;ENSG00000258410;;15;20333998;20353206;19208;0
8737;ENSG00000258418;;14;40855456;40855998;542;0
8738;ENSG00000258430;;14;105235686;105236608;922;0
8739;ENSG00000258441;LINC00641;14;21668238;21675059;6821;0
8740;ENSG00000258450;;14;50096009;50096608;599;0
8741;ENSG00000258457;;14;23451907;23468287;16380;0
8742;ENSG00000258458;;14;23171820;23235771;63951;0
8743;ENSG00000258461;;15;42640301;42704515;64214;0
8744;ENSG00000258472;;17;26782770;26941215;158445;0
8745;ENSG00000258486;RN7SL1;14;50053297;50053596;299;0
8746;ENSG00000258498;DIO3OS;14;102018558;102026768;8210;0
8747;ENSG00000258520;;14;69705883;69727284;21401;0
8748;ENSG00000258525;;14;31345385;31359014;13629;0
8749;ENSG00000258548;LINC00645;14;28081794;28108842;27048;1
8750;ENSG00000258559;;14;74755830;74761128;5298;0
8751;ENSG00000258561;;14;66679528;66976112;296584;0
8752;ENSG00000258568;RHOQP1;14;50066712;50067290;578;0
8753;ENSG00000258569;;14;77177001;77227731;50730;0
8754;ENSG00000258584;FAM181A-AS1;14;94371076;94393412;22336;0
8755;ENSG00000258590;NBEAP1;15;20862967;20893737;30770;0
8756;ENSG00000258591;;14;39577546;39577911;365;0
8757;ENSG00000258592;;14;57532978;57579378;46400;1
8758;ENSG00000258593;;14;105324129;105325173;1044;0
8759;ENSG00000258611;;15;93608815;93609835;1020;1
8760;ENSG00000258631;;15;94133096;94304028;170932;0
8761;ENSG00000258636;;14;42057064;42074059;16995;0
8762;ENSG00000258643;BCL2L2-PABPN1;14;23776044;23794578;18534;0
8763;ENSG00000258647;LINC00930;15;93111048;93115272;4224;0
8764;ENSG00000258655;ARHGAP5-AS1;14;32544625;32545999;1374;0
8765;ENSG00000258682;;14;58731380;58736399;5019;0
8766;ENSG00000258695;;14;73989582;73997314;7732;0
8767;ENSG00000258699;;14;89821404;89822915;1511;0
8768;ENSG00000258701;LINC00638;14;105287538;105290055;2517;0
8769;ENSG00000258704;;14;35390064;35451738;61674;0
8770;ENSG00000258708;SLC25A21-AS1;14;37641093;37643016;1923;0
8771;ENSG00000258711;;14;51422977;51428720;5743;0
8772;ENSG00000258725;PRC1-AS1;15;91509575;91531854;22279;0
8773;ENSG00000258727;;14;24030306;24037282;6976;0
8774;ENSG00000258738;;14;35343549;35345665;2116;0
8775;ENSG00000258739;ENO1P2;15;92964090;92965965;1875;0
8776;ENSG00000258744;;14;24970800;24977894;7094;0
8777;ENSG00000258752;;14;89816629;89831043;14414;0
8778;ENSG00000258754;;15;94261771;94614049;352278;0
8779;ENSG00000258768;;14;20728639;20732467;3828;0
8780;ENSG00000258780;BMS1P15;15;20359029;20366079;7050;0
8781;ENSG00000258789;;14;89017941;89018837;896;0
8782;ENSG00000258790;;14;35591755;35786680;194925;0
8783;ENSG00000258811;;14;105309000;105312253;3253;0
8784;ENSG00000258813;;14;73525139;73526123;984;0
8785;ENSG00000258824;;14;64889653;64915275;25622;0
8786;ENSG00000258839;MC1R;16;89978527;89987385;8858;0
8787;ENSG00000258847;;14;66424015;66471241;47226;0
8788;ENSG00000258882;;14;62278692;62437037;158345;0
8789;ENSG00000258890;CEP95;17;62502706;62538579;35873;0
8790;ENSG00000258891;;14;74362867;74404817;41950;0
8791;ENSG00000258900;HNRNPCP1;14;58987941;58988706;765;0
8792;ENSG00000258904;;14;100730118;100731742;1624;0
8793;ENSG00000258920;FOXN3-AS1;14;89883698;89886137;2439;0
8794;ENSG00000258938;;14;36288430;36295971;7541;0
8795;ENSG00000258940;;14;39734907;39736265;1358;0
8796;ENSG00000258944;;14;73738890;73740789;1899;1
8797;ENSG00000258946;;14;50394289;50428678;34389;0
8798;ENSG00000258947;;16;89987800;90005169;17369;0
8799;ENSG00000258957;;14;69649737;69680809;31072;0
8800;ENSG00000258982;;14;100673744;100704892;31148;0
8801;ENSG00000258983;;14;88965678;88981433;15755;0
8802;ENSG00000258986;TMEM179;14;104941015;105071984;130969;0
8803;ENSG00000258999;;14;81573377;81636758;63381;0
8804;ENSG00000259001;RPPH1;14;20811207;20811844;637;0
8805;ENSG00000259006;;16;89986235;89989070;2835;0
8806;ENSG00000259007;;14;52433721;52436518;2797;0
8807;ENSG00000259015;;14;73427303;73428701;1398;0
8808;ENSG00000259039;;14;58045350;58048038;2688;0
8809;ENSG00000259052;;14;100746296;100757793;11497;0
8810;ENSG00000259066;;14;93651318;93684932;33614;0
8811;ENSG00000259071;;14;50793244;50794627;1383;1
8812;ENSG00000259081;;14;77240627;77247861;7234;0
8813;ENSG00000259088;;14;102262892;102276658;13766;0
8814;ENSG00000259129;LINC00648;14;48234157;48264295;30138;0
8815;ENSG00000259146;;14;71759442;71788531;29089;0
8816;ENSG00000259153;;14;71276922;71282120;5198;0
8817;ENSG00000259158;ADAM20P1;14;70935598;70950473;14875;0
8818;ENSG00000259172;;15;101835624;101845942;10318;0
8819;ENSG00000259200;;15;45997276;46223267;225991;0
8820;ENSG00000259205;PRKXP1;15;101093734;101099159;5425;0
8821;ENSG00000259207;ITGB3;17;45331212;45421658;90446;0
8822;ENSG00000259209;;16;72840887;72843538;2651;0
8823;ENSG00000259219;;15;100516686;100520979;4293;0
8824;ENSG00000259235;;15;48481234;48483888;2654;0
8825;ENSG00000259243;GOLGA6L19;15;83011379;83018198;6819;0
8826;ENSG00000259244;;15;85056472;85070180;13708;0
8827;ENSG00000259248;USP3-AS1;15;63836446;63893788;57342;1
8828;ENSG00000259262;NDUFA3P4;15;90929046;90929295;249;0
8829;ENSG00000259286;;15;69126169;69127088;919;0
8830;ENSG00000259287;;15;34150918;34157026;6108;0
8831;ENSG00000259291;;15;90617747;90625439;7692;0
8832;ENSG00000259295;CSPG4P12;15;85734669;85757136;22467;0
8833;ENSG00000259314;;15;91147457;91157790;10333;0
8834;ENSG00000259318;;14;55861658;55861951;293;0
8835;ENSG00000259319;;14;75890386;75894444;4058;0
8836;ENSG00000259326;;15;38795054;38797182;2128;0
8837;ENSG00000259330;LINC00984;15;40617417;40618916;1499;0
8838;ENSG00000259343;;15;81616718;81654378;37660;0
8839;ENSG00000259344;;15;23095170;23115256;20086;0
8840;ENSG00000259345;;15;39157523;39719396;561873;0
8841;ENSG00000259349;;17;58603654;58628159;24505;0
8842;ENSG00000259362;;15;77817882;77826452;8570;0
8843;ENSG00000259363;;15;100347228;100417353;70125;0
8844;ENSG00000259372;;15;81702858;81711358;8500;0
8845;ENSG00000259376;;15;101583921;101589661;5740;0
8846;ENSG00000259378;DCAF13P3;15;51236860;51238193;1333;0
8847;ENSG00000259404;EFTUD1P1;15;84748920;84795356;46436;0
8848;ENSG00000259407;;15;86287340;86293512;6172;0
8849;ENSG00000259408;;15;34147101;34149010;1909;0
8850;ENSG00000259410;;15;68125063;68166204;41141;1
8851;ENSG00000259416;;15;86298172;86299468;1296;0
8852;ENSG00000259417;;15;80487826;80544555;56729;0
8853;ENSG00000259426;;15;69689243;69707368;18125;0
8854;ENSG00000259431;THTPA;14;24025216;24029480;4264;0
8855;ENSG00000259436;;19;42656721;42661675;4954;1
8856;ENSG00000259438;;15;52303196;52311292;8096;0
8857;ENSG00000259445;;15;82245644;82288007;42363;0
8858;ENSG00000259448;;15;31508223;31516648;8425;0
8859;ENSG00000259472;;15;83141718;83182928;41210;0
8860;ENSG00000259475;;15;99497378;99646030;148652;0
8861;ENSG00000259479;;15;45118569;45176892;58323;0
8862;ENSG00000259485;;15;97839111;97975324;136213;0
8863;ENSG00000259488;;15;48604550;48624053;19503;0
8864;ENSG00000259494;MRPL46;15;89002707;89010650;7943;0
8865;ENSG00000259495;;15;80637195;80695917;58722;0
8866;ENSG00000259502;;14;68077703;68080581;2878;0
8867;ENSG00000259511;UBE2Q2L;15;84841242;84850986;9744;0
8868;ENSG00000259520;;15;45543884;45571449;27565;0
8869;ENSG00000259529;;14;24620427;24636611;16184;0
8870;ENSG00000259539;;15;45444862;45459724;14862;0
8871;ENSG00000259543;;15;81719789;82047558;327769;0
8872;ENSG00000259544;;15;86269346;86270458;1112;0
8873;ENSG00000259548;;15;80124808;80125896;1088;0
8874;ENSG00000259556;;15;52211270;52222824;11554;0
8875;ENSG00000259562;;15;78582869;78583563;694;0
8876;ENSG00000259577;;15;52472290;52498071;25781;0
8877;ENSG00000259594;;15;81846344;81989121;142777;0
8878;ENSG00000259606;;14;75310727;75322378;11651;0
8879;ENSG00000259609;;15;84721865;84748849;26984;0
8880;ENSG00000259610;;15;81926228;81934531;8303;0
8881;ENSG00000259623;;17;40004770;40007699;2929;0
8882;ENSG00000259648;;14;68081646;68083343;1697;0
8883;ENSG00000259658;;15;102277302;102285913;8611;1
8884;ENSG00000259659;;15;44850027;44851386;1359;0
8885;ENSG00000259660;DNM1P47;15;102291235;102334505;43270;0
8886;ENSG00000259673;IQCH-AS1;15;67695957;67814182;118225;0
8887;ENSG00000259683;;15;84944427;84950601;6174;0
8888;ENSG00000259687;;14;75761107;75763341;2234;0
8889;ENSG00000259692;;15;81952823;82163466;210643;0
8890;ENSG00000259705;;15;48938148;48944213;6065;0
8891;ENSG00000259706;HSP90B2P;15;99797837;99800220;2383;0
8892;ENSG00000259707;;15;83360475;83361110;635;0
8893;ENSG00000259711;;16;54968825;54988577;19752;1
8894;ENSG00000259714;LINC00594;15;40664026;40664677;651;0
8895;ENSG00000259726;CSPG4P11;15;84855504;84866136;10632;0
8896;ENSG00000259736;;15;91163239;91260372;97133;0
8897;ENSG00000259744;;15;71141222;71142109;887;0
8898;ENSG00000259755;;15;101590937;101626271;35334;0
8899;ENSG00000259762;;15;86293567;86296132;2565;0
8900;ENSG00000259767;;15;83690988;83693088;2100;0
8901;ENSG00000259768;;16;72699069;72821143;122074;0
8902;ENSG00000259774;;15;84977316;84980581;3265;0
8903;ENSG00000259775;;14;103798011;103798704;693;0
8904;ENSG00000259781;;15;71457109;71457754;645;0
8905;ENSG00000259796;;14;62577593;62579268;1675;0
8906;ENSG00000259797;;16;68350704;68352939;2235;0
8907;ENSG00000259803;SLC22A31;16;89262406;89268072;5666;0
8908;ENSG00000259804;;16;67595314;67596212;898;0
8909;ENSG00000259806;;16;23683453;23686820;3367;0
8910;ENSG00000259877;;16;89281638;89284061;2423;0
8911;ENSG00000259888;;16;24621587;24652278;30691;0
8912;ENSG00000259895;;16;2514951;2518214;3263;0
8913;ENSG00000259901;;16;72823142;72825522;2380;0
8914;ENSG00000259905;PWRN1;15;24738284;24897277;158993;0
8915;ENSG00000259917;HNRNPLP2;15;34781203;34782772;1569;0
8916;ENSG00000259932;;15;45490715;45491337;622;0
8917;ENSG00000259940;;16;27224631;27226314;1683;0
8918;ENSG00000259954;IL21R-AS1;16;27458990;27464714;5724;1
8919;ENSG00000259957;;16;49328797;49330647;1850;0
8920;ENSG00000259964;;15;71439989;71481381;41392;0
8921;ENSG00000259969;;14;58460263;58461243;980;0
8922;ENSG00000259972;;16;74339100;74369244;30144;0
8923;ENSG00000259985;;18;29265618;29266786;1168;0
8924;ENSG00000259987;;16;33943723;33944473;750;0
8925;ENSG00000259998;;14;88624584;88626935;2351;0
8926;ENSG00000260011;;17;80338986;80340566;1580;0
8927;ENSG00000260018;;16;84150656;84151176;520;0
8928;ENSG00000260023;;16;70610204;70611571;1367;0
8929;ENSG00000260038;;16;57281262;57282404;1142;0
8930;ENSG00000260058;;16;8359964;8407862;47898;0
8931;ENSG00000260060;;16;31207452;31208284;832;0
8932;ENSG00000260083;MIR4519;16;30886543;30906541;19998;0
8933;ENSG00000260095;;16;2502582;2502978;396;0
8934;ENSG00000260103;;15;74770411;74782627;12216;0
8935;ENSG00000260111;;16;70413360;70433405;20045;0
8936;ENSG00000260114;;16;29930957;29933226;2269;0
8937;ENSG00000260121;;16;88785023;88786867;1844;0
8938;ENSG00000260136;;16;23464079;23468927;4848;0
8939;ENSG00000260144;;15;72897524;72904667;7143;0
8940;ENSG00000260160;;19;52561743;52566956;5213;0
8941;ENSG00000260198;;16;56334528;56336816;2288;0
8942;ENSG00000260211;;15;32605327;32607855;2528;0
8943;ENSG00000260213;;16;81050397;81069364;18967;0
8944;ENSG00000260219;;16;30366762;30367848;1086;0
8945;ENSG00000260232;PWRN4;15;24220319;24248582;28263;0
8946;ENSG00000260248;;17;71171622;71172772;1150;1
8947;ENSG00000260249;;16;50700122;50705550;5428;0
8948;ENSG00000260259;;16;89749028;89752977;3949;0
8949;ENSG00000260260;;16;2204798;2205359;561;0
8950;ENSG00000260267;;16;31468032;31471057;3025;0
8951;ENSG00000260269;;15;75819491;75893546;74055;0
8952;ENSG00000260274;;15;75660496;75661925;1429;0
8953;ENSG00000260276;;16;8941962;8954274;12312;0
8954;ENSG00000260279;;16;89363916;89364724;808;0
8955;ENSG00000260285;;14;103991347;103995409;4062;1
8956;ENSG00000260293;;16;2526559;2527062;503;0
8957;ENSG00000260300;;16;83941738;83985058;43320;0
8958;ENSG00000260306;;16;21805416;21807080;1664;0
8959;ENSG00000260337;;15;93138790;93139692;902;0
8960;ENSG00000260339;HEXA-AS1;15;72668454;72671129;2675;0
8961;ENSG00000260350;;16;8941507;8942581;1074;0
8962;ENSG00000260359;;15;95024040;95027181;3141;0
8963;ENSG00000260361;;15;93322987;93324722;1735;0
8964;ENSG00000260372;AQP4-AS1;18;24235706;24770662;534956;0
8965;ENSG00000260385;;13;112737863;112739785;1922;0
8966;ENSG00000260409;;15;20935076;20961512;26436;0
8967;ENSG00000260432;;16;9847272;9851895;4623;0
8968;ENSG00000260442;;16;28890278;28891241;963;0
8969;ENSG00000260448;;16;25096913;25122876;25963;0
8970;ENSG00000260450;;16;47999583;48005598;6015;0
8971;ENSG00000260456;C16orf95;16;87117168;87351022;233854;0
8972;ENSG00000260465;;16;66754800;66765688;10888;0
8973;ENSG00000260469;;15;74060555;74061978;1423;0
8974;ENSG00000260482;;16;23681332;23684448;3116;0
8975;ENSG00000260490;;15;42864125;42864631;506;0
8976;ENSG00000260495;;16;81344336;81347028;2692;0
8977;ENSG00000260523;;16;83831266;83834245;2979;0
8978;ENSG00000260528;FAM157C;16;90168679;90244752;76073;0
8979;ENSG00000260532;;16;1161627;1163399;1772;0
8980;ENSG00000260534;;15;72882032;72884186;2154;0
8981;ENSG00000260539;;16;74481325;74483790;2465;0
8982;ENSG00000260563;;17;80251592;80252786;1194;0
8983;ENSG00000260565;ERVK13-1;16;2710350;2723445;13095;0
8984;ENSG00000260578;;18;65149028;65152203;3175;0
8985;ENSG00000260579;;15;83782369;83783318;949;0
8986;ENSG00000260591;;15;75647551;75648087;536;0
8987;ENSG00000260608;;15;83681413;83730597;49184;0
8988;ENSG00000260614;;16;49321341;49324138;2797;0
8989;ENSG00000260625;;16;31519792;31520569;777;0
8990;ENSG00000260630;SNAI3-AS1;16;88729706;88753594;23888;0
8991;ENSG00000260643;;16;81087270;81121256;33986;0
8992;ENSG00000260647;;17;18171394;18172142;748;0
8993;ENSG00000260648;;15;40524283;40528308;4025;0
8994;ENSG00000260657;;15;68560130;68570332;10202;0
8995;ENSG00000260664;;16;72459847;72463072;3225;0
8996;ENSG00000260669;;14;24678852;24685193;6341;0
8997;ENSG00000260671;;16;87773369;87781312;7943;0
8998;ENSG00000260693;;15;30832296;30838172;5876;0
8999;ENSG00000260714;;16;25027299;25032344;5045;0
9000;ENSG00000260729;;15;72577068;72668322;91254;0
9001;ENSG00000260740;;16;31498691;31499813;1122;0
9002;ENSG00000260747;;18;65945039;65945480;441;0
9003;ENSG00000260750;;16;87526161;87549241;23080;0
9004;ENSG00000260751;;16;23579994;23581017;1023;0
9005;ENSG00000260760;PWRN3;15;24686274;24693114;6840;0
9006;ENSG00000260769;;16;49371078;49372904;1826;0
9007;ENSG00000260777;;17;26590660;26593395;2735;0
9008;ENSG00000260778;MIR940;16;2318156;2323419;5263;0
9009;ENSG00000260781;ARHGAP23P1;16;33709886;33739634;29748;0
9010;ENSG00000260787;;15;77334178;77335533;1355;1
9011;ENSG00000260793;;17;42298769;42301078;2309;0
9012;ENSG00000260806;;14;96967147;96968658;1511;0
9013;ENSG00000260807;;16;1025761;1031596;5835;0
9014;ENSG00000260824;;15;75192333;75193030;697;0
9015;ENSG00000260848;;16;73577840;73592421;14581;0
9016;ENSG00000260852;FBXL19-AS1;16;30930640;30934590;3950;1
9017;ENSG00000260872;;16;15111963;15114345;2382;0
9018;ENSG00000260874;;16;2506253;2509980;3727;0
9019;ENSG00000260896;;16;80862632;80926492;63860;0
9020;ENSG00000260907;;17;20433355;20434194;839;0
9021;ENSG00000260910;LINC00565;13;114629487;114631817;2330;0
9022;ENSG00000260911;;16;31054471;31061201;6730;0
9023;ENSG00000260916;CCPG1;15;55632230;55700708;68478;0
9024;ENSG00000260923;;16;90252405;90289086;36681;0
9025;ENSG00000260927;;16;58163433;58193037;29604;0
9026;ENSG00000260936;FTO-IT1;16;54073305;54074638;1333;0
9027;ENSG00000260978;;15;23812411;23814804;2393;0
9028;ENSG00000260992;DOCK9-AS2;13;99740073;99740879;806;0
9029;ENSG00000261005;;17;36858705;36861000;2295;0
9030;ENSG00000261008;;16;72459384;72698908;239524;0
9031;ENSG00000261033;;17;19911364;19912547;1183;0
9032;ENSG00000261052;SULT1A3;16;30205754;30215631;9877;0
9033;ENSG00000261054;;15;99669037;99672011;2974;0
9034;ENSG00000261056;;16;53332136;53333704;1568;0
9035;ENSG00000261061;;16;81064375;81065090;715;0
9036;ENSG00000261064;;15;32828248;32879814;51566;0
9037;ENSG00000261067;;16;28986125;29002096;15971;0
9038;ENSG00000261069;SNORD116-21;15;25332808;25334043;1235;0
9039;ENSG00000261069;SNORD116-20;15;25332808;25334043;1235;0
9040;ENSG00000261079;;16;74401360;74403724;2364;0
9041;ENSG00000261088;;16;66923072;66924996;1924;0
9042;ENSG00000261114;;16;56974940;56975638;698;0
9043;ENSG00000261118;;16;89558425;89570868;12443;0
9044;ENSG00000261123;;16;2144831;2147027;2196;0
9045;ENSG00000261126;RBFADN;18;77806900;77853362;46462;1
9046;ENSG00000261136;;15;40074772;40077818;3046;0
9047;ENSG00000261147;;15;90792788;90815440;22652;0
9048;ENSG00000261173;;16;47007900;47012894;4994;0
9049;ENSG00000261183;;15;41128006;41136585;8579;0
9050;ENSG00000261187;;15;72757469;72758603;1134;0
9051;ENSG00000261226;;16;89003187;89006059;2872;0
9052;ENSG00000261229;;15;80135889;80136646;757;0
9053;ENSG00000261231;;16;47758479;47942342;183863;1
9054;ENSG00000261242;;14;64010287;64011382;1095;0
9055;ENSG00000261270;;16;56974190;56975254;1064;0
9056;ENSG00000261280;;19;12456763;12458752;1989;1
9057;ENSG00000261286;;16;84492865;84500967;8102;0
9058;ENSG00000261302;;16;56742684;56763880;21196;0
9059;ENSG00000261335;;17;74668024;74669740;1716;0
9060;ENSG00000261342;;19;2727741;2729325;1584;0
9061;ENSG00000261351;;15;66782086;66784447;2361;0
9062;ENSG00000261372;;14;92511119;92516990;5871;1
9063;ENSG00000261374;;15;40666599;40668192;1593;0
9064;ENSG00000261377;;15;29034810;29101361;66551;0
9065;ENSG00000261386;;16;67583117;67597861;14744;0
9066;ENSG00000261408;TEN1-CDK3;17;73975312;74002080;26768;0
9067;ENSG00000261423;;15;72700119;72767509;67390;0
9068;ENSG00000261439;;16;56226526;56228430;1904;0
9069;ENSG00000261441;;15;89878284;89879392;1108;0
9070;ENSG00000261474;;16;31460856;31464814;3958;0
9071;ENSG00000261476;;16;75492150;75493915;1765;1
9072;ENSG00000261478;;15;90052192;90053647;1455;0
9073;ENSG00000261512;;16;46656773;46658363;1590;0
9074;ENSG00000261526;;19;1874881;1876168;1287;0
9075;ENSG00000261553;;13;76123909;76381256;257347;0
9076;ENSG00000261556;;16;70253477;70279519;26042;0
9077;ENSG00000261560;;16;11974932;11976426;1494;0
9078;ENSG00000261575;;17;44344403;44346060;1657;0
9079;ENSG00000261589;;17;53246184;53250993;4809;0
9080;ENSG00000261597;;15;49944336;49948429;4093;1
9081;ENSG00000261609;GAN;16;81348557;81424489;75932;0
9082;ENSG00000261616;;15;99679522;99685575;6053;0
9083;ENSG00000261617;;16;9449445;9501950;52505;0
9084;ENSG00000261622;;15;24157556;24186863;29307;0
9085;ENSG00000261644;;16;50769624;50774627;5003;0
9086;ENSG00000261652;C15orf65;15;55700746;55710962;10216;0
9087;ENSG00000261659;;16;739001;742554;3553;0
9088;ENSG00000261663;;16;2290488;2291819;1331;0
9089;ENSG00000261684;;15;42824065;42825038;973;0
9090;ENSG00000261685;;16;50679720;50683160;3440;0
9091;ENSG00000261687;;15;43476277;43477339;1062;0
9092;ENSG00000261705;;16;66921918;66922834;916;0
9093;ENSG00000261712;;15;79705700;79706228;528;0
9094;ENSG00000261722;;16;79246608;79263350;16742;0
9095;ENSG00000261732;;16;1682260;1736716;54456;0
9096;ENSG00000261744;;16;88579368;88597461;18093;0
9097;ENSG00000261754;;19;35302493;35305249;2756;0
9098;ENSG00000261762;;15;78881465;78883618;2153;1
9099;ENSG00000261766;;16;28873487;28874661;1174;0
9100;ENSG00000261770;;19;28248092;28251757;3665;0
9101;ENSG00000261777;;16;70349543;70380650;31107;0
9102;ENSG00000261783;;16;75413716;75415158;1442;0
9103;ENSG00000261788;;16;46737281;46737937;656;0
9104;ENSG00000261790;;16;2034878;2040358;5480;1
9105;ENSG00000261794;GOLGA8H;15;30896329;30906764;10435;0
9106;ENSG00000261801;LOXL1-AS1;15;74200424;74220589;20165;0
9107;ENSG00000261819;;16;15082116;15084017;1901;0
9108;ENSG00000261824;LINC00662;19;28175488;28284848;109360;0
9109;ENSG00000261840;;16;30709030;30710379;1349;0
9110;ENSG00000261879;;17;5095379;5151364;55985;0
9111;ENSG00000261884;;16;67963517;67969920;6403;0
9112;ENSG00000261886;;17;44994136;45000400;6264;0
9113;ENSG00000261888;;17;81061205;81063860;2655;0
9114;ENSG00000261949;GFY;19;49927006;49932075;5069;0
9115;ENSG00000261963;;17;2627714;2652714;25000;0
9116;ENSG00000261971;;16;3101992;3109371;7379;0
9117;ENSG00000261996;;17;6556783;6558328;1545;0
9118;ENSG00000262001;DLGAP1-AS2;18;3602998;3608334;5336;1
9119;ENSG00000262039;;17;47448102;47554350;106248;0
9120;ENSG00000262049;;17;79668354;79670330;1976;0
9121;ENSG00000262050;;17;2615603;2616127;524;0
9122;ENSG00000262089;;17;6897961;6898508;547;0
9123;ENSG00000262119;;14;27061953;27063723;1770;0
9124;ENSG00000262155;;16;25078258;25080264;2006;0
9125;ENSG00000262185;;16;3997610;4000445;2835;0
9126;ENSG00000262194;;17;3705459;3706676;1217;0
9127;ENSG00000262223;;17;79349801;79359160;9359;0
9128;ENSG00000262227;;17;4891001;4891741;740;0
9129;ENSG00000262246;CORO7;16;4404543;4475706;71163;0
9130;ENSG00000262251;;17;7588578;7589689;1111;0
9131;ENSG00000262333;HNRNPA1P16;17;2210055;2211009;954;0
9132;ENSG00000262352;;18;11103;15928;4825;0
9133;ENSG00000262410;;17;80702944;80703585;641;0
9134;ENSG00000262434;;17;692984;693765;781;0
9135;ENSG00000262454;;16;14396145;14420210;24065;0
9136;ENSG00000262468;;16;4295826;4303790;7964;0
9137;ENSG00000262484;CCER2;19;39399620;39402798;3178;0
9138;ENSG00000262521;;16;3231233;3234018;2785;0
9139;ENSG00000262533;;17;1946194;1946719;525;0
9140;ENSG00000262580;;17;78174472;78179748;5276;0
9141;ENSG00000262583;;16;75533686;75550178;16492;0
9142;ENSG00000262585;;17;77889051;77900524;11473;0
9143;ENSG00000262587;;16;25043202;25069430;26228;0
9144;ENSG00000262601;;16;85204882;85218969;14087;0
9145;ENSG00000262652;;17;80535899;80536492;593;0
9146;ENSG00000262663;;17;80876158;80876661;503;0
9147;ENSG00000262668;;16;3238212;3274779;36567;0
9148;ENSG00000262681;;17;19622372;19625741;3369;0
9149;ENSG00000262691;;16;67295011;67297687;2676;1
9150;ENSG00000262700;;16;25104708;25106576;1868;0
9151;ENSG00000262712;;16;4385871;4387819;1948;0
9152;ENSG00000262728;;15;32898619;32907361;8742;0
9153;ENSG00000262758;;17;3710042;3712148;2106;0
9154;ENSG00000262766;;16;31129399;31130068;669;0
9155;ENSG00000262772;;17;77797251;77801503;4252;0
9156;ENSG00000262814;MRPL12;17;79670387;79674556;4169;0
9157;ENSG00000262823;;17;4385261;4389648;4387;0
9158;ENSG00000262837;;17;47911601;47913816;2215;0
9159;ENSG00000262873;;17;78991769;78993811;2042;0
9160;ENSG00000262877;;17;79361930;79364056;2126;0
9161;ENSG00000262879;;17;45061411;45177689;116278;0
9162;ENSG00000262888;;16;3981218;3996306;15088;0
9163;ENSG00000262890;;16;70835986;70836743;757;1
9164;ENSG00000262903;;17;3558915;3561386;2471;0
9165;ENSG00000262904;;16;74701404;74702604;1200;0
9166;ENSG00000262944;;16;9198705;9200618;1913;0
9167;ENSG00000262951;;17;54946308;54946925;617;0
9168;ENSG00000262966;;17;9074385;9082435;8050;0
9169;ENSG00000263002;ZNF234;19;44645710;44663156;17446;0
9170;ENSG00000263004;;17;55155659;55162385;6726;1
9171;ENSG00000263006;ROCK1P1;18;109065;122219;13154;0
9172;ENSG00000263013;;16;11032743;11033901;1158;1
9173;ENSG00000263033;;16;11290034;11318373;28339;0
9174;ENSG00000263050;;17;1946769;1948262;1493;0
9175;ENSG00000263053;;17;79369275;79375658;6383;0
9176;ENSG00000263063;;17;80671784;80674131;2347;1
9177;ENSG00000263069;;17;78325628;78388968;63340;0
9178;ENSG00000263072;;16;3166043;3184883;18840;0
9179;ENSG00000263120;;17;55060110;55062465;2355;0
9180;ENSG00000263126;;16;67916364;67920270;3906;0
9181;ENSG00000263142;LRRC37A17P;17;45055847;45131935;76088;0
9182;ENSG00000263146;;18;76736555;76739074;2519;0
9183;ENSG00000263165;;17;4067204;4068007;803;0
9184;ENSG00000263214;ZNF205-AS1;16;3160461;3165599;5138;0
9185;ENSG00000263232;ATP5A1P3;16;72038936;72040442;1506;0
9186;ENSG00000263235;;16;3700637;3701704;1067;0
9187;ENSG00000263244;;16;9201098;9207038;5940;0
9188;ENSG00000263276;;16;68258616;68261637;3021;0
9189;ENSG00000263293;;17;45380832;45400979;20147;0
9190;ENSG00000263320;;16;71963914;71965102;1188;0
9191;ENSG00000263335;;16;15820531;15826850;6319;0
9192;ENSG00000263350;;18;19210099;19213485;3386;0
9193;ENSG00000263412;;17;46122503;46125435;2932;0
9194;ENSG00000263422;;17;58119722;58119803;81;0
9195;ENSG00000263470;;17;63096930;63107176;10246;0
9196;ENSG00000263535;AK4P1;17;29672539;29673205;666;0
9197;ENSG00000263551;;18;976590;1174824;198234;0
9198;ENSG00000263571;;17;32488756;32491270;2514;0
9199;ENSG00000263585;;17;79890274;79890934;660;0
9200;ENSG00000263603;;17;29056487;29058220;1733;0
9201;ENSG00000263606;;18;2945548;2946888;1340;0
9202;ENSG00000263627;;18;9615262;9619361;4099;0
9203;ENSG00000263677;;18;24268075;24269632;1557;0
9204;ENSG00000263729;;17;20887215;20887359;144;0
9205;ENSG00000263731;;17;79836301;79838982;2681;0
9206;ENSG00000263753;LINC00667;18;5232875;5246507;13632;0
9207;ENSG00000263766;;17;45681226;45726786;45560;0
9208;ENSG00000263786;;17;73141356;73142641;1285;0
9209;ENSG00000263809;;17;8271956;8286505;14549;0
9210;ENSG00000263818;;17;37213272;37269443;56171;0
9211;ENSG00000263823;;18;29522538;29524119;1581;0
9212;ENSG00000263843;;17;73267450;73269976;2526;0
9213;ENSG00000263874;LINC00672;17;37081421;37084310;2889;0
9214;ENSG00000263884;;18;268148;270278;2130;1
9215;ENSG00000263916;;18;47010906;47012519;1613;0
9216;ENSG00000263931;;17;61012763;61044171;31408;0
9217;ENSG00000263934;SNORD3A;17;19091329;19092027;698;0
9218;ENSG00000263958;;18;70535623;70548634;13011;0
9219;ENSG00000263968;RN7SL381P;16;85692984;85693279;295;0
9220;ENSG00000264049;MIR4737;17;58120386;58120466;80;0
9221;ENSG00000264058;;17;38785049;38821393;36344;0
9222;ENSG00000264070;DND1P1;17;43663237;43664295;1058;0
9223;ENSG00000264083;;17;30757986;30759860;1874;0
9224;ENSG00000264098;;17;26729128;26731067;1939;1
9225;ENSG00000264107;;17;29417805;29422468;4663;0
9226;ENSG00000264109;MIR4712;15;50652526;50652607;81;0
9227;ENSG00000264112;;17;56066400;56072211;5811;0
9228;ENSG00000264187;;17;17105963;17140499;34536;0
9229;ENSG00000264222;;18;14244624;14252139;7515;0
9230;ENSG00000264247;LINC00909;18;72259010;72265744;6734;0
9231;ENSG00000264278;;18;74506688;74534251;27563;0
9232;ENSG00000264350;SNRPGP2;18;51933259;51933484;225;0
9233;ENSG00000264364;DYNLL2;17;56160776;56172897;12121;0
9234;ENSG00000264469;;17;25641669;25642952;1283;1
9235;ENSG00000264538;;17;29036317;29117926;81609;0
9236;ENSG00000264548;;17;80172103;80175228;3125;0
9237;ENSG00000264575;LINC00526;18;5236723;5238597;1874;0
9238;ENSG00000264589;MAPT-AS1;17;43921017;43972966;51949;0
9239;ENSG00000264608;;17;26928845;26929302;457;0
9240;ENSG00000264655;;17;38524204;38524690;486;0
9241;ENSG00000264660;;17;20841851;20885670;43819;0
9242;ENSG00000264666;;17;17494742;17513799;19057;0
9243;ENSG00000264745;;18;21574177;21595303;21126;0
9244;ENSG00000264772;SNORA67;17;7476144;7485342;9198;0
9245;ENSG00000264885;;17;18570942;18572774;1832;0
9246;ENSG00000264920;;17;45968621;45973178;4557;0
9247;ENSG00000264943;SH3GL1P2;17;28951431;28952512;1081;0
9248;ENSG00000264954;;17;62073431;62077259;3828;0
9249;ENSG00000264964;;18;9315192;9334439;19247;0
9250;ENSG00000265010;;17;71239232;71240845;1613;0
9251;ENSG00000265091;;18;5232875;5238525;5650;0
9252;ENSG00000265148;BZRAP1-AS1;17;56402811;56493127;90316;0
9253;ENSG00000265150;RN7SL2;14;50329271;50329567;296;0
9254;ENSG00000265179;;18;902767;906668;3901;0
9255;ENSG00000265218;;17;62888847;62906298;17451;0
9256;ENSG00000265242;;17;73161681;73163344;1663;0
9257;ENSG00000265254;;17;26732258;26733814;1556;0
9258;ENSG00000265262;;17;61028192;61028549;357;0
9259;ENSG00000265263;;17;19237621;19239440;1819;0
9260;ENSG00000265342;;17;73390204;73391044;840;1
9261;ENSG00000265413;;18;8402845;8405159;2314;1
9262;ENSG00000265450;MIR4502;13;115039303;115039383;80;0
9263;ENSG00000265458;;17;80412149;80416397;4248;0
9264;ENSG00000265485;;18;22208146;22242162;34016;0
9265;ENSG00000265533;;18;65183783;65566856;383073;0
9266;ENSG00000265579;;18;70410991;70413196;2205;1
9267;ENSG00000265611;MIR5010;17;40666206;40666325;119;0
9268;ENSG00000265666;;17;38497119;38499388;2269;0
9269;ENSG00000265681;RPL17;18;47014851;47018906;4055;0
9270;ENSG00000265683;;17;25678884;25679610;726;1
9271;ENSG00000265688;MAFG-AS1;17;79885705;79888629;2924;0
9272;ENSG00000265728;;18;10594587;10604795;10208;0
9273;ENSG00000265750;;18;21739473;21742175;2702;0
9274;ENSG00000265778;;18;74203608;74205487;1879;0
9275;ENSG00000265798;;17;29365593;29386139;20546;0
9276;ENSG00000265800;;17;73134511;73137445;2934;0
9277;ENSG00000265962;;18;8695854;8707619;11765;0
9278;ENSG00000265967;;15;64987240;64987793;553;0
9279;ENSG00000265984;;18;18820636;18821332;696;0
9280;ENSG00000266053;;18;9121263;9136643;15380;0
9281;ENSG00000266173;STRADA;17;61780192;61819330;39138;0
9282;ENSG00000266208;;17;38516907;38520945;4038;0
9283;ENSG00000266236;NARF-IT1;17;80439974;80441264;1290;0
9284;ENSG00000266256;LINC00683;18;74327169;74337897;10728;0
9285;ENSG00000266258;;18;68002675;68019695;17020;0
9286;ENSG00000266306;;17;26596229;26599391;3162;0
9287;ENSG00000266335;;18;49862731;49865395;2664;0
9288;ENSG00000266352;RN7SL192P;19;11122384;11122680;296;0
9289;ENSG00000266368;;17;11857206;11880911;23705;0
9290;ENSG00000266385;;17;30738236;30739439;1203;0
9291;ENSG00000266402;SNORA76;17;62223330;62223836;506;0
9292;ENSG00000266405;CBX3P2;18;2652169;2655394;3225;0
9293;ENSG00000266411;;17;61044178;61045910;1732;1
9294;ENSG00000266456;;18;650229;652843;2614;0
9295;ENSG00000266469;;17;37558046;37562486;4440;0
9296;ENSG00000266490;;17;29119390;29119851;461;0
9297;ENSG00000266538;;17;15434087;15434403;316;0
9298;ENSG00000266589;MIR4512;15;66789296;66789372;76;0
9299;ENSG00000266644;;17;62895884;62896834;950;0
9300;ENSG00000266651;;17;16343793;16344266;473;0
9301;ENSG00000266709;;17;14207171;14208822;1651;0
9302;ENSG00000266714;MYO15B;17;73584139;73622929;38790;0
9303;ENSG00000266753;;17;37408897;37410550;1653;0
9304;ENSG00000266777;SH3GL1P1;17;30366993;30369847;2854;0
9305;ENSG00000266783;;18;2561171;2562219;1048;0
9306;ENSG00000266844;;18;74686646;74696118;9472;0
9307;ENSG00000266903;;19;45135500;45222031;86531;0
9308;ENSG00000266904;LINC00663;19;19868175;19887232;19057;0
9309;ENSG00000266905;;18;46489321;46490311;990;0
9310;ENSG00000266910;;19;30528330;30529063;733;0
9311;ENSG00000266911;;17;34084218;34085344;1126;0
9312;ENSG00000266912;;19;9455460;9456574;1114;0
9313;ENSG00000266916;;19;37988063;37997948;9885;0
9314;ENSG00000266918;;17;43608943;43611204;2261;0
9315;ENSG00000266921;;19;44501048;44506988;5940;0
9316;ENSG00000266926;;19;1581789;1582322;533;0
9317;ENSG00000266930;;19;33366831;33369327;2496;0
9318;ENSG00000266934;;17;59460146;59462041;1895;0
9319;ENSG00000266935;;19;37119695;37121092;1397;0
9320;ENSG00000266947;;17;33558469;33569982;11513;0
9321;ENSG00000266962;;17;40704456;40706766;2310;0
9322;ENSG00000266967;AARSD1;17;41102543;41116515;13972;0
9323;ENSG00000266972;LRRC37A9P;17;34239639;34245014;5375;0
9324;ENSG00000266994;;16;4780116;4802566;22450;0
9325;ENSG00000266999;;17;34220711;34238027;17316;0
9326;ENSG00000267002;;17;41316200;41322420;6220;0
9327;ENSG00000267009;;17;66409764;66521090;111326;0
9328;ENSG00000267010;;18;56419380;56421709;2329;1
9329;ENSG00000267040;;18;55297534;55405276;107742;0
9330;ENSG00000267041;ZNF850;19;37205285;37263727;58442;0
9331;ENSG00000267058;;19;44395956;44405957;10001;0
9332;ENSG00000267060;PTGES3L;17;41120105;41132545;12440;0
9333;ENSG00000267065;;17;74795126;74802035;6909;0
9334;ENSG00000267077;;16;4845266;4846533;1267;0
9335;ENSG00000267080;ASB16-AS1;17;42253341;42264085;10744;0
9336;ENSG00000267088;;18;39669276;39669716;440;0
9337;ENSG00000267091;CTBP2P7;19;36987818;36989061;1243;0
9338;ENSG00000267092;;19;1508381;1508962;581;0
9339;ENSG00000267095;;17;58213123;58217442;4319;0
9340;ENSG00000267100;ILF3-AS1;19;10762538;10764520;1982;0
9341;ENSG00000267102;;17;33736621;33737247;626;0
9342;ENSG00000267106;C19orf82;19;9731967;9756572;24605;0
9343;ENSG00000267108;;18;12432896;12437634;4738;0
9344;ENSG00000267114;;19;45453301;45457264;3963;0
9345;ENSG00000267119;;19;9930817;9931131;314;0
9346;ENSG00000267121;;17;43268298;43299589;31291;0
9347;ENSG00000267127;;18;77794346;77854968;60622;0
9348;ENSG00000267128;RNF157-AS1;17;74136637;74150731;14094;0
9349;ENSG00000267138;;19;3754618;3756657;2039;0
9350;ENSG00000267144;;19;44527756;44529414;1658;0
9351;ENSG00000267152;;19;38219487;38221544;2057;0
9352;ENSG00000267160;;17;42751057;42753625;2568;0
9353;ENSG00000267161;;19;1573595;1575474;1879;0
9354;ENSG00000267167;;18;44383187;44383857;670;0
9355;ENSG00000267169;;19;14247991;14282079;34088;1
9356;ENSG00000267185;PTP4A2P1;17;40685550;40686027;477;0
9357;ENSG00000267191;;19;44406153;44430697;24544;0
9358;ENSG00000267194;;17;67547499;67550002;2503;0
9359;ENSG00000267198;;17;43623170;43640596;17426;0
9360;ENSG00000267199;;18;12438889;12448204;9315;0
9361;ENSG00000267213;;19;32880956;32896466;15510;0
9362;ENSG00000267219;;19;34839261;34850317;11056;0
9363;ENSG00000267221;;17;40192731;40195135;2404;0
9364;ENSG00000267226;;18;56337712;56339109;1397;0
9365;ENSG00000267228;;18;44661027;44702652;41625;0
9366;ENSG00000267230;;17;41127706;41129292;1586;0
9367;ENSG00000267242;;19;44978645;44979403;758;0
9368;ENSG00000267246;;17;43627147;43636104;8957;0
9369;ENSG00000267247;;18;12230410;12231572;1162;0
9370;ENSG00000267248;;17;58203896;58213005;9109;0
9371;ENSG00000267249;;18;12670425;12671144;719;0
9372;ENSG00000267251;;18;77941563;77960875;19312;0
9373;ENSG00000267254;;19;37288420;37319017;30597;0
9374;ENSG00000267260;;19;37264055;37267980;3925;0
9375;ENSG00000267263;;17;75465150;75467127;1977;0
9376;ENSG00000267264;;19;28294446;28294968;522;0
9377;ENSG00000267268;;19;20011777;20074273;62496;0
9378;ENSG00000267270;;18;77905807;77936315;30508;0
9379;ENSG00000267274;;19;12050774;12064196;13422;0
9380;ENSG00000267277;;19;11478799;11485611;6812;0
9381;ENSG00000267283;;19;1989400;1990369;969;0
9382;ENSG00000267293;;18;43608272;43609795;1523;0
9383;ENSG00000267305;;19;239145;239247;102;0
9384;ENSG00000267309;;19;36980551;36981942;1391;0
9385;ENSG00000267313;;18;39047395;39212149;164754;0
9386;ENSG00000267317;;19;1457664;1462764;5100;0
9387;ENSG00000267319;;19;38184181;38184465;284;0
9388;ENSG00000267321;;17;33895139;33901811;6672;0
9389;ENSG00000267322;;18;47340393;47377429;37036;0
9390;ENSG00000267327;;18;53560269;53690753;130484;0
9391;ENSG00000267340;;17;41321897;41322094;197;0
9392;ENSG00000267345;;19;37566015;37569507;3492;0
9393;ENSG00000267348;;19;45579768;45593649;13881;0
9394;ENSG00000267350;;17;18227536;18229211;1675;0
9395;ENSG00000267365;KCNJ2-AS1;17;68163102;68165543;2441;0
9396;ENSG00000267370;;19;9866828;9867539;711;0
9397;ENSG00000267374;LINC00669;18;36786888;37380282;593394;0
9398;ENSG00000267381;;19;37978901;37979554;653;0
9399;ENSG00000267383;;19;20236186;20432114;195928;0
9400;ENSG00000267385;;19;4528439;4540079;11640;0
9401;ENSG00000267388;;19;36451414;36454965;3551;0
9402;ENSG00000267390;;18;61034561;61048862;14301;0
9403;ENSG00000267395;;19;46271054;46275762;4708;0
9404;ENSG00000267397;;18;33296334;33297942;1608;0
9405;ENSG00000267414;;18;42256892;42259682;2790;0
9406;ENSG00000267416;;17;58156670;58166056;9386;0
9407;ENSG00000267419;;19;19887411;19945736;58325;0
9408;ENSG00000267422;;19;38270326;38283505;13179;0
9409;ENSG00000267427;;19;6210390;6212492;2102;0
9410;ENSG00000267436;;19;3544197;3557567;13370;0
9411;ENSG00000267470;ZNF571-AS1;19;38039816;38078249;38433;0
9412;ENSG00000267473;;19;38888821;38890521;1700;0
9413;ENSG00000267475;;19;33177995;33182656;4661;0
9414;ENSG00000267481;;19;19899564;19901340;1776;0
9415;ENSG00000267493;CIRBP-AS1;19;1268165;1270240;2075;0
9416;ENSG00000267500;;19;11759179;11763692;4513;0
9417;ENSG00000267506;;17;75543022;75559325;16303;1
9418;ENSG00000267508;ZNF285;19;44886459;44905774;19315;0
9419;ENSG00000267519;MIR24-2;19;13945330;13947173;1843;0
9420;ENSG00000267534;S1PR2;19;10334520;10341948;7428;0
9421;ENSG00000267543;;17;74546033;74546908;875;0
9422;ENSG00000267546;;17;74541750;74553765;12015;0
9423;ENSG00000267547;;17;33730856;33731392;536;0
9424;ENSG00000267575;;19;28284371;28409771;125400;0
9425;ENSG00000267583;;18;33023833;33047052;23219;0
9426;ENSG00000267586;LINC00907;18;39739247;40271387;532140;0
9427;ENSG00000267594;CYP4F24P;19;15871051;15890719;19668;0
9428;ENSG00000267595;;17;41320187;41320266;79;0
9429;ENSG00000267632;;17;40661802;40663537;1735;0
9430;ENSG00000267634;RPL7L1P5;17;42442382;42443119;737;0
9431;ENSG00000267640;;19;38307999;38317278;9279;0
9432;ENSG00000267651;;18;34814082;34816205;2123;1
9433;ENSG00000267655;;18;76877207;76877920;713;0
9434;ENSG00000267668;;17;36002976;36044255;41279;0
9435;ENSG00000267680;ZNF224;19;44598492;44612479;13987;0
9436;ENSG00000267681;;17;41296973;41297272;299;0
9437;ENSG00000267682;;19;37828138;37828645;507;0
9438;ENSG00000267692;TAF9P3;19;30528192;30528318;126;0
9439;ENSG00000267707;;18;34823739;34827179;3440;0
9440;ENSG00000267711;;17;33727897;33730025;2128;0
9441;ENSG00000267723;;19;14365001;14404017;39016;0
9442;ENSG00000267731;;17;66186025;66188943;2918;0
9443;ENSG00000267741;UBE2L4;19;9885173;9885636;463;0
9444;ENSG00000267745;;17;33733703;33736787;3084;0
9445;ENSG00000267746;;18;31802929;31804725;1796;0
9446;ENSG00000267750;;17;42376942;42392683;15741;0
9447;ENSG00000267751;;19;567212;572215;5003;0
9448;ENSG00000267756;;18;14074911;14075740;829;0
9449;ENSG00000267759;;19;1413900;1414734;834;0
9450;ENSG00000267767;;19;35279486;35323773;44287;0
9451;ENSG00000267778;;19;1238178;1239521;1343;0
9452;ENSG00000267786;;19;36438017;36450094;12077;0
9453;ENSG00000267796;LIN37;19;36239262;36245420;6158;0
9454;ENSG00000267809;NDUFV2P1;19;53727226;53728132;906;0
9455;ENSG00000267852;;19;7455408;7459925;4517;0
9456;ENSG00000267855;NDUFA7;19;8373490;8386280;12790;0
9457;ENSG00000267868;;13;113619149;113620445;1296;0
9458;ENSG00000267886;;19;23258003;23283163;25160;1
9459;ENSG00000267890;;19;50578380;50579159;779;0
9460;ENSG00000267896;;19;50363139;50363771;632;0
9461;ENSG00000267904;;19;16750778;16751479;701;0
9462;ENSG00000267909;;14;70038216;70040339;2123;0
9463;ENSG00000267938;;19;4347777;4349058;1281;0
9464;ENSG00000267939;;19;8073613;8080909;7296;0
9465;ENSG00000267980;;19;4363786;4364637;851;0
9466;ENSG00000268001;;19;48758932;48761456;2524;0
9467;ENSG00000268006;PTOV1-AS1;19;50341896;50354933;13037;1
9468;ENSG00000268041;;19;42412671;42414249;1578;0
9469;ENSG00000268061;NAPA-AS1;19;47987539;48004854;17315;0
9470;ENSG00000268166;;19;40526292;40526948;656;0
9471;ENSG00000268218;;16;89334512;89339452;4940;0
9472;ENSG00000268225;;19;53365060;53366119;1059;0
9473;ENSG00000268231;;19;51058627;51061226;2599;0
9474;ENSG00000268262;;19;39805291;39811498;6207;0
9475;ENSG00000268357;VN1R81P;19;21306620;21306991;371;0
9476;ENSG00000268362;;19;24216247;24249711;33464;1
9477;ENSG00000268401;;19;46530912;46533419;2507;0
9478;ENSG00000268460;;19;46706683;46718094;11411;0
9479;ENSG00000268499;;19;38690476;38691574;1098;0
9480;ENSG00000268521;VN1R83P;19;21472356;21472800;444;0
9481;ENSG00000268565;;19;4654976;4655536;560;0
9482;ENSG00000268573;;18;32860831;32870165;9334;1
9483;ENSG00000268613;;19;53638190;53638575;385;0
9484;ENSG00000268658;LINC00664;19;21666176;21686040;19864;1
9485;ENSG00000268670;;19;4061613;4062747;1134;0
9486;ENSG00000268743;;19;16954836;16957284;2448;0
9487;ENSG00000268747;;19;21458825;21459134;309;0
9488;ENSG00000268751;SCGB1B2P;19;35067638;35068606;968;0
9489;ENSG00000268758;EMR4P;19;6952511;6990857;38346;0
9490;ENSG00000268798;;19;1440838;1441937;1099;0
9491;ENSG00000268834;OR7A1P;19;15002707;15003616;909;0
9492;ENSG00000268863;;16;30996808;30997533;725;0
9493;ENSG00000268927;;16;70695570;70699739;4169;0
9494;ENSG00000268945;;19;12793507;12798093;4586;0
9495;ENSG00000268965;;17;76422409;76422834;425;0
9496;ENSG00000268995;VN1R82P;19;21371401;21371756;355;0
9497;ENSG00000269001;ZNF818P;19;53716241;53716649;408;0
9498;ENSG00000269044;;19;16744614;16746080;1466;0
9499;ENSG00000269051;;19;53700364;53714268;13904;1
9500;ENSG00000269067;ZNF728;19;23158270;23185978;27708;1
9501;ENSG00000269069;;19;40529291;40531409;2118;0
9502;ENSG00000269139;;19;7990886;7991648;762;0
9503;ENSG00000269235;HCCAT3;19;52452387;52484620;32233;0
9504;ENSG00000269292;;19;47112534;47114036;1502;0
9505;ENSG00000269318;;19;4356634;4358445;1811;0
9506;ENSG00000269352;;19;50360227;50362546;2319;0
9507;ENSG00000269374;;19;42989228;42989866;638;0
9508;ENSG00000269378;ITGB1P1;19;14732446;14733054;608;0
9509;ENSG00000269386;RAB11B-AS1;19;8439257;8455569;16312;0
9510;ENSG00000269388;;19;52097814;52109403;11589;0
9511;ENSG00000269397;;19;24110590;24112089;1499;0
9512;ENSG00000269399;;19;16653434;16655625;2191;0
9513;ENSG00000269416;;19;23582035;23598877;16842;0
9514;ENSG00000269421;ZNF92P3;19;24118022;24118975;953;0
9515;ENSG00000269423;;19;48969623;48970237;614;0
9516;ENSG00000269425;;19;4339574;4343488;3914;0
9517;ENSG00000269439;;19;17599799;17622698;22899;0
9518;ENSG00000269483;;19;52343177;52346577;3400;0
9519;ENSG00000269657;;17;66539369;66542970;3601;0
9520;ENSG00000269688;;19;39335369;39336139;770;0
9521;ENSG00000269693;;19;12636534;12691789;55255;0
9522;ENSG00000269755;;19;12543917;12595630;51713;0
9523;ENSG00000269779;;19;20874142;20880421;6279;0
9524;ENSG00000269814;;19;49016464;49016917;453;0
9525;ENSG00000269815;;19;17407005;17407504;499;0
9526;ENSG00000269825;;19;53153690;53156537;2847;0
9527;ENSG00000269834;;19;52892095;52901019;8924;0
9528;ENSG00000269837;;19;23437855;23440741;2886;0
9529;ENSG00000269858;EGLN2;19;41304901;41314338;9437;0
9530;ENSG00000269883;;14;77607026;77609339;2313;0
9531;ENSG00000269906;;14;51129229;51129896;667;0
9532;ENSG00000269928;;17;8128139;8128798;659;0
9533;ENSG00000269935;;16;87634132;87635796;1664;0
9534;ENSG00000269937;;16;2611472;2615097;3625;0
9535;ENSG00000269940;;14;104160897;104161507;610;0
9536;ENSG00000269942;;13;103331776;103332308;532;0
9537;ENSG00000269947;;17;8181081;8181754;673;1
9538;ENSG00000269951;;15;77359996;77360667;671;1
9539;ENSG00000269958;;14;104162690;104163500;810;0
9540;ENSG00000269959;SPACA6P-AS;19;52188616;52196709;8093;0
9541;ENSG00000269963;;14;104179904;104180586;682;0
9542;ENSG00000270010;;17;40190250;40190752;502;0
9543;ENSG00000270011;ZNF559-ZNF177;19;9434850;9493293;58443;0
9544;ENSG00000270015;;15;31218717;31220610;1893;0
9545;ENSG00000270016;;15;30899898;30900396;498;0
9546;ENSG00000270020;;16;86553989;86557503;3514;0
9547;ENSG00000270049;;16;67515217;67521153;5936;0
9548;ENSG00000270055;;15;30780166;30782516;2350;0
9549;ENSG00000270062;;14;51190495;51190990;495;0
9550;ENSG00000270091;;17;19799903;19800600;697;0
9551;ENSG00000270108;;14;104153913;104154464;551;0
9552;ENSG00000270124;;16;85613615;85617177;3562;0
9553;ENSG00000270127;;15;101087972;101090358;2386;0
9554;ENSG00000270143;;19;15346330;15346819;489;0
9555;ENSG00000270145;;17;38459457;38460909;1452;0
9556;ENSG00000270165;;16;67772491;67773825;1334;0
9557;ENSG00000270173;;15;30649969;30650976;1007;0
9558;ENSG00000270246;SNORD109A;15;25287065;25287575;510;1
9559;ENSG00000270248;;19;52613571;52613979;408;0
9560;ENSG00000270580;;16;15198580;15225458;26878;0
9561;ENSG00000270581;;13;103053821;103054807;986;0
9562;ENSG00000270704;SNORD64;15;25230011;25230320;309;0
9563;ENSG00000270876;;19;35414203;35417716;3513;0
9564;ENSG00000270878;;14;64060749;64062009;1260;0
9565;ENSG00000270964;;15;67833410;67834942;1532;0
9566;ENSG00000271009;;16;73094369;73096215;1846;0
9567;ENSG00000271105;SCML2P2;16;25080891;25081430;539;0
9568;ENSG00000271109;;19;35340182;35351480;11298;0
9569;ENSG00000271150;;19;48297907;48298177;270;0
9570;ENSG00000271283;;19;19810012;19810218;206;0
9571;ENSG00000271347;;15;25236633;25236900;267;0
9572;ENSG00000271417;;14;101433989;101452987;18998;0
9573;ENSG00000271725;;15;81595556;81601732;6176;0
9574;ENSG00000271776;;13;79170264;79173754;3490;0
9575;ENSG00000271780;;14;102414684;102415762;1078;0
9576;ENSG00000271819;;15;50639620;50639726;106;0
9577;ENSG00000271851;;17;9456640;9459013;2373;0
9578;ENSG00000271983;;15;80985557;80986048;491;0
9579;ENSG00000271997;;15;89045175;89049018;3843;0
9580;ENSG00000272003;;15;42188137;42189031;894;0
9581;ENSG00000272079;;16;3056121;3057386;1265;0
9582;ENSG00000272098;;19;197075;199431;2356;0
9583;ENSG00000272143;FGF14-AS2;13;103046980;103048053;1073;0
9584;ENSG00000272158;;14;65470043;65470485;442;0
9585;ENSG00000272250;;16;73094144;73094658;514;0
9586;ENSG00000272349;;13;102369198;102369728;530;0
9587;ENSG00000272444;;14;102418753;102419400;647;0
9588;ENSG00000272515;;13;88260162;88261489;1327;0
9589;ENSG00000272542;;13;103541208;103542184;976;0
9590;ENSG00000272636;DOC2B;17;5810;31427;25617;0
9591;ENSG00000272658;;14;24778161;24781252;3091;0
9592;ENSG00000272688;;18;3246399;3247084;685;0
9593;ENSG00000272695;GAS6-AS2;13;114567141;114569806;2665;0
9594;ENSG00000272788;;18;8801654;8802303;649;0
9595;ENSG00000272828;;14;64929946;64930175;229;0
9596;ENSG00000272888;;15;93425937;93441975;16038;0
9597;ENSG00000272909;;14;64907087;64908956;1869;1
9598;ENSG00000273018;;17;18414535;18455019;40484;0
9599;ENSG00000273087;;14;101203922;101204561;639;0
9600;ENSG00000273173;;15;25200133;25223729;23596;0
9601;ENSG00000273284;;18;9259386;9260388;1002;0
9602;ENSG00000273290;;17;10575791;10579323;3532;0
9603;ENSG00000273321;;18;21982117;21982678;561;0
9604;ENSG00000273355;;18;813275;813757;482;0
9605;ENSG00000000419;DPM1;20;49551404;49575092;23688;0
9606;ENSG00000001617;SEMA3F;3;50192478;50226508;34030;0
9607;ENSG00000002549;LAP3;4;17578815;17609595;30780;0
9608;ENSG00000002587;HS3ST1;4;11394774;11431389;36615;1
9609;ENSG00000003137;CYP26B1;2;72356367;72375167;18800;0
9610;ENSG00000003393;ALS2;2;202565277;202645912;80635;0
9611;ENSG00000003400;CASP10;2;202047604;202094129;46525;0
9612;ENSG00000003402;CFLAR;2;201980827;202041410;60583;0
9613;ENSG00000003436;TFPI;2;188328957;188430487;101530;0
9614;ENSG00000003509;NDUFAF7;2;37458774;37480546;21772;0
9615;ENSG00000003756;RBM5;3;50126341;50156454;30113;0
9616;ENSG00000004399;PLXND1;3;129274018;129325661;51643;0
9617;ENSG00000004534;RBM6;3;49977440;50137478;160038;0
9618;ENSG00000004838;ZMYND10;3;50378541;50384283;5742;0
9619;ENSG00000005059;CCDC109B;4;110481361;110609874;128513;1
9620;ENSG00000005436;GCFC2;2;75879126;75938115;58989;0
9621;ENSG00000005448;WDR54;2;74648805;74652882;4077;0
9622;ENSG00000006607;FARP2;2;242295658;242434256;138598;0
9623;ENSG00000007001;UPP2;2;158733214;158992666;259452;0
9624;ENSG00000007062;PROM1;4;15964699;16086001;121302;0
9625;ENSG00000007402;CACNA2D2;3;50400233;50541675;141442;0
9626;ENSG00000008226;DLEC1;3;38080696;38165516;84820;0
9627;ENSG00000008300;CELSR3;3;48673902;48700348;26446;0
9628;ENSG00000008324;SS18L2;3;42623332;42636606;13274;0
9629;ENSG00000008735;MAPK8IP2;22;51039114;51052409;13295;0
9630;ENSG00000008869;HEATR5B;2;37195526;37311485;115959;0
9631;ENSG00000008952;SEC62;3;169684423;169716161;31738;0
9632;ENSG00000010256;UQCRC1;3;48636435;48648409;11974;0
9633;ENSG00000010318;PHF7;3;52444673;52457657;12984;0
9634;ENSG00000010322;NISCH;3;52489134;52527087;37953;0
9635;ENSG00000011198;ABHD5;3;43731605;43775863;44258;0
9636;ENSG00000011376;LARS2;3;45429998;45590913;160915;0
9637;ENSG00000011523;CEP68;2;65283500;65314138;30638;0
9638;ENSG00000011566;MAP4K3;2;39476407;39664453;188046;0
9639;ENSG00000012171;SEMA3B;3;50304990;50314977;9987;1
9640;ENSG00000013016;EHD3;2;31456880;31492313;35433;0
9641;ENSG00000013288;MAN2B2;4;6576902;6625089;48187;0
9642;ENSG00000013293;SLC7A14;3;170177372;170303863;126491;0
9643;ENSG00000013297;CLDN11;3;170136653;170578169;441516;0
9644;ENSG00000013441;CLK1;2;201717732;201729422;11690;0
9645;ENSG00000013810;TACC3;4;1723227;1746898;23671;0
9646;ENSG00000014641;MDH1;2;63815743;63834331;18588;0
9647;ENSG00000014824;SLC30A9;4;41992489;42092474;99985;0
9648;ENSG00000015475;BID;22;18216906;18257536;40630;0
9649;ENSG00000015568;RGPD5;2;110550335;110615272;64937;0
9650;ENSG00000016391;CHDH;3;53846362;53880417;34055;0
9651;ENSG00000016864;GLT8D1;3;52728505;52740048;11543;0
9652;ENSG00000017260;ATP2C1;3;130569439;130735556;166117;0
9653;ENSG00000018189;RUFY3;4;71569921;71673032;103111;0
9654;ENSG00000018408;WWTR1;3;149235022;149454501;219479;0
9655;ENSG00000018510;AGPS;2;178257372;178408564;151192;0
9656;ENSG00000018607;ZNF806;2;133066882;133076309;9427;0
9657;ENSG00000018699;TTC27;2;32853099;33046118;193019;0
9658;ENSG00000018869;ZNF582;19;56887413;56904914;17501;0
9659;ENSG00000019186;CYP24A1;20;52769988;52790512;20524;0
9660;ENSG00000020256;ZFP64;20;50668202;50820847;152645;0
9661;ENSG00000021574;SPAST;2;32288680;32382706;94026;0
9662;ENSG00000021826;CPS1;2;211342406;211543831;201425;1
9663;ENSG00000022277;RTFDC1;20;55043647;55093943;50296;0
9664;ENSG00000023228;NDUFS1;2;206979541;207024327;44786;0
9665;ENSG00000023330;ALAS1;3;52232102;52248343;16241;0
9666;ENSG00000025293;PHF20;20;34359896;34538303;178407;0
9667;ENSG00000025770;NCAPH2;22;50946645;50961901;15256;0
9668;ENSG00000025772;TOMM34;20;43570771;43589127;18356;0
9669;ENSG00000026036;RTEL1-TNFRSF6B;20;62290653;62330037;39384;0
9670;ENSG00000026559;KCNG1;20;49620193;49639666;19473;0
9671;ENSG00000028116;VRK2;2;58134786;58387055;252269;1
9672;ENSG00000028310;BRD9;5;850406;892939;42533;0
9673;ENSG00000029559;IBSP;4;88720733;88733074;12341;0
9674;ENSG00000030419;IKZF2;2;213864429;214017151;152722;0
9675;ENSG00000031081;ARHGAP31;3;119013220;119139561;126341;0
9676;ENSG00000032389;TSSC1;2;3192696;3381653;188957;0
9677;ENSG00000033178;UBA6;4;68478370;68566897;88527;0
9678;ENSG00000033867;SLC4A7;3;27414214;27525911;111697;0
9679;ENSG00000034510;TMSB10;2;85132749;85133795;1046;0
9680;ENSG00000034533;ASTE1;3;130732719;130746493;13774;0
9681;ENSG00000035115;SH3YL1;2;217730;266398;48668;0
9682;ENSG00000035141;FAM136A;2;70523107;70529222;6115;0
9683;ENSG00000035499;DEPDC1B;5;59892739;59996017;103278;0
9684;ENSG00000035928;RFC1;4;39289076;39367995;78919;0
9685;ENSG00000036054;TBC1D23;3;99979844;100044095;64251;0
9686;ENSG00000036257;CUL3;2;225334867;225450110;115243;0
9687;ENSG00000037474;NSUN2;5;6599352;6633404;34052;0
9688;ENSG00000038002;AGA;4;178351924;178363657;11733;0
9689;ENSG00000038210;PI4K2B;4;25162263;25280714;118451;0
9690;ENSG00000038219;BOD1L1;4;13570362;13629347;58985;0
9691;ENSG00000038295;TLL1;4;166794410;167025047;230637;1
9692;ENSG00000038382;TRIO;5;14143811;14532235;388424;0
9693;ENSG00000039123;SKIV2L2;5;54603588;54721409;117821;0
9694;ENSG00000039139;DNAH5;5;13690440;13944652;254212;0
9695;ENSG00000039537;C6;5;41142336;41261540;119204;0
9696;ENSG00000039560;RAI14;5;34656342;34832732;176390;0
9697;ENSG00000040608;RTN4R;22;20228938;20270769;41831;0
9698;ENSG00000040731;CDH10;5;24487209;24645087;157878;0
9699;ENSG00000040933;INPP4A;2;99061317;99210853;149536;0
9700;ENSG00000041802;LSG1;3;194361517;194393206;31689;0
9701;ENSG00000041880;PARP3;3;51976361;51982883;6522;1
9702;ENSG00000042062;FAM65C;20;49202645;49308065;105420;0
9703;ENSG00000042445;RETSAT;2;85569211;85581743;12532;0
9704;ENSG00000043093;DCUN1D1;3;182655862;182703741;47879;0
9705;ENSG00000044524;EPHA3;3;89156674;89531284;374610;0
9706;ENSG00000047315;POLR2B;4;57843888;57897334;53446;0
9707;ENSG00000047365;ARAP2;4;35949843;36246131;296288;0
9708;ENSG00000047457;CP;3;148880197;148939842;59645;0
9709;ENSG00000047662;FAM184B;4;17630929;17783135;152206;0
9710;ENSG00000047849;MAP4;3;47892182;48130769;238587;0
9711;ENSG00000048342;CC2D2A;4;15471489;15603180;131691;0
9712;ENSG00000048991;R3HDM1;2;136289025;136482840;193815;0
9713;ENSG00000049167;ERCC8;5;60169658;60240900;71242;0
9714;ENSG00000049192;ADAMTS6;5;64444563;64777747;333184;0
9715;ENSG00000049323;LTBP1;2;33172039;33624576;452537;1
9716;ENSG00000049656;CLPTM1L;5;1317859;1345214;27355;0
9717;ENSG00000049860;HEXB;5;73935848;74018472;82624;0
9718;ENSG00000049883;PTCD2;5;71616194;71656052;39858;0
9719;ENSG00000050730;TNIP3;4;122052563;122148621;96058;0
9720;ENSG00000051341;POLQ;3;121150278;121264853;114575;1
9721;ENSG00000051382;PIK3CB;3;138372860;138553780;180920;0
9722;ENSG00000052795;FNIP2;4;159690290;159829201;138911;0
9723;ENSG00000052802;MSMO1;4;166248775;166264312;15537;0
9724;ENSG00000053438;NNAT;20;36149617;36152092;2475;0
9725;ENSG00000053524;MCF2L2;3;182895831;183146566;250735;0
9726;ENSG00000053900;ANAPC4;4;25378835;25420120;41285;0
9727;ENSG00000054356;PTPRN;2;220154345;220174370;20025;0
9728;ENSG00000054611;TBC1D22A;22;47158518;47571336;412818;0
9729;ENSG00000054793;ATP9A;20;50213053;50385173;172120;0
9730;ENSG00000055044;NOP58;2;203130439;203168389;37950;0
9731;ENSG00000055332;EIF2AK2;2;37326353;37384208;57855;0
9732;ENSG00000055813;CCDC85A;2;56411258;56613308;202050;0
9733;ENSG00000055917;PUM2;2;20448452;20551995;103543;0
9734;ENSG00000055955;ITIH4;3;52846991;52865495;18504;0
9735;ENSG00000056050;C4orf27;4;170650616;170679104;28488;0
9736;ENSG00000056097;ZFR;5;32354456;32444867;90411;0
9737;ENSG00000056291;NPFFR2;4;72897521;73013784;116263;0
9738;ENSG00000056487;PHF21B;22;45277042;45405880;128838;0
9739;ENSG00000056736;IL17RB;3;53880607;53899827;19220;0
9740;ENSG00000057019;DCBLD2;3;98514785;98620533;105748;0
9741;ENSG00000057935;MTA3;2;42721709;42984087;262378;0
9742;ENSG00000058056;USP13;3;179370543;179507189;136646;0
9743;ENSG00000058063;ATP11B;3;182511288;182639423;128135;0
9744;ENSG00000058262;SEC61A1;3;127770484;127790526;20042;0
9745;ENSG00000058866;DGKG;3;185823457;186080026;256569;1
9746;ENSG00000059691;PET112;4;152591656;152682175;90519;0
9747;ENSG00000059728;MXD1;2;70124820;70170077;45257;0
9748;ENSG00000060491;OGFR;20;61436187;61445352;9165;0
9749;ENSG00000060971;ACAA1;3;38144620;38178733;34113;0
9750;ENSG00000061656;SPAG4;20;34203814;34208971;5157;0
9751;ENSG00000061676;NCKAP1;2;183773843;183903586;129743;0
9752;ENSG00000061918;GUCY1B3;4;156680144;156728743;48599;0
9753;ENSG00000061938;TNK2;3;195590235;195638816;48581;0
9754;ENSG00000062194;GPBP1;5;56469775;56560506;90731;0
9755;ENSG00000062598;ELMO2;20;44994688;45061704;67016;0
9756;ENSG00000063241;ISOC2;19;55964352;55973710;9358;0
9757;ENSG00000063244;U2AF2;19;56165512;56186081;20569;0
9758;ENSG00000063245;EPN1;19;56186592;56221224;34632;0
9759;ENSG00000063438;AHRR;5;304291;438406;134115;0
9760;ENSG00000063660;GPC1;2;241375088;241407493;32405;0
9761;ENSG00000063978;RNF4;4;2463947;2627047;163100;0
9762;ENSG00000064012;CASP8;2;202098166;202152434;54268;1
9763;ENSG00000064042;LIMCH1;4;41361624;41702061;340437;0
9764;ENSG00000064225;ST3GAL6;3;98451080;98540045;88965;0
9765;ENSG00000064601;CTSA;20;44518783;44527459;8676;0
9766;ENSG00000064655;EYA2;20;45523263;45817492;294229;0
9767;ENSG00000064933;PMS1;2;190649107;190742355;93248;0
9768;ENSG00000064989;CALCRL;2;188207856;188313187;105331;0
9769;ENSG00000065413;ANKRD44;2;197831741;198175897;344156;0
9770;ENSG00000065485;PDIA5;3;122785909;122944074;158165;1
9771;ENSG00000065518;NDUFB4;3;120315156;120321347;6191;0
9772;ENSG00000065534;MYLK;3;123328896;123603178;274282;0
9773;ENSG00000065548;ZC3H15;2;187350883;187374090;23207;0
9774;ENSG00000065802;ASB1;2;239335383;239360891;25508;0
9775;ENSG00000065882;TBC1D1;4;37892708;38140796;248088;0
9776;ENSG00000065911;MTHFD2;2;74425689;74444692;19003;1
9777;ENSG00000066032;CTNNA2;2;79412357;80875905;1463548;0
9778;ENSG00000066248;NGEF;2;233743396;233877982;134586;0
9779;ENSG00000066422;ZBTB11;3;101367733;101396339;28606;0
9780;ENSG00000067113;PPAP2A;5;54720682;54830878;110196;0
9781;ENSG00000067248;DHX29;5;54552073;54603550;51477;0
9782;ENSG00000067560;RHOA;3;49396578;49450431;53853;0
9783;ENSG00000068001;HYAL2;3;50355221;50360337;5116;0
9784;ENSG00000068024;HDAC4;2;239969864;240323348;353484;0
9785;ENSG00000068028;RASSF1;3;50367219;50378411;11192;0
9786;ENSG00000068078;FGFR3;4;1795034;1810599;15565;0
9787;ENSG00000068615;REEP1;2;86441116;86565206;124090;0
9788;ENSG00000068654;POLR1A;2;86247339;86333278;85939;0
9789;ENSG00000068697;LAPTM4A;2;20232411;20251789;19378;0
9790;ENSG00000068724;TTC7A;2;47143296;47303276;159980;0
9791;ENSG00000068745;IP6K2;3;48725436;48777786;52350;0
9792;ENSG00000068784;SRBD1;2;45615819;45839304;223485;0
9793;ENSG00000068796;KIF2A;5;61601989;61833076;231087;0
9794;ENSG00000068878;PSME4;2;54091204;54197977;106773;0
9795;ENSG00000068885;IFT80;3;159974774;160117668;142894;0
9796;ENSG00000068912;ERLEC1;2;54014181;54045956;31775;0
9797;ENSG00000069020;MAST4;5;65892176;66465423;573247;0
9798;ENSG00000069849;ATP1B3;3;141594966;141645356;50390;0
9799;ENSG00000069998;CECR5;22;17618401;17646177;27776;0
9800;ENSG00000070010;UFD1L;22;19437433;19466738;29305;0
9801;ENSG00000070087;PFN2;3;149682691;149768575;85884;0
9802;ENSG00000070193;FGF10;5;44303646;44389808;86162;0
9803;ENSG00000070371;CLTCL1;22;19166986;19279239;112253;0
9804;ENSG00000070413;DGCR2;22;19023795;19109967;86172;0
9805;ENSG00000070476;ZXDC;3;126156444;126194762;38318;0
9806;ENSG00000070950;RAD18;3;8817088;9005457;188369;0
9807;ENSG00000071051;NCK2;2;106361354;106510730;149376;0
9808;ENSG00000071054;MAP4K4;2;102313312;102511149;197837;0
9809;ENSG00000071073;MGAT4A;2;99235569;99347589;112020;0
9810;ENSG00000071082;RPL31;2;101618177;101640494;22317;0
9811;ENSG00000071127;WDR1;4;10075963;10118573;42610;0
9812;ENSG00000071205;ARHGAP10;4;148653214;148993931;340717;0
9813;ENSG00000071282;LMCD1;3;8543393;8609805;66412;0
9814;ENSG00000071539;TRIP13;5;892758;919472;26714;0
9815;ENSG00000071575;TRIB2;2;12857015;12882860;25845;0
9816;ENSG00000071794;HLTF;3;148747914;148804341;56427;0
9817;ENSG00000071909;MYO3B;2;171034655;171511681;477026;1
9818;ENSG00000071967;CYBRD1;2;172378757;172414643;35886;0
9819;ENSG00000072135;PTPN18;2;131113580;131132982;19402;0
9820;ENSG00000072163;LIMS2;2;128395956;128439360;43404;0
9821;ENSG00000072182;ASIC4;2;220378892;220403494;24602;0
9822;ENSG00000072195;SPEG;2;220299568;220363009;63441;0
9823;ENSG00000072201;LNX1;4;54325468;54567572;242104;0
9824;ENSG00000072274;TFRC;3;195754054;195809060;55006;0
9825;ENSG00000072756;TRNT1;3;3168600;3192563;23963;0
9826;ENSG00000072832;CRMP1;4;5749811;5894785;144974;0
9827;ENSG00000072840;EVC;4;5712924;5830772;117848;0
9828;ENSG00000072858;SIDT1;3;113251143;113348425;97282;1
9829;ENSG00000073111;MCM2;3;127317066;127341276;24210;0
9830;ENSG00000073146;MOV10L1;22;50528308;50600119;71811;0
9831;ENSG00000073150;PANX2;22;50609160;50618723;9563;0
9832;ENSG00000073169;;22;50639408;50656045;16637;0
9833;ENSG00000073282;TP63;3;189349205;189615068;265863;0
9834;ENSG00000073331;ALPK1;4;113206665;113363776;157111;0
9835;ENSG00000073578;SDHA;5;218356;256815;38459;0
9836;ENSG00000073711;PPP2R3A;3;135684515;135866733;182218;0
9837;ENSG00000073734;ABCB11;2;169779448;169887832;108384;0
9838;ENSG00000073792;IGF2BP2;3;185361527;185542844;181317;0
9839;ENSG00000073803;MAP3K13;3;185000729;185206885;206156;0
9840;ENSG00000073849;ST6GAL1;3;186648274;186796341;148067;0
9841;ENSG00000074047;GLI2;2;121493199;121750229;257030;1
9842;ENSG00000074054;CLASP1;2;122095352;122407163;311811;0
9843;ENSG00000074211;PPP2R2C;4;6322305;6565327;243022;0
9844;ENSG00000074416;MGLL;3;127407909;127542051;134142;0
9845;ENSG00000074582;BCS1L;2;219523487;219528166;4679;0
9846;ENSG00000075043;KCNQ2;20;62037542;62103993;66451;0
9847;ENSG00000075218;GTSE1;22;46692638;46726707;34069;1
9848;ENSG00000075234;TTC38;22;46663858;46689905;26047;0
9849;ENSG00000075240;GRAMD4;22;46971909;47075688;103779;0
9850;ENSG00000075275;CELSR1;22;46756731;46933067;176336;0
9851;ENSG00000075292;ZNF638;2;71503691;71662199;158508;0
9852;ENSG00000075340;ADD2;2;70834750;70995357;160607;0
9853;ENSG00000075420;FNDC3B;3;171757418;172119455;362037;0
9854;ENSG00000075426;FOSL2;2;28615315;28640179;24864;1
9855;ENSG00000075539;FRYL;4;48499378;48782339;282961;0
9856;ENSG00000075568;TMEM131;2;98372799;98612388;239589;0
9857;ENSG00000075651;PLD1;3;171318195;171528740;210545;0
9858;ENSG00000075711;DLG1;3;196769431;197026171;256740;0
9859;ENSG00000075785;RAB7A;3;128444965;128533639;88674;0
9860;ENSG00000075884;ARHGAP15;2;143848931;144525921;676990;1
9861;ENSG00000075914;EXOSC7;3;45016733;45077558;60825;0
9862;ENSG00000075975;MKRN2;3;12598513;12625212;26699;0
9863;ENSG00000076003;MCM6;2;136597196;136633996;36800;1
9864;ENSG00000076201;PTPN23;3;47422501;47454931;32430;0
9865;ENSG00000076242;MLH1;3;37034823;37107380;72557;0
9866;ENSG00000077044;DGKD;2;234263153;234380750;117597;0
9867;ENSG00000077092;RARB;3;25215823;25639423;423600;0
9868;ENSG00000077097;TOP2B;3;25639475;25706398;66923;0
9869;ENSG00000077232;DNAJC10;2;183580999;183659191;78192;0
9870;ENSG00000077380;DYNC1I2;2;172543919;172604930;61011;0
9871;ENSG00000077684;JADE1;4;129730779;129796379;65600;0
9872;ENSG00000077942;FBLN1;22;45898118;45997015;98897;0
9873;ENSG00000078018;MAP2;2;210288782;210598842;310060;0
9874;ENSG00000078070;MCCC1;3;182733006;182833863;100857;0
9875;ENSG00000078081;LAMP3;3;182840001;182881627;41626;0
9876;ENSG00000078140;UBE2K;4;39699664;39784412;84748;0
9877;ENSG00000078177;N4BP2;4;40058446;40159872;101426;0
9878;ENSG00000078295;ADCY2;5;7396321;7830194;433873;0
9879;ENSG00000078699;CBFA2T2;20;32077881;32237842;159961;0
9880;ENSG00000078747;ITCH;20;32951041;33099198;148157;0
9881;ENSG00000078804;TP53INP2;20;33292094;33301243;9149;0
9882;ENSG00000078814;MYH7B;20;33563206;33590240;27034;0
9883;ENSG00000079150;FKBP7;2;179328391;179343327;14936;0
9884;ENSG00000079156;OSBPL6;2;179059208;179264160;204952;0
9885;ENSG00000079215;SLC1A3;5;36606457;36688436;81979;1
9886;ENSG00000079246;XRCC5;2;216972187;217071026;98839;0
9887;ENSG00000079257;LXN;3;158363611;158390482;26871;0
9888;ENSG00000079263;SP140;2;231067826;231223762;155936;0
9889;ENSG00000079308;TNS1;2;218664512;218867718;203206;0
9890;ENSG00000079785;DDX1;2;15731302;15771235;39933;0
9891;ENSG00000079974;RABL2B;22;51205929;51222091;16162;0
9892;ENSG00000080031;PTPRH;19;55692616;55720874;28258;1
9893;ENSG00000080189;SLC35C2;20;44978167;44993043;14876;0
9894;ENSG00000080200;CRYBG3;3;97595819;97663810;67991;0
9895;ENSG00000080224;EPHA6;3;96533425;97471304;937879;0
9896;ENSG00000080345;RIF1;2;152266397;152364527;98130;0
9897;ENSG00000080493;SLC4A4;4;72053003;72437804;384801;0
9898;ENSG00000080819;CPOX;3;98239976;98312567;72591;0
9899;ENSG00000080822;CLDND1;3;98216756;98241910;25154;0
9900;ENSG00000080839;RBL1;20;35624752;35724398;99646;0
9901;ENSG00000080845;DLGAP4;20;34894258;35157040;262782;0
9902;ENSG00000081051;AFP;4;74296855;74321891;25036;0
9903;ENSG00000081052;COL4A4;2;227867427;228028829;161402;0
9904;ENSG00000081148;IMPG2;3;100941390;101039404;98014;0
9905;ENSG00000081154;PCNP;3;101292939;101313281;20342;0
9906;ENSG00000081307;UBA5;3;132373290;132396941;23651;0
9907;ENSG00000081320;STK17B;2;196998290;197041227;42937;0
9908;ENSG00000081479;LRP2;2;169983619;170219195;235576;0
9909;ENSG00000082068;WDR70;5;37379314;37753537;374223;0
9910;ENSG00000082126;MPP4;2;202509593;202563417;53824;0
9911;ENSG00000082146;STRADB;2;202252581;202345569;92988;0
9912;ENSG00000082153;BZW1;2;201675317;201688569;13252;0
9913;ENSG00000082196;C1QTNF3;5;34019553;34043937;24384;0
9914;ENSG00000082213;C5orf22;5;31532373;31555165;22792;0
9915;ENSG00000082258;CCNT2;2;135675805;135716912;41107;0
9916;ENSG00000082438;COBLL1;2;165510134;165700189;190055;0
9917;ENSG00000082684;SEMA5B;3;122628041;122747452;119411;0
9918;ENSG00000082701;GSK3B;3;119540170;119813264;273094;0
9919;ENSG00000082781;ITGB5;3;124480795;124620265;139470;0
9920;ENSG00000082898;XPO1;2;61704984;61765761;60777;0
9921;ENSG00000082996;RNF13;3;149530495;149679926;149431;0
9922;ENSG00000083312;TNPO1;5;72112139;72212560;100421;0
9923;ENSG00000083720;OXCT1;5;41730167;41870621;140454;0
9924;ENSG00000083807;SLC27A5;19;58990879;59023780;32901;0
9925;ENSG00000083812;ZNF324;19;58978423;58984945;6522;0
9926;ENSG00000083814;ZNF671;19;58231119;58238992;7873;0
9927;ENSG00000083817;ZNF416;19;58082934;58090295;7361;0
9928;ENSG00000083828;ZNF586;19;58281023;58331307;50284;0
9929;ENSG00000083838;ZNF446;19;58985384;58992597;7213;0
9930;ENSG00000083844;ZNF264;19;57702868;57724724;21856;0
9931;ENSG00000083845;RPS5;19;58897767;58906173;8406;0
9932;ENSG00000083857;FAT1;4;187508937;187647876;138939;0
9933;ENSG00000083896;YTHDC1;4;69176105;69215807;39702;0
9934;ENSG00000083937;CHMP2B;3;87276421;87304698;28277;0
9935;ENSG00000084090;STARD7;2;96850597;96874563;23966;0
9936;ENSG00000084092;NOA1;4;57829536;57844989;15453;0
9937;ENSG00000084093;REST;4;57774075;57802010;27935;0
9938;ENSG00000084676;NCOA1;2;24714783;24993571;278788;0
9939;ENSG00000084693;AGBL5;2;27265232;27293490;28258;0
9940;ENSG00000084710;EFR3B;2;25264999;25378243;113244;0
9941;ENSG00000084731;KIF3C;2;26149471;26205618;56147;0
9942;ENSG00000084733;RAB10;2;26256976;26360323;103347;0
9943;ENSG00000084734;GCKR;2;27719709;27746554;26845;0
9944;ENSG00000084754;HADHA;2;26413504;26467594;54090;0
9945;ENSG00000084764;MAPRE3;2;27193480;27250064;56584;0
9946;ENSG00000084774;CAD;2;27440258;27466811;26553;0
9947;ENSG00000085231;TAF9;5;68646811;68665840;19029;0
9948;ENSG00000085274;MYNN;3;169490619;169507504;16885;0
9949;ENSG00000085449;WDFY1;2;224720433;224810104;89671;0
9950;ENSG00000085760;MTIF2;2;55463731;55496483;32752;0
9951;ENSG00000085871;MGST2;4;140586922;140661899;74977;0
9952;ENSG00000085978;ATG16L1;2;234118697;234204320;85623;0
9953;ENSG00000085982;USP40;2;234384166;234475428;91262;0
9954;ENSG00000086189;DIMT1;5;61683081;61699766;16685;0
9955;ENSG00000086200;IPO11;5;61699799;61924409;224610;0
9956;ENSG00000087008;ACOX3;4;8368009;8442450;74441;0
9957;ENSG00000087266;SH3BP2;4;2794750;2842825;48075;0
9958;ENSG00000087269;NOP14;4;2939660;2965112;25452;0
9959;ENSG00000087274;ADD1;4;2845584;2931803;86219;0
9960;ENSG00000087338;GMCL1;2;70056774;70108528;51754;0
9961;ENSG00000087460;GNAS;20;57414773;57486247;71474;0
9962;ENSG00000087495;PHACTR3;20;58152564;58422766;270202;0
9963;ENSG00000087586;AURKA;20;54944445;54967393;22948;0
9964;ENSG00000087589;CASS4;20;54987168;55034396;47228;0
9965;ENSG00000088038;CNOT3;19;54641444;54659419;17975;0
9966;ENSG00000088053;GP6;19;55525073;55549632;24559;0
9967;ENSG00000088179;PTPN4;2;120517207;120741394;224187;0
9968;ENSG00000088205;DDX18;2;118572226;118589955;17729;0
9969;ENSG00000088298;EDEM2;20;33703167;33865928;162761;0
9970;ENSG00000088305;DNMT3B;20;31350191;31397162;46971;0
9971;ENSG00000088325;TPX2;20;30327074;30389608;62534;1
9972;ENSG00000088340;FER1L4;20;34146507;34195484;48977;0
9973;ENSG00000088356;PDRG1;20;30532758;30539895;7137;0
9974;ENSG00000088367;EPB41L1;20;34679426;34820721;141295;0
9975;ENSG00000088538;DOCK3;3;50712672;51421629;708957;0
9976;ENSG00000088543;C3orf18;3;50595462;50608458;12996;0
9977;ENSG00000088727;KIF9;3;47269516;47324941;55425;0
9978;ENSG00000088766;CRLS1;20;5986736;6020699;33963;0
9979;ENSG00000088812;ATRN;20;3451687;3631769;180082;0
9980;ENSG00000088826;SMOX;20;4101627;4168394;66767;0
9981;ENSG00000088827;SIGLEC1;20;3667617;3687775;20158;0
9982;ENSG00000088832;FKBP1A;20;1349622;1373806;24184;0
9983;ENSG00000088833;NSFL1C;20;1422807;1454487;31680;0
9984;ENSG00000088836;SLC4A11;20;3208063;3219836;11773;0
9985;ENSG00000088854;C20orf194;20;3229951;3388272;158321;0
9986;ENSG00000088876;ZNF343;20;2462463;2505348;42885;0
9987;ENSG00000088881;EBF4;20;2673524;2740753;67229;0
9988;ENSG00000088882;CPXM1;20;2774715;2781283;6568;0
9989;ENSG00000088888;MAVS;20;3827487;3849280;21793;0
9990;ENSG00000088899;;20;3143263;3154192;10929;0
9991;ENSG00000088926;F11;4;187187099;187210835;23736;0
9992;ENSG00000088930;XRN2;20;21283942;21370463;86521;0
9993;ENSG00000088970;PLK1S1;20;21106624;21227260;120636;0
9994;ENSG00000089006;SNX5;20;17922241;17949623;27382;0
9995;ENSG00000089048;ESF1;20;13694969;13765532;70563;0
9996;ENSG00000089050;RBBP9;20;18467184;18477887;10703;0
9997;ENSG00000089057;SLC23A2;20;4833002;4990939;157937;0
9998;ENSG00000089063;TMEM230;20;5080486;5093749;13263;0
9999;ENSG00000089091;DZANK1;20;18364011;18447925;83914;0
10000;ENSG00000089101;C20orf26;20;20033158;20341346;308188;0
10001;ENSG00000089123;TASP1;20;13246709;13619587;372878;0
10002;ENSG00000089177;KIF16B;20;16252749;16554078;301329;0
10003;ENSG00000089195;TRMT6;20;5917881;5931182;13301;0
10004;ENSG00000089199;CHGB;20;5892076;5906007;13931;0
10005;ENSG00000090097;PCBP4;3;51991470;52002426;10956;0
10006;ENSG00000090316;MAEA;4;1283639;1333935;50296;0
10007;ENSG00000090520;DNAJB11;3;186285192;186315061;29869;0
10008;ENSG00000090530;LEPREL1;3;189674517;189840226;165709;0
10009;ENSG00000090539;CHRD;3;184097861;184108524;10663;0
10010;ENSG00000090971;NAT14;19;55996371;55998935;2564;0
10011;ENSG00000090989;EXOC1;4;56719782;56771200;51418;0
10012;ENSG00000091317;CMTM6;3;32522804;32544900;22096;0
10013;ENSG00000091409;ITGA6;2;173292082;173371181;79099;0
10014;ENSG00000091428;RAPGEF4;2;173600002;173917621;317619;0
10015;ENSG00000091436;;2;173940163;174132738;192575;0
10016;ENSG00000091490;SEL1L3;4;25749055;25865382;116327;0
10017;ENSG00000091513;TF;3;133464800;133497850;33050;0
10018;ENSG00000091527;CDV3;3;133292574;133309105;16531;0
10019;ENSG00000091972;CD200;3;112051194;112081659;30465;0
10020;ENSG00000091986;CCDC80;3;112323407;112368377;44970;0
10021;ENSG00000092345;DAZL;3;16628299;16711813;83514;1
10022;ENSG00000092758;COL9A3;20;61447596;61472511;24915;0
10023;ENSG00000093000;NUP50;22;45559722;45583896;24174;0
10024;ENSG00000093009;CDC45;22;19466982;19508135;41153;0
10025;ENSG00000093010;COMT;22;19929130;19957498;28368;0
10026;ENSG00000093072;CECR1;22;17660194;17702879;42685;0
10027;ENSG00000093100;;22;18270418;18294263;23845;0
10028;ENSG00000093167;LRRFIP2;3;37094117;37225180;131063;0
10029;ENSG00000093183;SEC22C;3;42589461;42642572;53111;0
10030;ENSG00000093217;XYLB;3;38388251;38462839;74588;0
10031;ENSG00000095002;MSH2;2;47630108;47789450;159342;0
10032;ENSG00000095015;MAP3K1;5;56111401;56191979;80578;0
10033;ENSG00000095752;IL11;19;55875757;55881831;6074;0
10034;ENSG00000099326;MZF1;19;59073298;59084942;11644;0
10035;ENSG00000099889;ARVCF;22;19957419;20004331;46912;0
10036;ENSG00000099899;TRMT2A;22;20099389;20104915;5526;0
10037;ENSG00000099901;RANBP1;22;20103461;20114878;11417;0
10038;ENSG00000099904;ZDHHC8;22;20116979;20135530;18551;0
10039;ENSG00000099910;KLHL22;22;20783528;20850170;66642;0
10040;ENSG00000099917;MED15;22;20850200;20941919;91719;0
10041;ENSG00000099940;SNAP29;22;21213271;21245506;32235;0
10042;ENSG00000099942;CRKL;22;21271714;21308037;36323;0
10043;ENSG00000099949;LZTR1;22;21333751;21353327;19576;0
10044;ENSG00000099953;MMP11;22;24110413;24126503;16090;0
10045;ENSG00000099954;CECR2;22;17840837;18037850;197013;0
10046;ENSG00000099956;SMARCB1;22;24129150;24176703;47553;0
10047;ENSG00000099957;P2RX6;22;21364097;21383119;19022;0
10048;ENSG00000099958;DERL3;22;24176690;24181315;4625;0
10049;ENSG00000099960;SLC7A4;22;21383007;21387129;4122;0
10050;ENSG00000099968;BCL2L13;22;18111621;18213388;101767;0
10051;ENSG00000099977;DDT;22;24313554;24322660;9106;0
10052;ENSG00000099991;CABIN1;22;24407642;24574596;166954;0
10053;ENSG00000099992;TBC1D10A;22;30687979;30723035;35056;0
10054;ENSG00000099994;SUSD2;22;24577227;24585078;7851;0
10055;ENSG00000099995;SF3A1;22;30727977;30752936;24959;0
10056;ENSG00000099999;RNF215;22;30773835;30817760;43925;0
10057;ENSG00000100003;SEC14L2;22;30792846;30821305;28459;0
10058;ENSG00000100014;SPECC1L;22;24666786;24813708;146922;0
10059;ENSG00000100023;PPIL2;22;22006559;22054304;47745;0
10060;ENSG00000100024;UPB1;22;24863206;24924358;61152;0
10061;ENSG00000100027;YPEL1;22;22051833;22090123;38290;0
10062;ENSG00000100028;SNRPD3;22;24951471;25005947;54476;0
10063;ENSG00000100029;PES1;22;30972612;31003070;30458;0
10064;ENSG00000100030;MAPK1;22;22108789;22221970;113181;0
10065;ENSG00000100031;GGT1;22;24979718;25024972;45254;0
10066;ENSG00000100033;PRODH;22;18900294;18924066;23772;0
10067;ENSG00000100034;PPM1F;22;22273793;22307209;33416;0
10068;ENSG00000100036;SLC35E4;22;31031639;31065003;33364;0
10069;ENSG00000100038;TOP3B;22;22311397;22337213;25816;0
10070;ENSG00000100056;DGCR14;22;19117792;19132197;14405;0
10071;ENSG00000100058;CRYBB2P1;22;25844072;25916821;72749;0
10072;ENSG00000100060;MFNG;22;37865101;37882439;17338;0
10073;ENSG00000100065;CARD10;22;37886400;37915549;29149;0
10074;ENSG00000100068;LRP5L;22;25747385;25801344;53959;0
10075;ENSG00000100075;SLC25A1;22;19163095;19166343;3248;0
10076;ENSG00000100077;ADRBK2;22;25960816;26125261;164445;0
10077;ENSG00000100078;PLA2G3;22;31530795;31536593;5798;0
10078;ENSG00000100083;GGA1;22;38004481;38029571;25090;0
10079;ENSG00000100084;HIRA;22;19318221;19435224;117003;0
10080;ENSG00000100092;SH3BP1;22;38030661;38062939;32278;0
10081;ENSG00000100095;SEZ6L;22;26565440;26779562;214122;1
10082;ENSG00000100097;LGALS1;22;38071615;38075813;4198;0
10083;ENSG00000100099;HPS4;22;26839389;26879803;40414;0
10084;ENSG00000100100;PIK3IP1;22;31677579;31688520;10941;0
10085;ENSG00000100101;NOL12;22;38077680;38170137;92457;0
10086;ENSG00000100104;SRRD;22;26879843;26890624;10781;0
10087;ENSG00000100105;PATZ1;22;31721790;31742218;20428;0
10088;ENSG00000100106;TRIOBP;22;38093011;38172563;79552;1
10089;ENSG00000100109;TFIP11;22;26887191;26908471;21280;0
10090;ENSG00000100116;GCAT;22;38203912;38213183;9271;0
10091;ENSG00000100124;ANKRD54;22;38226862;38245334;18472;0
10092;ENSG00000100129;EIF3L;22;38244875;38285414;40539;0
10093;ENSG00000100138;NHP2L1;22;42069934;42086508;16574;0
10094;ENSG00000100139;MICALL1;22;38301664;38338829;37165;0
10095;ENSG00000100142;POLR2F;22;38348614;38437922;89308;0
10096;ENSG00000100147;CCDC134;22;42196683;42222303;25620;0
10097;ENSG00000100150;DEPDC5;22;32149944;32303012;153068;0
10098;ENSG00000100151;PICK1;22;38452318;38471708;19390;0
10099;ENSG00000100154;TTC28;22;28374004;29075853;701849;0
10100;ENSG00000100162;CENPM;22;42334725;42343168;8443;0
10101;ENSG00000100167;03-Sep;22;42372276;42394225;21949;0
10102;ENSG00000100181;TPTEP1;22;17082777;17179632;96855;0
10103;ENSG00000100196;KDELR3;22;38864067;38879452;15385;0
10104;ENSG00000100197;CYP2D6;22;42522501;42526908;4407;0
10105;ENSG00000100201;DDX17;22;38879445;38903665;24220;0
10106;ENSG00000100206;DMC1;22;38914954;38966291;51337;0
10107;ENSG00000100207;TCF20;22;42556019;42739622;183603;0
10108;ENSG00000100209;HSCB;22;29138019;29153503;15484;0
10109;ENSG00000100211;CBY1;22;39052641;39069859;17218;0
10110;ENSG00000100216;TOMM22;22;39077953;39080818;2865;0
10111;ENSG00000100218;RTDR1;22;23401593;23487208;85615;0
10112;ENSG00000100219;XBP1;22;29190543;29196585;6042;0
10113;ENSG00000100220;RTCB;22;32783569;32808242;24673;0
10114;ENSG00000100221;JOSD1;22;39081548;39097561;16013;0
10115;ENSG00000100225;FBXO7;22;32870663;32894818;24155;0
10116;ENSG00000100226;GTPBP1;22;39101728;39134304;32576;0
10117;ENSG00000100227;POLDIP3;22;42979727;43010968;31241;0
10118;ENSG00000100228;RAB36;22;23487513;23506537;19024;0
10119;ENSG00000100234;TIMP3;22;33197687;33259030;61343;0
10120;ENSG00000100239;PPP6R2;22;50781733;50883514;101781;0
10121;ENSG00000100241;SBF1;22;50883429;50913454;30025;0
10122;ENSG00000100242;SUN2;22;39130730;39190148;59418;0
10123;ENSG00000100243;CYB5R3;22;43013846;43045574;31728;0
10124;ENSG00000100246;DNAL4;22;39174513;39190203;15690;0
10125;ENSG00000100258;LMF2;22;50941376;50946135;4759;0
10126;ENSG00000100263;RHBDD3;22;29655841;29664198;8357;0
10127;ENSG00000100266;PACSIN2;22;43231418;43411151;179733;0
10128;ENSG00000100271;TTLL1;22;43435522;43485434;49912;0
10129;ENSG00000100276;RASL10A;22;29708922;29715668;6746;0
10130;ENSG00000100280;AP1B1;22;29723669;29819168;95499;0
10131;ENSG00000100281;HMGXB4;22;35653445;35691800;38355;0
10132;ENSG00000100284;TOM1;22;35695268;35743985;48717;0
10133;ENSG00000100285;NEFH;22;29876219;29887379;11160;0
10134;ENSG00000100288;CHKB;22;51017378;51039884;22506;0
10135;ENSG00000100292;HMOX1;22;35776354;35790207;13853;1
10136;ENSG00000100294;MCAT;22;43528212;43539400;11188;0
10137;ENSG00000100296;THOC5;22;29901868;29951205;49337;0
10138;ENSG00000100297;MCM5;22;35796056;35821423;25367;1
10139;ENSG00000100299;ARSA;22;51061182;51066607;5425;0
10140;ENSG00000100300;TSPO;22;43547520;43559248;11728;0
10141;ENSG00000100302;RASD2;22;35936915;35950048;13133;1
10142;ENSG00000100304;TTLL12;22;43562628;43583139;20511;0
10143;ENSG00000100307;CBX7;22;39516172;39548679;32507;0
10144;ENSG00000100311;PDGFB;22;39619364;39640756;21392;0
10145;ENSG00000100314;CABP7;22;30116073;30127828;11755;0
10146;ENSG00000100316;RPL3;22;39708887;39716394;7507;0
10147;ENSG00000100319;ZMAT5;22;30126945;30163000;36055;0
10148;ENSG00000100320;RBFOX2;22;36134783;36424473;289690;0
10149;ENSG00000100321;SYNGR1;22;39745930;39781593;35663;0
10150;ENSG00000100324;TAB1;22;39795746;39833065;37319;0
10151;ENSG00000100325;ASCC2;22;30184597;30234271;49674;0
10152;ENSG00000100330;MTMR3;22;30279144;30426855;147711;0
10153;ENSG00000100335;MIEF1;22;39895437;39914137;18700;0
10154;ENSG00000100336;APOL4;22;36585172;36600886;15714;0
10155;ENSG00000100344;PNPLA3;22;44319619;44360368;40749;0
10156;ENSG00000100345;MYH9;22;36677327;36784063;106736;0
10157;ENSG00000100346;CACNA1I;22;39966758;40085742;118984;0
10158;ENSG00000100347;SAMM50;22;44351301;44406411;55110;0
10159;ENSG00000100348;TXN2;22;36863083;36878077;14994;0
10160;ENSG00000100350;FOXRED2;22;36883237;36903148;19911;0
10161;ENSG00000100353;EIF3D;22;36906897;36925483;18586;0
10162;ENSG00000100354;TNRC6B;22;40440821;40731812;290991;0
10163;ENSG00000100359;SGSM3;22;40766595;40806293;39698;0
10164;ENSG00000100360;IFT27;22;37154246;37172300;18054;0
10165;ENSG00000100364;KIAA0930;22;45586219;45636650;50431;0
10166;ENSG00000100372;SLC25A17;22;41165634;41215403;49769;0
10167;ENSG00000100376;FAM118A;22;45704849;45737836;32987;0
10168;ENSG00000100379;KCTD17;22;37447779;37459430;11651;0
10169;ENSG00000100380;ST13;22;41220539;41253026;32487;0
10170;ENSG00000100387;RBX1;22;41347351;41369313;21962;0
10171;ENSG00000100393;EP300;22;41487790;41576081;88291;0
10172;ENSG00000100395;L3MBTL2;22;41601209;41627275;26066;0
10173;ENSG00000100399;CHADL;22;41625517;41636938;11421;0
10174;ENSG00000100401;RANGAP1;22;41641615;41682255;40640;0
10175;ENSG00000100403;ZC3H7B;22;41697526;41756151;58625;0
10176;ENSG00000100410;PHF5A;22;41855721;41864729;9008;0
10177;ENSG00000100412;ACO2;22;41865129;41924993;59864;0
10178;ENSG00000100413;POLR3H;22;41921808;41940610;18802;0
10179;ENSG00000100416;TRMU;22;46726772;46753237;26465;0
10180;ENSG00000100417;PMM1;22;41972898;41985894;12996;0
10181;ENSG00000100418;DESI1;22;41994032;42017100;23068;0
10182;ENSG00000100422;CERK;22;47080308;47134158;53850;0
10183;ENSG00000100425;BRD1;22;50166931;50221160;54229;0
10184;ENSG00000100426;ZBED4;22;50247490;50283726;36236;0
10185;ENSG00000100427;MLC1;22;50497820;50524331;26511;0
10186;ENSG00000100429;HDAC10;22;50683612;50689834;6222;0
10187;ENSG00000100979;PLTP;20;44527399;44540794;13395;0
10188;ENSG00000100982;PCIF1;20;44563267;44576662;13395;0
10189;ENSG00000100983;GSS;20;33516236;33543620;27384;0
10190;ENSG00000100991;TRPC4AP;20;33590207;33680674;90467;0
10191;ENSG00000100994;PYGB;20;25228705;25278650;49945;0
10192;ENSG00000100997;ABHD12;20;25275379;25371619;96240;0
10193;ENSG00000101003;GINS1;20;25388363;25433264;44901;0
10194;ENSG00000101004;NINL;20;25433341;25566153;132812;0
10195;ENSG00000101019;UQCC1;20;33890369;33999944;109575;0
10196;ENSG00000101040;ZMYND8;20;45837859;45985567;147708;0
10197;ENSG00000101049;SGK2;20;42187608;42216877;29269;1
10198;ENSG00000101052;IFT52;20;42219571;42275936;56365;0
10199;ENSG00000101057;MYBL2;20;42295754;42345136;49382;1
10200;ENSG00000101079;NDRG3;20;35280169;35374481;94312;0
10201;ENSG00000101084;C20orf24;20;35234137;35240960;6823;0
10202;ENSG00000101096;NFATC2;20;50003494;50179370;175876;0
10203;ENSG00000101098;RIMS4;20;43380449;43438979;58530;0
10204;ENSG00000101104;PABPC1L;20;43538703;43587676;48973;0
10205;ENSG00000101109;STK4;20;43595115;43708600;113485;0
10206;ENSG00000101115;SALL4;20;50400581;50419059;18478;0
10207;ENSG00000101126;ADNP;20;49505585;49547958;42373;0
10208;ENSG00000101132;PFDN4;20;52824386;52844591;20205;0
10209;ENSG00000101134;DOK5;20;53092136;53267710;175574;0
10210;ENSG00000101138;CSTF1;20;54967427;54979518;12091;0
10211;ENSG00000101144;BMP7;20;55743804;55841685;97881;0
10212;ENSG00000101146;RAE1;20;55926066;55954267;28201;0
10213;ENSG00000101150;TPD52L2;20;62496596;62522898;26302;0
10214;ENSG00000101152;DNAJC5;20;62526518;62567384;40866;0
10215;ENSG00000101158;NELFCD;20;57556263;57570188;13925;0
10216;ENSG00000101160;CTSZ;20;57570240;57582302;12062;1
10217;ENSG00000101161;PRPF6;20;62612488;62664453;51965;0
10218;ENSG00000101166;SLMO2;20;57608200;57617964;9764;0
10219;ENSG00000101180;HRH3;20;60790026;60795323;5297;0
10220;ENSG00000101181;MTG2;20;60758085;60778624;20539;0
10221;ENSG00000101182;PSMA7;20;60711791;60718496;6705;0
10222;ENSG00000101187;SLCO4A1;20;61273797;61317137;43340;0
10223;ENSG00000101188;NTSR1;20;61340189;61394123;53934;0
10224;ENSG00000101189;MRGBP;20;61427805;61431945;4140;0
10225;ENSG00000101190;TCFL5;20;61472467;61493115;20648;1
10226;ENSG00000101191;DIDO1;20;61509090;61569304;60214;0
10227;ENSG00000101193;GID8;20;61569471;61576996;7525;0
10228;ENSG00000101194;SLC17A9;20;61584052;61599949;15897;0
10229;ENSG00000101198;NKAIN4;20;61872136;61904046;31910;0
10230;ENSG00000101199;ARFGAP1;20;61904137;61921142;17005;0
10231;ENSG00000101203;COL20A1;20;61924538;61966203;41665;0
10232;ENSG00000101204;CHRNA4;20;61975420;62009753;34333;0
10233;ENSG00000101210;EEF1A2;20;62119366;62130505;11139;0
10234;ENSG00000101216;GMEB2;20;62218955;62258394;39439;0
10235;ENSG00000101220;C20orf27;20;3734155;3749034;14879;0
10236;ENSG00000101222;SPEF1;20;3758151;3762095;3944;0
10237;ENSG00000101224;CDC25B;20;3767578;3786762;19184;0
10238;ENSG00000101230;ISM1;20;13202418;13281298;78880;0
10239;ENSG00000101236;RNF24;20;3907956;3996229;88273;0
10240;ENSG00000101246;ARFRP1;20;62329996;62339377;9381;0
10241;ENSG00000101247;NDUFAF5;20;13765596;13799067;33471;0
10242;ENSG00000101251;SEL1L2;20;13829893;13977089;147196;0
10243;ENSG00000101255;TRIB3;20;361261;378203;16942;0
10244;ENSG00000101265;RASSF2;20;4760669;4804291;43622;1
10245;ENSG00000101266;CSNK2A1;20;459116;524465;65349;0
10246;ENSG00000101282;RSPO4;20;939095;982907;43812;0
10247;ENSG00000101290;CDS2;20;5107432;5178533;71101;0
10248;ENSG00000101294;HM13;20;30102231;30157370;55139;0
10249;ENSG00000101298;SNPH;20;1246960;1289972;43012;0
10250;ENSG00000101310;SEC23B;20;18488137;18542059;53922;0
10251;ENSG00000101327;PDYN;20;1959403;1974732;15329;0
10252;ENSG00000101331;CCM2L;20;30598245;30619984;21739;0
10253;ENSG00000101333;PLCB4;20;9049410;9461889;412479;0
10254;ENSG00000101335;MYL9;20;35169887;35178228;8341;1
10255;ENSG00000101337;TM9SF4;20;30697309;30755061;57752;0
10256;ENSG00000101343;CRNKL1;20;20015012;20036690;21678;0
10257;ENSG00000101346;POFUT1;20;30795683;30826470;30787;0
10258;ENSG00000101347;SAMHD1;20;35518632;35580246;61614;0
10259;ENSG00000101349;PAK7;20;9518036;9819689;301653;0
10260;ENSG00000101350;KIF3B;20;30865467;30922814;57347;0
10261;ENSG00000101353;MROH8;20;35729629;35807991;78362;0
10262;ENSG00000101361;NOP56;20;2632791;2639039;6248;0
10263;ENSG00000101363;MANBAL;20;35918041;35945663;27622;0
10264;ENSG00000101365;IDH3B;20;2639041;2644865;5824;0
10265;ENSG00000101367;MAPRE1;20;31407699;31438211;30512;0
10266;ENSG00000101384;JAG1;20;10618332;10654694;36362;1
10267;ENSG00000101391;CDK5RAP1;20;31946645;31989367;42722;0
10268;ENSG00000101400;SNTA1;20;31995761;32031698;35937;0
10269;ENSG00000101407;TTI1;20;36611409;36661870;50461;0
10270;ENSG00000101412;E2F1;20;32263489;32274210;10721;0
10271;ENSG00000101413;RPRD1B;20;36661948;36720768;58820;0
10272;ENSG00000101417;PXMP4;20;32294512;32308125;13613;0
10273;ENSG00000101421;CHMP4B;20;32399110;32442172;43062;0
10274;ENSG00000101438;SLC32A1;20;37353105;37358015;4910;1
10275;ENSG00000101439;CST3;20;23608534;23619110;10576;0
10276;ENSG00000101442;ACTR5;20;37377085;37400834;23749;0
10277;ENSG00000101443;WFDC2;20;44098346;44110172;11826;0
10278;ENSG00000101444;AHCY;20;32868074;32899608;31534;0
10279;ENSG00000101445;PPP1R16B;20;37434348;37551667;117319;0
10280;ENSG00000101447;FAM83D;20;37554955;37581703;26748;0
10281;ENSG00000101452;DHX35;20;37590942;37668366;77424;0
10282;ENSG00000101457;DNTTIP1;20;44420576;44440066;19490;0
10283;ENSG00000101460;MAP1LC3A;20;33134658;33148149;13491;0
10284;ENSG00000101463;SYNDIG1;20;24449835;24647252;197417;0
10285;ENSG00000101464;PIGU;20;33148346;33264910;116564;0
10286;ENSG00000101473;ACOT8;20;44470360;44486045;15685;0
10287;ENSG00000101474;APMAP;20;24943561;24973615;30054;0
10288;ENSG00000101898;;20;30135307;30135852;545;0
10289;ENSG00000105048;TNNT1;19;55644162;55660722;16560;0
10290;ENSG00000105063;PPP6R1;19;55741148;55770363;29215;0
10291;ENSG00000105136;ZNF419;19;57999079;58006048;6969;0
10292;ENSG00000105146;AURKC;19;57742377;57746916;4539;0
10293;ENSG00000105605;CACNG7;19;54412589;54447195;34606;0
10294;ENSG00000105617;LENG1;19;54658899;54663620;4721;0
10295;ENSG00000105618;PRPF31;19;54618837;54635140;16303;0
10296;ENSG00000105619;TFPT;19;54610320;54619055;8735;0
10297;ENSG00000108106;UBE2S;19;55912652;55919145;6493;0
10298;ENSG00000108107;RPL28;19;55896713;55914612;17899;0
10299;ENSG00000109132;PHOX2B;4;41746099;41750987;4888;1
10300;ENSG00000109133;TMEM33;4;41937137;41962589;25452;0
10301;ENSG00000109158;GABRA4;4;46920917;46996424;75507;0
10302;ENSG00000109171;SLAIN2;4;48343339;48428229;84890;0
10303;ENSG00000109180;OCIAD1;4;48807229;48863834;56605;0
10304;ENSG00000109184;DCUN1D4;4;52709166;52783003;73837;0
10305;ENSG00000109189;USP46;4;53457138;53525502;68364;0
10306;ENSG00000109193;SULT1E1;4;70676498;70725870;49372;0
10307;ENSG00000109220;CHIC2;4;54875956;54930857;54901;0
10308;ENSG00000109255;NMU;4;56461396;56502865;41469;0
10309;ENSG00000109265;KIAA1211;4;57036361;57194791;158430;0
10310;ENSG00000109270;LAMTOR3;4;100799493;100815647;16154;0
10311;ENSG00000109320;NFKB1;4;103422486;103538459;115973;0
10312;ENSG00000109323;MANBA;4;103552660;103682151;129491;0
10313;ENSG00000109332;UBE2D3;4;103715540;103790053;74513;0
10314;ENSG00000109339;MAPK10;4;86936276;87515284;579008;0
10315;ENSG00000109381;ELF2;4;139949266;140098372;149106;0
10316;ENSG00000109390;NDUFC1;4;140188034;140223705;35671;0
10317;ENSG00000109436;TBC1D9;4;141541919;141677274;135355;0
10318;ENSG00000109445;ZNF330;4;142142041;142155851;13810;0
10319;ENSG00000109452;INPP4B;4;142944313;143768585;824272;0
10320;ENSG00000109458;GAB1;4;144257915;144395721;137806;0
10321;ENSG00000109466;KLHL2;4;166128770;166244308;115538;0
10322;ENSG00000109472;CPE;4;166282346;166419472;137126;0
10323;ENSG00000109475;RPL34;4;109541722;109551568;9846;0
10324;ENSG00000109501;WFS1;4;6271576;6304992;33416;0
10325;ENSG00000109519;GRPEL1;4;7060633;7069924;9291;0
10326;ENSG00000109534;GAR1;4;110736666;110745893;9227;0
10327;ENSG00000109536;FRG1;4;190861943;190884359;22416;0
10328;ENSG00000109572;CLCN3;4;170533784;170644824;111040;0
10329;ENSG00000109576;AADAT;4;170981373;171012850;31477;0
10330;ENSG00000109586;GALNT7;4;174089904;174245118;155214;0
10331;ENSG00000109606;DHX15;4;24519064;24586173;67109;0
10332;ENSG00000109618;SEPSECS;4;25121627;25162204;40577;0
10333;ENSG00000109654;TRIM2;4;154073494;154260472;186978;0
10334;ENSG00000109670;FBXW7;4;153242410;153457253;214843;0
10335;ENSG00000109674;NEIL3;4;178230990;178284097;53107;0
10336;ENSG00000109680;TBC1D19;4;26578059;26756973;178914;0
10337;ENSG00000109685;WHSC1;4;1873151;1983934;110783;0
10338;ENSG00000109686;SH3D19;4;152023903;152246784;222881;0
10339;ENSG00000109689;STIM2;4;26859300;27027003;167703;0
10340;ENSG00000109736;MFSD10;4;2932288;2936586;4298;0
10341;ENSG00000109738;GLRB;4;157997209;158093242;96033;0
10342;ENSG00000109743;BST1;4;15704573;15739936;35363;0
10343;ENSG00000109756;RAPGEF2;4;160025330;160281321;255991;0
10344;ENSG00000109758;HGFAC;4;3443614;3451211;7597;0
10345;ENSG00000109762;SNX25;4;186125391;186291339;165948;0
10346;ENSG00000109771;LRP2BP;4;186285032;186317053;32021;0
10347;ENSG00000109775;UFSP2;4;186320694;186347139;26445;0
10348;ENSG00000109787;KLF3;4;38665817;38702663;36846;0
10349;ENSG00000109790;KLHL5;4;39046659;39128477;81818;0
10350;ENSG00000109794;FAM149A;4;187025573;187093821;68248;0
10351;ENSG00000109805;NCAPG;4;17812525;17846485;33960;0
10352;ENSG00000109814;UGDH;4;39500375;39529931;29556;0
10353;ENSG00000109819;PPARGC1A;4;23756664;23905712;149048;0
10354;ENSG00000112851;ERBB2IP;5;65222303;65378377;156074;0
10355;ENSG00000112877;CEP72;5;612387;667283;54896;0
10356;ENSG00000112902;SEMA5A;5;9035138;9546187;511049;0
10357;ENSG00000112941;PAPD7;5;6714718;6757161;42443;0
10358;ENSG00000112964;GHR;5;42423879;42721979;298100;0
10359;ENSG00000112972;HMGCS1;5;43289497;43313614;24117;0
10360;ENSG00000112977;DAP;5;10679342;10761384;82042;0
10361;ENSG00000112992;NNT;5;43602794;43707507;104713;0
10362;ENSG00000112996;MRPS30;5;44809027;44820530;11503;0
10363;ENSG00000113048;MRPS27;5;71515236;71616473;101237;0
10364;ENSG00000113100;CDH9;5;26880709;27121257;240548;0
10365;ENSG00000113360;DROSHA;5;31400604;31532303;131699;0
10366;ENSG00000113361;CDH6;5;31193857;31329253;135396;0
10367;ENSG00000113384;GOLPH3;5;32124810;32174456;49646;0
10368;ENSG00000113387;SUB1;5;32531739;32604185;72446;0
10369;ENSG00000113389;NPR3;5;32689176;32791819;102643;0
10370;ENSG00000113407;TARS;5;33440802;33469644;28842;0
10371;ENSG00000113430;IRX4;5;1877541;1887350;9809;0
10372;ENSG00000113448;PDE4D;5;58264865;59817947;1553082;0
10373;ENSG00000113456;RAD1;5;34905369;34919094;13725;0
10374;ENSG00000113460;BRIX1;5;34915481;34926101;10620;0
10375;ENSG00000113494;PRLR;5;35048861;35230794;181933;0
10376;ENSG00000113504;SLC12A7;5;1050499;1112150;61651;0
10377;ENSG00000113569;NUP155;5;37288239;37371283;83044;0
10378;ENSG00000113593;PPWD1;5;64859063;64883376;24313;0
10379;ENSG00000113594;LIFR;5;38475065;38608456;133391;0
10380;ENSG00000113595;TRIM23;5;64885507;64921802;36295;0
10381;ENSG00000113597;TRAPPC13;5;64920543;64962060;41517;0
10382;ENSG00000113638;TTC33;5;40714577;40756077;41500;0
10383;ENSG00000113790;EHHADH;3;184908412;184999778;91366;0
10384;ENSG00000113805;CNTN3;3;74311719;74570291;258572;0
10385;ENSG00000113810;SMC4;3;160117062;160152750;35688;0
10386;ENSG00000113811;;3;53918437;53926015;7578;0
10387;ENSG00000113812;ACTR8;3;53901093;53916229;15136;0
10388;ENSG00000113838;TBCCD1;3;186263862;186288332;24470;0
10389;ENSG00000113845;TIMMDC1;3;119217379;119243937;26558;0
10390;ENSG00000113851;CRBN;3;3190676;3221394;30718;0
10391;ENSG00000113889;KNG1;3;186435065;186461743;26678;0
10392;ENSG00000113916;BCL6;3;187439165;187463515;24350;0
10393;ENSG00000113924;HGD;3;120347020;120401418;54398;0
10394;ENSG00000113966;ARL6;3;97483365;97519953;36588;0
10395;ENSG00000113971;NPHP3;3;132276986;132441303;164317;0
10396;ENSG00000114019;AMOTL2;3;134074716;134094321;19605;0
10397;ENSG00000114021;NIT2;3;100053545;100075710;22165;0
10398;ENSG00000114023;FAM162A;3;122103023;122131181;28158;0
10399;ENSG00000114026;OGG1;3;9791628;9829903;38275;0
10400;ENSG00000114030;KPNA1;3;122140796;122233792;92996;0
10401;ENSG00000114054;PCCB;3;135969148;136056738;87590;0
10402;ENSG00000114098;ARMC8;3;137906109;138017231;111122;0
10403;ENSG00000114107;CEP70;3;138213186;138313380;100194;0
10404;ENSG00000114115;RBP1;3;139236276;139258671;22395;0
10405;ENSG00000114120;SLC25A36;3;140660672;140698775;38103;0
10406;ENSG00000114124;GRK7;3;141496990;141537332;40342;0
10407;ENSG00000114125;RNF7;3;141457046;141466402;9356;0
10408;ENSG00000114126;TFDP2;3;141663277;141868386;205109;0
10409;ENSG00000114127;XRN1;3;142025449;142166904;141455;0
10410;ENSG00000114166;KAT2B;3;20081515;20195896;114381;0
10411;ENSG00000114200;BCHE;3;165490692;165555260;64568;0
10412;ENSG00000114204;SERPINI2;3;167159577;167196792;37215;0
10413;ENSG00000114209;PDCD10;3;167401086;167452727;51641;0
10414;ENSG00000114251;WNT5A;3;55499743;55523973;24230;0
10415;ENSG00000114268;PFKFB4;3;48555117;48599448;44331;0
10416;ENSG00000114270;COL7A1;3;48601506;48632700;31194;0
10417;ENSG00000114279;FGF12;3;191857184;192485553;628369;0
10418;ENSG00000114302;PRKAR2A;3;48782030;48885279;103249;0
10419;ENSG00000114315;HES1;3;193853934;193856521;2587;0
10420;ENSG00000114316;USP4;3;49315264;49378145;62881;0
10421;ENSG00000114331;ACAP2;3;194995465;195163807;168342;0
10422;ENSG00000114346;ECT2;3;172468472;172539264;70792;0
10423;ENSG00000114353;GNAI2;3;50263724;50296787;33063;0
10424;ENSG00000114354;TFG;3;100428205;100467810;39605;0
10425;ENSG00000114378;HYAL1;3;50337320;50349812;12492;1
10426;ENSG00000114383;TUSC2;3;50357458;50365682;8224;0
10427;ENSG00000114388;NPRL2;3;50384761;50388522;3761;0
10428;ENSG00000114391;RPL24;3;101399935;101405626;5691;0
10429;ENSG00000114395;CYB561D2;3;50388126;50395891;7765;0
10430;ENSG00000114405;C3orf14;3;62304648;62321888;17240;0
10431;ENSG00000114416;FXR1;3;180585929;180700541;114612;0
10432;ENSG00000114423;CBLB;3;105374305;105588396;214091;0
10433;ENSG00000114439;BBX;3;107241783;107530171;288388;1
10434;ENSG00000114446;IFT57;3;107879659;107941417;61758;0
10435;ENSG00000114450;GNB4;3;179116990;179169378;52388;0
10436;ENSG00000114473;IQCG;3;197615946;197687013;71067;0
10437;ENSG00000114480;GBE1;3;81538850;81811312;272462;0
10438;ENSG00000114491;UMPS;3;124449213;124464040;14827;0
10439;ENSG00000114503;NCBP2;3;196662273;196669468;7195;0
10440;ENSG00000114520;SNX4;3;125165495;125239041;73546;0
10441;ENSG00000114529;C3orf52;3;111805182;111849851;44669;0
10442;ENSG00000114541;FRMD4B;3;69219141;69591734;372593;0
10443;ENSG00000114544;SLC41A3;3;125725198;125820404;95206;0
10444;ENSG00000114554;PLXNA1;3;126707437;126756235;48798;0
10445;ENSG00000114573;ATP6V1A;3;113465866;113530903;65037;0
10446;ENSG00000114626;ABTB1;3;127391778;127399768;7990;0
10447;ENSG00000114631;PODXL2;3;127348024;127391652;43628;0
10448;ENSG00000114646;CSPG5;3;47603729;47622282;18553;0
10449;ENSG00000114648;KLHL18;3;47324407;47388306;63899;0
10450;ENSG00000114650;SCAP;3;47455203;47518616;63413;0
10451;ENSG00000114654;EFCC1;3;128720472;128759585;39113;0
10452;ENSG00000114656;KIAA1257;3;128628709;128721533;92824;0
10453;ENSG00000114670;NEK11;3;130745694;131069309;323615;0
10454;ENSG00000114686;MRPL3;3;131181056;131221827;40771;0
10455;ENSG00000114698;PLSCR4;3;145910126;145968966;58840;0
10456;ENSG00000114735;HEMK1;3;50606583;50622366;15783;0
10457;ENSG00000114737;CISH;3;50643921;50649262;5341;0
10458;ENSG00000114738;MAPKAPK3;3;50648951;50686720;37769;0
10459;ENSG00000114739;ACVR2B;3;38495342;38534633;39291;0
10460;ENSG00000114742;WDR48;3;39093489;39138155;44666;0
10461;ENSG00000114744;COMMD2;3;149456257;149470286;14029;0
10462;ENSG00000114745;GORASP1;3;39138150;39149854;11704;0
10463;ENSG00000114757;PEX5L;3;179512746;179754841;242095;0
10464;ENSG00000114767;RRP9;3;51967446;51975957;8511;0
10465;ENSG00000114770;ABCC5;3;183637722;183735803;98081;0
10466;ENSG00000114779;ABHD14B;3;52002526;52017425;14899;0
10467;ENSG00000114784;EIF1B;3;40351175;40353915;2740;0
10468;ENSG00000114786;ABHD14A-ACY1;3;52009066;52023199;14133;0
10469;ENSG00000114790;ARHGEF26;3;153838792;153975616;136824;0
10470;ENSG00000114796;KLHL24;3;183353356;183402265;48909;0
10471;ENSG00000114805;PLCH1;3;155093369;155462856;369487;0
10472;ENSG00000114841;DNAH1;3;52350335;52434507;84172;0
10473;ENSG00000114850;SSR3;3;156257929;156272973;15044;0
10474;ENSG00000114853;ZBTB47;3;42695176;42709072;13896;0
10475;ENSG00000114857;NKTR;3;42642106;42690227;48121;0
10476;ENSG00000114859;CLCN2;3;184063973;184079439;15466;0
10477;ENSG00000114861;FOXP1;3;71003844;71633140;629296;0
10478;ENSG00000114867;EIF4G1;3;184032283;184053146;20863;0
10479;ENSG00000114902;SPCS1;3;52738971;52742182;3211;0
10480;ENSG00000114904;NEK4;3;52744800;52804965;60165;0
10481;ENSG00000114923;SLC4A3;2;220492049;220506702;14653;0
10482;ENSG00000114933;INO80D;2;206858445;206951027;92582;0
10483;ENSG00000114942;EEF1B2;2;207024309;207027652;3343;0
10484;ENSG00000114948;ADAM23;2;207308263;207485851;177588;0
10485;ENSG00000114956;DGUOK;2;74153953;74186088;32135;0
10486;ENSG00000114978;MOB1A;2;74379655;74406025;26370;0
10487;ENSG00000114982;KANSL3;2;97258907;97308524;49617;0
10488;ENSG00000114988;LMAN2L;2;97371666;97405801;34135;0
10489;ENSG00000114993;RTKN;2;74652963;74669549;16586;0
10490;ENSG00000114999;TTL;2;113239731;113299316;59585;0
10491;ENSG00000115020;PIKFYVE;2;209130991;209223475;92484;0
10492;ENSG00000115041;KCNIP3;2;95963052;96051825;88773;0
10493;ENSG00000115042;FAHD2A;2;96068469;96082364;13895;0
10494;ENSG00000115053;NCL;2;232318242;232348352;30110;0
10495;ENSG00000115073;ACTR1B;2;98272431;98280570;8139;0
10496;ENSG00000115084;SLC35F5;2;114462588;114514400;51812;0
10497;ENSG00000115085;ZAP70;2;98330023;98356325;26302;0
10498;ENSG00000115091;ACTR3;2;114647537;114720173;72636;0
10499;ENSG00000115107;STEAP3;2;119981384;120023228;41844;0
10500;ENSG00000115109;EPB41L5;2;120770581;120936695;166114;0
10501;ENSG00000115128;;2;24290454;24299313;8859;0
10502;ENSG00000115129;TP53I3;2;24300303;24308731;8428;0
10503;ENSG00000115137;DNAJC27;2;25166505;25194963;28458;0
10504;ENSG00000115145;STAM2;2;152973315;153032506;59191;0
10505;ENSG00000115155;OTOF;2;26680071;26781566;101495;0
10506;ENSG00000115159;GPD2;2;157291802;157470247;178445;0
10507;ENSG00000115163;CENPA;2;26987157;27023935;36778;0
10508;ENSG00000115170;ACVR1;2;158592958;158732374;139416;0
10509;ENSG00000115183;TANC1;2;159825146;160089170;264024;0
10510;ENSG00000115194;SLC30A3;2;27476552;27498685;22133;1
10511;ENSG00000115204;MPV17;2;27532360;27548547;16187;0
10512;ENSG00000115207;GTF3C2;2;27548716;27579868;31152;0
10513;ENSG00000115211;EIF2B4;2;27587219;27593353;6134;0
10514;ENSG00000115216;NRBP1;2;27650657;27665126;14469;0
10515;ENSG00000115221;ITGB6;2;160956177;161128399;172222;1
10516;ENSG00000115226;FNDC4;2;27714750;27718112;3362;0
10517;ENSG00000115232;ITGA4;2;182321929;182400914;78985;0
10518;ENSG00000115233;PSMD14;2;162164549;162268228;103679;0
10519;ENSG00000115234;SNX17;2;27593389;27599995;6606;0
10520;ENSG00000115239;GPR75-ASB3;2;53759810;54087170;327360;0
10521;ENSG00000115241;PPM1G;2;27604061;27632554;28493;0
10522;ENSG00000115252;PDE1A;2;183004763;183387919;383156;0
10523;ENSG00000115267;IFIH1;2;163123589;163175213;51624;0
10524;ENSG00000115271;GCA;2;163175350;163228105;52755;0
10525;ENSG00000115274;INO80B;2;74682150;74688011;5861;0
10526;ENSG00000115275;MOGS;2;74688184;74692537;4353;0
10527;ENSG00000115282;TTC31;2;74710200;74722013;11813;0
10528;ENSG00000115289;PCGF1;2;74732170;74735707;3537;0
10529;ENSG00000115290;GRB14;2;165349322;165478358;129036;0
10530;ENSG00000115295;CLIP4;2;29320571;29412509;91938;0
10531;ENSG00000115306;SPTBN1;2;54683422;54896812;213390;0
10532;ENSG00000115307;AUP1;2;74753772;74757066;3294;0
10533;ENSG00000115310;RTN4;2;55199325;55339757;140432;0
10534;ENSG00000115317;HTRA2;2;74756504;74760472;3968;0
10535;ENSG00000115318;LOXL3;2;74759541;74782817;23276;0
10536;ENSG00000115325;DOK1;2;74776153;74784681;8528;0
10537;ENSG00000115339;GALNT3;2;166604101;166651192;47091;0
10538;ENSG00000115350;POLE4;2;75185619;75197255;11636;0
10539;ENSG00000115353;TACR1;2;75273590;75426826;153236;1
10540;ENSG00000115355;CCDC88A;2;55514978;55647057;132079;0
10541;ENSG00000115361;ACADL;2;211052663;211090215;37552;0
10542;ENSG00000115364;MRPL19;2;75873909;75917977;44068;0
10543;ENSG00000115365;LANCL1;2;211295973;211342376;46403;0
10544;ENSG00000115368;WDR75;2;190306159;190340291;34132;0
10545;ENSG00000115380;EFEMP1;2;56093102;56151274;58172;1
10546;ENSG00000115392;FANCL;2;58386378;58468507;82129;0
10547;ENSG00000115414;FN1;2;216225163;216300895;75732;1
10548;ENSG00000115415;STAT1;2;191829084;191885686;56602;0
10549;ENSG00000115419;GLS;2;191745553;191830278;84725;0
10550;ENSG00000115421;PAPOLG;2;60983365;61029220;45855;0
10551;ENSG00000115423;DNAH6;2;84743579;85046713;303134;0
10552;ENSG00000115425;PECR;2;216861052;216947678;86626;0
10553;ENSG00000115446;UNC50;2;99225042;99234978;9936;0
10554;ENSG00000115457;IGFBP2;2;217497551;217529159;31608;0
10555;ENSG00000115459;ELMOD3;2;85581517;85618875;37358;0
10556;ENSG00000115461;IGFBP5;2;217536828;217560248;23420;0
10557;ENSG00000115464;USP34;2;61414598;61697904;283306;0
10558;ENSG00000115468;EFHD1;2;233470767;233547491;76724;1
10559;ENSG00000115484;CCT4;2;62095224;62115939;20715;0
10560;ENSG00000115486;GGCX;2;85771846;85788670;16824;0
10561;ENSG00000115504;EHBP1;2;62900986;63273622;372636;0
10562;ENSG00000115507;OTX1;2;63277192;63284971;7779;0
10563;ENSG00000115514;TXNDC9;2;99935445;99957165;21720;0
10564;ENSG00000115520;COQ10B;2;198318147;198340032;21885;0
10565;ENSG00000115524;SF3B1;2;198254508;198299815;45307;0
10566;ENSG00000115525;ST3GAL5;2;86066267;86116137;49870;0
10567;ENSG00000115526;CHST10;2;101008327;101034118;25791;0
10568;ENSG00000115539;PDCL3;2;101179152;101193197;14045;0
10569;ENSG00000115540;MOB4;2;198380295;198418423;38128;0
10570;ENSG00000115541;HSPE1;2;198364718;198368181;3463;0
10571;ENSG00000115548;KDM3A;2;86667770;86719839;52069;0
10572;ENSG00000115556;PLCD4;2;219472488;219501907;29419;1
10573;ENSG00000115561;CHMP3;2;86730554;86948245;217691;0
10574;ENSG00000115568;ZNF142;2;219502639;219524378;21739;0
10575;ENSG00000115593;SMYD1;2;88367299;88412906;45607;0
10576;ENSG00000115594;IL1R1;2;102681004;102796334;115330;0
10577;ENSG00000115641;FHL2;2;105974169;106054970;80801;0
10578;ENSG00000115649;CNPPD1;2;220036619;220042828;6209;0
10579;ENSG00000115652;UXS1;2;106709759;106810795;101036;0
10580;ENSG00000115657;ABCB6;2;220074490;220083712;9222;0
10581;ENSG00000115661;STK16;2;220110177;220115059;4882;0
10582;ENSG00000115665;SLC5A7;2;108602979;108630450;27471;0
10583;ENSG00000115677;HDLBP;2;242166679;242256476;89797;0
10584;ENSG00000115685;PPP1R7;2;242088991;242123067;34076;0
10585;ENSG00000115687;PASK;2;242045514;242089679;44165;0
10586;ENSG00000115694;STK25;2;242432089;242449145;17056;0
10587;ENSG00000115705;TPO;2;1377995;1547483;169488;0
10588;ENSG00000115718;PROC;2;128176003;128186822;10819;1
10589;ENSG00000115738;ID2;2;8818975;8824583;5608;0
10590;ENSG00000115750;TAF1B;2;9983483;10074545;91062;0
10591;ENSG00000115756;HPCAL1;2;10443015;10567743;124728;0
10592;ENSG00000115758;ODC1;2;10580094;10588630;8536;0
10593;ENSG00000115760;BIRC6;2;32582096;32843966;261870;0
10594;ENSG00000115761;NOL10;2;10710892;10830101;119209;0
10595;ENSG00000115762;PLEKHB2;2;131862420;132111282;248862;0
10596;ENSG00000115806;GORASP2;2;171784974;171823639;38665;0
10597;ENSG00000115808;STRN;2;37070783;37193615;122832;0
10598;ENSG00000115816;CEBPZ;2;37428755;37458856;30101;0
10599;ENSG00000115825;PRKD3;2;37477645;37551951;74306;0
10600;ENSG00000115827;DCAF17;2;172290727;172341562;50835;0
10601;ENSG00000115828;QPCT;2;37571717;37600465;28748;0
10602;ENSG00000115839;RAB3GAP1;2;135809835;135933964;124129;0
10603;ENSG00000115840;SLC25A12;2;172640880;172864766;223886;0
10604;ENSG00000115841;RMDN2;2;38150330;38294285;143955;0
10605;ENSG00000115866;DARS;2;136664247;136743670;79423;0
10606;ENSG00000115875;SRSF7;2;38970741;38978636;7895;0
10607;ENSG00000115884;SDC1;2;20400558;20425194;24636;0
10608;ENSG00000115896;PLCL1;2;198669426;199437305;767879;0
10609;ENSG00000115902;SLC1A4;2;65215611;65250999;35388;0
10610;ENSG00000115904;SOS1;2;39208537;39351486;142949;0
10611;ENSG00000115935;WIPF1;2;175424300;175547644;123344;0
10612;ENSG00000115942;ORC2;2;201773696;201828403;54707;0
10613;ENSG00000115944;COX7A2L;2;42560686;42652228;91542;0
10614;ENSG00000115946;PNO1;2;68384976;68403370;18394;0
10615;ENSG00000115947;ORC4;2;148687968;148779147;91179;0
10616;ENSG00000115963;RND3;2;151324709;151395525;70816;0
10617;ENSG00000115966;ATF2;2;175936978;176033110;96132;0
10618;ENSG00000115970;THADA;2;43393800;43823185;429385;0
10619;ENSG00000115977;AAK1;2;69688532;69901481;212949;0
10620;ENSG00000115993;TRAK2;2;202241930;202316302;74372;0
10621;ENSG00000115998;C2orf42;2;70377012;70475747;98735;0
10622;ENSG00000116001;TIA1;2;70436576;70475792;39216;0
10623;ENSG00000116005;PCYOX1;2;70484518;70508323;23805;0
10624;ENSG00000116016;EPAS1;2;46520806;46613836;93030;0
10625;ENSG00000116030;SUMO1;2;203070903;203103331;32428;0
10626;ENSG00000116035;VAX2;2;71127720;71160576;32856;0
10627;ENSG00000116039;ATP6V1B1;2;71163012;71192536;29524;1
10628;ENSG00000116044;NFE2L2;2;178092323;178257425;165102;0
10629;ENSG00000116062;MSH6;2;47922669;48037240;114571;0
10630;ENSG00000116095;PLEKHA3;2;179345195;179381189;35994;0
10631;ENSG00000116096;SPR;2;73114489;73119287;4798;0
10632;ENSG00000116106;EPHA4;2;222282747;222438922;156175;1
10633;ENSG00000116117;PARD3B;2;205410516;206484886;1074370;0
10634;ENSG00000116120;FARSB;2;223435255;223521056;85801;0
10635;ENSG00000116127;ALMS1;2;73612886;73837920;225034;0
10636;ENSG00000118007;STAG1;3;136055077;136471220;416143;0
10637;ENSG00000118242;MREG;2;216809213;216898819;89606;0
10638;ENSG00000118246;FASTKD2;2;207630081;207657233;27152;0
10639;ENSG00000118257;NRP2;2;206546714;206662857;116143;0
10640;ENSG00000118260;CREB1;2;208394461;208468155;73694;0
10641;ENSG00000118263;KLF7;2;207938861;208031991;93130;0
10642;ENSG00000118564;FBXL5;4;15606162;15683302;77140;0
10643;ENSG00000118579;MED28;4;17616254;17635728;19474;0
10644;ENSG00000118705;RPN2;20;35806813;35870022;63209;0
10645;ENSG00000118707;TGIF2;20;35201891;35222353;20462;0
10646;ENSG00000118762;PKD2;4;88928820;88998929;70109;0
10647;ENSG00000118777;ABCG2;4;89011416;89152474;141058;0
10648;ENSG00000118785;SPP1;4;88896819;88904562;7743;0
10649;ENSG00000118816;CCNI;4;77968311;77997158;28847;0
10650;ENSG00000118855;MFSD1;3;158449987;158547508;97521;0
10651;ENSG00000118960;HS1BP3;2;20760208;20850849;90641;0
10652;ENSG00000118961;C2orf43;2;20883788;21022882;139094;0
10653;ENSG00000118965;WDR35;2;20110021;20189892;79871;0
10654;ENSG00000118997;DNAH7;2;196602427;196933536;331109;0
10655;ENSG00000119004;CYP20A1;2;204103663;204163009;59346;0
10656;ENSG00000119013;NDUFB3;2;201936156;201950473;14317;0
10657;ENSG00000119041;GTF3C3;2;197627756;197664449;36693;0
10658;ENSG00000119042;SATB2;2;200134223;200335989;201766;0
10659;ENSG00000119185;ITGB1BP1;2;9543604;9563676;20072;0
10660;ENSG00000119203;CPSF3;2;9563697;9613230;49533;0
10661;ENSG00000119227;PIGZ;3;196673214;196695931;22717;0
10662;ENSG00000119231;SENP5;3;196594727;196661585;66858;0
10663;ENSG00000119574;ZBTB45;19;59024897;59050278;25381;0
10664;ENSG00000119729;RHOQ;2;46768945;46810260;41315;0
10665;ENSG00000119737;GPR75;2;54080050;54087126;7076;0
10666;ENSG00000119760;SUPT7L;2;27873679;27886676;12997;0
10667;ENSG00000119771;KLHL29;2;23608088;23931481;323393;0
10668;ENSG00000119772;DNMT3A;2;25455845;25565459;109614;0
10669;ENSG00000119777;TMEM214;2;27255778;27264563;8785;0
10670;ENSG00000119778;ATAD2B;2;23971534;24149984;178450;0
10671;ENSG00000119782;FKBP1B;2;24272571;24286551;13980;0
10672;ENSG00000119787;ATL2;2;38522022;38604427;82405;0
10673;ENSG00000119801;YPEL5;2;30369807;30383399;13592;0
10674;ENSG00000119812;FAM98A;2;33808725;33824449;15724;0
10675;ENSG00000119820;YIPF4;2;32502979;32541663;38684;0
10676;ENSG00000119844;AFTPH;2;64751465;64820139;68674;0
10677;ENSG00000119862;LGALSL;2;64681103;64688515;7412;0
10678;ENSG00000119865;CNRIP1;2;68511303;68547183;35880;0
10679;ENSG00000119866;BCL11A;2;60678302;60780702;102400;0
10680;ENSG00000119878;CRIPT;2;46843555;46852881;9326;0
10681;ENSG00000119888;EPCAM;2;47572297;47614740;42443;0
10682;ENSG00000120251;GRIA2;4;158125334;158287227;161893;0
10683;ENSG00000120519;SLC10A7;4;147175127;147443123;267996;0
10684;ENSG00000120742;SERP1;3;150259781;150321015;61234;0
10685;ENSG00000120756;PLS1;3;142315229;142432506;117277;0
10686;ENSG00000121152;NCAPH;2;97001525;97039583;38058;1
10687;ENSG00000121207;LRAT;4;155548097;155674270;126173;1
10688;ENSG00000121210;KIAA0922;4;154387498;154557863;170365;0
10689;ENSG00000121211;MND1;4;154265801;154336270;70469;0
10690;ENSG00000121406;ZNF549;19;58038693;58068910;30217;0
10691;ENSG00000121410;A1BG;19;58856544;58864865;8321;0
10692;ENSG00000121413;ZSCAN18;19;58595205;58629794;34589;0
10693;ENSG00000121417;ZNF211;19;58141761;58154147;12386;0
10694;ENSG00000121440;PDZRN3;3;73431584;73674091;242507;0
10695;ENSG00000121542;SEC22A;3;122920774;122992977;72203;0
10696;ENSG00000121570;DPPA4;3;109044988;109056419;11431;1
10697;ENSG00000121577;POPDC2;3;119355304;119384171;28867;0
10698;ENSG00000121578;B4GALT4;3;118930579;118959950;29371;0
10699;ENSG00000121579;NAA50;3;113435307;113465147;29840;0
10700;ENSG00000121864;ZNF639;3;179040779;179053323;12544;0
10701;ENSG00000121871;SLITRK3;3;164904508;164914897;10389;0
10702;ENSG00000121879;PIK3CA;3;178865902;178957881;91979;0
10703;ENSG00000121892;PDS5A;4;39824483;39979576;155093;0
10704;ENSG00000121897;LIAS;4;39460620;39479273;18653;0
10705;ENSG00000121964;GTDC1;2;144695635;145090135;394500;0
10706;ENSG00000121966;CXCR4;2;136871919;136875735;3816;0
10707;ENSG00000121988;ZRANB3;2;135894486;136288806;394320;0
10708;ENSG00000121989;ACVR2A;2;148602086;148688393;86307;0
10709;ENSG00000122068;FYTTD1;3;197464050;197514467;50417;0
10710;ENSG00000122085;MTERFD2;2;242011584;242041747;30163;0
10711;ENSG00000123213;NLN;5;65018023;65167553;149530;0
10712;ENSG00000123219;CENPK;5;64813593;64858998;45405;0
10713;ENSG00000123485;HJURP;2;234742062;234763212;21150;1
10714;ENSG00000123600;METTL8;2;172173919;172291312;117393;0
10715;ENSG00000123607;TTC21B;2;166713985;166810353;96368;0
10716;ENSG00000123609;NMI;2;152126979;152146571;19592;1
10717;ENSG00000123612;ACVR1C;2;158383279;158485517;102238;0
10718;ENSG00000123636;BAZ2B;2;160175490;160473203;297713;0
10719;ENSG00000123737;EXOSC9;4;122722472;122738176;15704;0
10720;ENSG00000123739;PLA2G12A;4;110631145;110651233;20088;0
10721;ENSG00000123933;MXD4;4;2249159;2264021;14862;0
10722;ENSG00000123977;DAW1;2;228735770;228789060;53290;0
10723;ENSG00000123983;ACSL3;2;223725652;223809357;83705;0
10724;ENSG00000123989;CHPF;2;220403669;220408509;4840;0
10725;ENSG00000123992;DNPEP;2;220238268;220264744;26476;0
10726;ENSG00000123999;INHA;2;220433884;220440435;6551;0
10727;ENSG00000124006;OBSL1;2;220415451;220436581;21130;0
10728;ENSG00000124019;FAM124B;2;225243415;225266802;23387;0
10729;ENSG00000124098;FAM210B;20;54933971;54943719;9748;0
10730;ENSG00000124104;SNX21;20;44462449;44471914;9465;0
10731;ENSG00000124116;WFDC3;20;44376583;44420571;43988;0
10732;ENSG00000124120;TTPAL;20;43104526;43123244;18718;0
10733;ENSG00000124126;PREX1;20;47240790;47444420;203630;0
10734;ENSG00000124134;KCNS1;20;43720951;43729753;8802;0
10735;ENSG00000124140;SLC12A5;20;44650356;44688784;38428;0
10736;ENSG00000124145;SDC4;20;43953928;43977064;23136;0
10737;ENSG00000124151;NCOA3;20;46130601;46285621;155020;0
10738;ENSG00000124155;PIGT;20;44044717;44054884;10167;0
10739;ENSG00000124160;NCOA5;20;44689624;44718591;28967;0
10740;ENSG00000124164;VAPB;20;56964178;57026157;61979;0
10741;ENSG00000124171;PARD6B;20;49348081;49373332;25251;0
10742;ENSG00000124172;ATP5E;20;57600522;57607437;6915;0
10743;ENSG00000124177;CHD6;20;40030741;40247133;216392;0
10744;ENSG00000124181;PLCG1;20;39765600;39811629;46029;0
10745;ENSG00000124191;TOX2;20;42543504;42698256;154752;0
10746;ENSG00000124193;SRSF6;20;42086568;42092245;5677;0
10747;ENSG00000124194;GDAP1L1;20;42875887;42909013;33126;0
10748;ENSG00000124198;ARFGEF2;20;47538427;47653230;114803;0
10749;ENSG00000124201;ZNFX1;20;47854483;47894963;40480;0
10750;ENSG00000124207;CSE1L;20;47662849;47713489;50640;0
10751;ENSG00000124209;RAB22A;20;56884752;56942563;57811;0
10752;ENSG00000124212;PTGIS;20;48120411;48184683;64272;0
10753;ENSG00000124214;STAU1;20;47729878;47804904;75026;0
10754;ENSG00000124215;CDH26;20;58533471;58609066;75595;0
10755;ENSG00000124216;SNAI1;20;48599536;48605423;5887;0
10756;ENSG00000124217;MOCS3;20;49575363;49577820;2457;0
10757;ENSG00000124222;STX16;20;57226328;57254582;28254;0
10758;ENSG00000124224;PPP4R1L;20;56806188;56884495;78307;0
10759;ENSG00000124225;PMEPA1;20;56223448;56286592;63144;0
10760;ENSG00000124226;RNF114;20;48552948;48570429;17481;0
10761;ENSG00000124228;DDX27;20;47835884;47860614;24730;0
10762;ENSG00000124243;BCAS4;20;49411431;49493714;82283;0
10763;ENSG00000124257;NEURL2;20;44517264;44519926;2662;0
10764;ENSG00000124275;MTRR;5;7851299;7906138;54839;0
10765;ENSG00000124279;FASTKD3;5;7859272;7869150;9878;0
10766;ENSG00000124356;STAMBP;2;74056086;74100786;44700;0
10767;ENSG00000124357;NAGK;2;71291474;71306935;15461;0
10768;ENSG00000124370;MCEE;2;71336814;71357369;20555;0
10769;ENSG00000124374;PAIP2B;2;71409869;71454213;44344;0
10770;ENSG00000124380;SNRNP27;2;70120692;70132707;12015;0
10771;ENSG00000124383;MPHOSPH10;2;71357444;71377231;19787;0
10772;ENSG00000124406;ATP8A1;4;42410390;42659122;248732;1
10773;ENSG00000124831;LRRFIP1;2;238536219;238722325;186106;0
10774;ENSG00000124839;RAB17;2;238482965;238510257;27292;0
10775;ENSG00000125037;EMC3;3;10004221;10052800;48579;0
10776;ENSG00000125046;SSUH2;3;8661086;8786726;125640;0
10777;ENSG00000125386;FAM193A;4;2626988;2734292;107304;0
10778;ENSG00000125388;GRK4;4;2965335;3042474;77139;0
10779;ENSG00000125503;PPP1R12C;19;55602281;55628927;26646;0
10780;ENSG00000125505;MBOAT7;19;54677107;54693733;16626;0
10781;ENSG00000125510;OPRL1;20;62711526;62731996;20470;0
10782;ENSG00000125520;SLC2A4RG;20;62371214;62374858;3644;0
10783;ENSG00000125531;C20orf195;20;62184373;62188061;3688;0
10784;ENSG00000125534;PPDPF;20;62152077;62153559;1482;0
10785;ENSG00000125551;PLGLB2;2;88047606;88058312;10706;0
10786;ENSG00000125611;CHCHD5;2;113341817;113346852;5035;0
10787;ENSG00000125629;INSIG2;2;118846028;118868573;22545;0
10788;ENSG00000125630;POLR1B;2;113299492;113334635;35143;0
10789;ENSG00000125633;CCDC93;2;118673054;118771709;98655;0
10790;ENSG00000125637;PSD4;2;113914902;113966973;52071;0
10791;ENSG00000125772;GPCPD1;20;5525085;5591672;66587;1
10792;ENSG00000125775;SDCBP2;20;1290619;1309883;19264;0
10793;ENSG00000125779;PANK2;20;3869486;3907605;38119;0
10794;ENSG00000125780;TGM3;20;2276647;2321724;45077;0
10795;ENSG00000125787;GNRH2;20;3024268;3026393;2125;0
10796;ENSG00000125804;FAM182A;20;26035291;26073683;38392;0
10797;ENSG00000125812;GZF1;20;23342787;23353700;10913;0
10798;ENSG00000125814;NAPB;20;23355159;23402125;46966;0
10799;ENSG00000125817;CENPB;20;3764498;3767337;2839;0
10800;ENSG00000125818;PSMF1;20;1093906;1160596;66690;0
10801;ENSG00000125821;DTD1;20;18568537;18744561;176024;0
10802;ENSG00000125826;RBCK1;20;388142;411610;23468;0
10803;ENSG00000125827;TMX4;20;7957995;8000476;42481;0
10804;ENSG00000125834;STK35;20;2082257;2157684;75427;0
10805;ENSG00000125835;SNRPB;20;2442280;2451499;9219;0
10806;ENSG00000125841;NRSN2;20;327426;340304;12878;0
10807;ENSG00000125843;AP5S1;20;3801178;3805949;4771;0
10808;ENSG00000125844;RRBP1;20;17594323;17662940;68617;0
10809;ENSG00000125845;BMP2;20;6748311;6760927;12616;0
10810;ENSG00000125846;ZNF133;20;18269121;18297640;28519;0
10811;ENSG00000125848;FLRT3;20;14303634;14318262;14628;0
10812;ENSG00000125851;PCSK2;20;17206752;17465223;258471;0
10813;ENSG00000125863;MKKS;20;10381657;10414870;33213;0
10814;ENSG00000125864;BFSP1;20;17474550;17549865;75315;0
10815;ENSG00000125868;DSTN;20;17550508;17590564;40056;0
10816;ENSG00000125869;LAMP5;20;9495005;9511171;16166;0
10817;ENSG00000125870;SNRPB2;20;16710606;16722421;11815;0
10818;ENSG00000125871;MGME1;20;17949556;17971765;22209;0
10819;ENSG00000125875;TBC1D20;20;416124;443197;27073;0
10820;ENSG00000125877;ITPA;20;3189514;3204516;15002;0
10821;ENSG00000125885;MCM8;20;5931298;5975852;44554;0
10822;ENSG00000125895;TMEM74B;20;1161205;1166059;4854;1
10823;ENSG00000125898;FAM110A;20;814358;838106;23748;0
10824;ENSG00000125901;MRPS26;20;3026591;3028900;2309;0
10825;ENSG00000125965;GDF5;20;34021145;34042568;21423;0
10826;ENSG00000125966;MMP24;20;33814457;33864801;50344;0
10827;ENSG00000125967;NECAB3;20;32244893;32262269;17376;0
10828;ENSG00000125968;ID1;20;30193086;30194318;1232;0
10829;ENSG00000125970;RALY;20;32581452;32696114;114662;0
10830;ENSG00000125971;DYNLRB1;20;33104214;33128762;24548;0
10831;ENSG00000125977;EIF2S2;20;32676104;32700138;24034;0
10832;ENSG00000125991;ERGIC3;20;34129770;34145405;15635;0
10833;ENSG00000125995;ROMO1;20;34287194;34288906;1712;0
10834;ENSG00000126001;CEP250;20;34042985;34099804;56819;0
10835;ENSG00000126003;PLAGL2;20;30780306;30795594;15288;0
10836;ENSG00000126005;MMP24-AS1;20;33804265;33865934;61669;0
10837;ENSG00000126062;TMEM115;3;50392180;50397041;4861;0
10838;ENSG00000127241;MASP1;3;186935942;187009810;73868;0
10839;ENSG00000127249;ATP13A4;3;193119866;193310900;191034;0
10840;ENSG00000127252;HRASLS;3;192958914;192995527;36613;0
10841;ENSG00000127415;IDUA;4;980785;998316;17531;0
10842;ENSG00000127418;FGFRL1;4;1003724;1020685;16961;0
10843;ENSG00000127419;TMEM175;4;926175;952444;26269;0
10844;ENSG00000127837;AAMP;2;219128850;219134980;6130;0
10845;ENSG00000127838;PNKD;2;219135115;219211516;76401;0
10846;ENSG00000127903;ZNF835;19;57174020;57183151;9131;0
10847;ENSG00000128039;SRD5A3;4;56212276;56239263;26987;0
10848;ENSG00000128045;RASL11B;4;53728457;53733000;4543;1
10849;ENSG00000128050;PAICS;4;57301907;57327534;25627;0
10850;ENSG00000128052;KDR;4;55944644;55991756;47112;0
10851;ENSG00000128059;PPAT;4;57259528;57301781;42253;0
10852;ENSG00000128159;TUBGCP6;22;50656118;50683421;27303;0
10853;ENSG00000128165;ADM2;22;50919985;50924869;4884;0
10854;ENSG00000128185;DGCR6L;22;20301799;20307603;5804;0
10855;ENSG00000128191;DGCR8;22;20067755;20099400;31645;0
10856;ENSG00000128203;ASPHD2;22;26825239;26840981;15742;0
10857;ENSG00000128228;SDF2L1;22;21996550;21998587;2037;0
10858;ENSG00000128245;YWHAH;22;32340447;32353590;13143;0
10859;ENSG00000128250;RFPL1;22;29834572;29838444;3872;0
10860;ENSG00000128253;RFPL2;22;32586422;32600718;14296;0
10861;ENSG00000128254;C22orf24;22;32329507;32341504;11997;0
10862;ENSG00000128266;GNAZ;22;23412540;23467224;54684;0
10863;ENSG00000128268;MGAT3;22;39853349;39888199;34850;0
10864;ENSG00000128271;ADORA2A;22;24813847;24838328;24481;0
10865;ENSG00000128272;ATF4;22;39915700;39918691;2991;0
10866;ENSG00000128276;RFPL3;22;32750872;32757148;6276;0
10867;ENSG00000128283;CDC42EP1;22;37956454;37965412;8958;0
10868;ENSG00000128285;MCHR1;22;41074754;41078818;4064;0
10869;ENSG00000128294;TPST2;22;26921458;26992681;71223;0
10870;ENSG00000128298;BAIAP2L2;22;38480896;38506677;25781;0
10871;ENSG00000128309;MPST;22;37415676;37425863;10187;0
10872;ENSG00000128311;TST;22;37406900;37415681;8781;0
10873;ENSG00000128335;APOL2;22;36622256;36636000;13744;0
10874;ENSG00000128342;LIF;22;30636436;30642840;6404;0
10875;ENSG00000128346;C22orf23;22;38339528;38349676;10148;0
10876;ENSG00000128394;APOBEC3F;22;39436609;39449915;13306;0
10877;ENSG00000128408;RIBC2;22;45809572;45828376;18804;1
10878;ENSG00000128641;MYO1B;2;192109911;192290115;180204;0
10879;ENSG00000128654;MTX2;2;177134123;177202753;68630;0
10880;ENSG00000128655;PDE11A;2;178487980;178973066;485086;0
10881;ENSG00000128656;CHN1;2;175664091;175870097;206006;0
10882;ENSG00000128683;GAD1;2;171669723;171717661;47938;1
10883;ENSG00000128692;EIF2S2P4;2;171608221;171609562;1341;0
10884;ENSG00000128694;OSGEPL1;2;190611386;190627953;16567;0
10885;ENSG00000128699;ORMDL1;2;190635049;190649097;14048;0
10886;ENSG00000128708;HAT1;2;172778958;172848599;69641;0
10887;ENSG00000129055;ANAPC13;3;134196548;134205558;9010;0
10888;ENSG00000129071;MBD4;3;129149787;129158878;9091;0
10889;ENSG00000129116;PALLD;4;169418217;169849608;431391;1
10890;ENSG00000129128;SPCS3;4;177241115;177253396;12281;0
10891;ENSG00000129187;DCTD;4;183811213;183839089;27876;0
10892;ENSG00000129810;SGOL1;3;20202085;20227784;25699;1
10893;ENSG00000129990;SYT5;19;55682567;55691809;9242;0
10894;ENSG00000129991;TNNI3;19;55663137;55669141;6004;0
10895;ENSG00000130147;SH3BP4;2;235860617;235964358;103741;0
10896;ENSG00000130294;KIF1A;2;241653181;241759725;106544;0
10897;ENSG00000130414;NDUFA10;2;240831867;240964819;132952;0
10898;ENSG00000130449;ZSWIM6;5;60628100;60841997;213897;0
10899;ENSG00000130489;SCO2;22;50961997;50964868;2871;0
10900;ENSG00000130508;PXDN;2;1635659;1748624;112965;0
10901;ENSG00000130540;SULT4A1;22;44220389;44258398;38009;0
10902;ENSG00000130584;ZBTB46;20;62375019;62462597;87578;0
10903;ENSG00000130589;HELZ2;20;62189439;62205592;16153;0
10904;ENSG00000130590;SAMD10;20;62605466;62611361;5895;0
10905;ENSG00000130638;ATXN10;22;46067678;46241187;173509;0
10906;ENSG00000130684;ZNF337;20;25654851;25677477;22626;0
10907;ENSG00000130699;TAF4;20;60528525;60640866;112341;0
10908;ENSG00000130702;LAMA5;20;60883011;60942368;59357;0
10909;ENSG00000130703;OSBPL2;20;60813580;60871268;57688;0
10910;ENSG00000130706;ADRM1;20;60877149;60883918;6769;0
10911;ENSG00000130724;CHMP2A;19;59062933;59066491;3558;0
10912;ENSG00000130725;UBE2M;19;59067079;59070327;3248;0
10913;ENSG00000130726;TRIM28;19;59055458;59062089;6631;0
10914;ENSG00000130997;POLN;4;2073645;2243848;170203;1
10915;ENSG00000131037;EPS8L1;19;55583388;55599291;15903;0
10916;ENSG00000131043;AAR2;20;34824381;34858840;34459;0
10917;ENSG00000131044;TTLL9;20;30458505;30532764;74259;0
10918;ENSG00000131051;RBM39;20;34291531;34330234;38703;0
10919;ENSG00000131061;ZNF341;20;32319463;32380075;60612;0
10920;ENSG00000131067;GGT7;20;33432523;33460663;28140;0
10921;ENSG00000131069;ACSS2;20;33459949;33515769;55820;0
10922;ENSG00000131100;ATP6V1E1;22;18074902;18111584;36682;0
10923;ENSG00000131127;ZNF141;4;331603;378653;47050;0
10924;ENSG00000131368;MRPS25;3;15083967;15106842;22875;1
10925;ENSG00000131370;SH3BP5;3;15296360;15382875;86515;0
10926;ENSG00000131373;HACL1;3;15602211;15643338;41127;0
10927;ENSG00000131374;TBC1D5;3;17198654;18486309;1287655;0
10928;ENSG00000131375;CAPN7;3;15247659;15294425;46766;0
10929;ENSG00000131378;RFTN1;3;16355081;16555533;200452;0
10930;ENSG00000131379;C3orf20;3;14716606;14814541;97935;0
10931;ENSG00000131381;ZFYVE20;3;15111580;15140670;29090;0
10932;ENSG00000131386;GALNT15;3;16216156;16273499;57343;1
10933;ENSG00000131389;SLC6A6;3;14444076;14530857;86781;0
10934;ENSG00000131711;MAP1B;5;71403061;71505395;102334;0
10935;ENSG00000131844;MCCC2;5;70883115;70954531;71416;0
10936;ENSG00000131845;ZNF304;19;57862675;57871266;8591;0
10937;ENSG00000131848;ZSCAN5A;19;56732681;56879752;147071;0
10938;ENSG00000131849;ZNF132;19;58944181;58951589;7408;0
10939;ENSG00000132031;MATN3;2;20191872;20212455;20583;0
10940;ENSG00000132153;DHX30;3;47844399;47891685;47286;0
10941;ENSG00000132155;RAF1;3;12625100;12705725;80625;0
10942;ENSG00000132164;SLC6A11;3;10857885;10982419;124534;0
10943;ENSG00000132182;NUP210;3;13357737;13461809;104072;0
10944;ENSG00000132300;PTCD3;2;86333305;86369280;35975;0
10945;ENSG00000132305;IMMT;2;86371055;86422893;51838;0
10946;ENSG00000132313;MRPL35;2;86426478;86440917;14439;0
10947;ENSG00000132321;IQCA1;2;237232794;237416185;183391;0
10948;ENSG00000132323;ILKAP;2;239079042;239112370;33328;0
10949;ENSG00000132326;PER2;2;239152679;239198743;46064;0
10950;ENSG00000132329;RAMP1;2;238767536;238820756;53220;0
10951;ENSG00000132330;SCLY;2;238969530;239008054;38524;0
10952;ENSG00000132356;PRKAA1;5;40759481;40798476;38995;0
10953;ENSG00000132357;CARD6;5;40841286;40860275;18989;0
10954;ENSG00000132394;EEFSEC;3;127872297;128127485;255188;0
10955;ENSG00000132405;TBC1D14;4;6910969;7034845;123876;0
10956;ENSG00000132406;TMEM128;4;4237269;4249950;12681;0
10957;ENSG00000132463;GRSF1;4;71681499;71705662;24163;0
10958;ENSG00000132464;ENAM;4;71494461;71552533;58072;0
10959;ENSG00000132466;ANKRD17;4;73939093;74124515;185422;0
10960;ENSG00000132467;UTP3;4;71554196;71556267;2071;0
10961;ENSG00000132623;ANKEF1;20;9966774;10037410;70636;0
10962;ENSG00000132635;PCED1A;20;2815960;2821836;5876;0
10963;ENSG00000132639;SNAP25;20;10199478;10288066;88588;0
10964;ENSG00000132640;BTBD3;20;11871371;11907257;35886;0
10965;ENSG00000132646;PCNA;20;5095599;5107272;11673;0
10966;ENSG00000132661;NXT1;20;23331373;23335414;4041;0
10967;ENSG00000132664;POLR3F;20;18447771;18465287;17516;0
10968;ENSG00000132669;RIN2;20;19867165;19983101;115936;0
10969;ENSG00000132670;PTPRA;20;2844830;3019722;174892;0
10970;ENSG00000132792;CTNNBL1;20;36322408;36500531;178123;0
10971;ENSG00000132801;ZSWIM3;20;44486256;44507761;21505;0
10972;ENSG00000132819;RBM38;20;55966463;55984389;17926;0
10973;ENSG00000132821;VSTM2L;20;36531499;36573752;42253;0
10974;ENSG00000132823;OSER1;20;42825136;42839431;14295;0
10975;ENSG00000132824;SERINC3;20;43124862;43150750;25888;0
10976;ENSG00000132825;PPP1R3D;20;58511894;58515352;3458;0
10977;ENSG00000132832;;20;43285092;43324737;39645;0
10978;ENSG00000132967;HMGB1P5;3;22423310;22424420;1110;0
10979;ENSG00000133247;SUV420H2;19;55851221;55859488;8267;0
10980;ENSG00000133256;PDE6B;4;619373;664571;45198;1
10981;ENSG00000133265;HSPBP1;19;55773599;55791749;18150;0
10982;ENSG00000133398;MED10;5;6371994;6378707;6713;0
10983;ENSG00000133401;PDZD2;5;31639517;32111037;471520;0
10984;ENSG00000133422;MORC2;22;31321117;31364284;43167;0
10985;ENSG00000133424;LARGE;22;33558212;34318829;760617;0
10986;ENSG00000133454;MYO18B;22;26138111;26427007;288896;0
10987;ENSG00000133460;SLC2A11;22;24198890;24228496;29606;0
10988;ENSG00000133466;C1QTNF6;22;37576207;37595425;19218;0
10989;ENSG00000133519;ZDHHC8P1;22;23732793;23744913;12120;0
10990;ENSG00000133657;ATP13A3;3;194123401;194219093;95692;0
10991;ENSG00000134056;MRPS36;5;68513587;68525956;12369;0
10992;ENSG00000134057;CCNB1;5;68462837;68474072;11235;0
10993;ENSG00000134058;CDK7;5;68530668;68573250;42582;0
10994;ENSG00000134070;IRAK2;3;10206549;10285427;78878;0
10995;ENSG00000134072;CAMK1;3;9799026;9811676;12650;0
10996;ENSG00000134077;THUMPD3;3;9404526;9428475;23949;0
10997;ENSG00000134086;VHL;3;10182692;10193904;11212;0
10998;ENSG00000134107;BHLHE40;3;5020801;5027008;6207;0
10999;ENSG00000134108;ARL8B;3;5163905;5222596;58691;0
11000;ENSG00000134109;EDEM1;3;5229331;5261642;32311;0
11001;ENSG00000134121;CHL1;3;238279;451090;212811;1
11002;ENSG00000134308;YWHAQ;2;9724101;9771143;47042;0
11003;ENSG00000134313;KIDINS220;2;8865408;8977760;112352;0
11004;ENSG00000134317;GRHL1;2;10085341;10142411;57070;0
11005;ENSG00000134318;ROCK2;2;11319887;11488456;168569;0
11006;ENSG00000134323;MYCN;2;16080686;16087129;6443;0
11007;ENSG00000134324;LPIN1;2;11817721;11967535;149814;0
11008;ENSG00000134326;CMPK2;2;6980701;7006766;26065;0
11009;ENSG00000134330;IAH1;2;9613787;9636672;22885;0
11010;ENSG00000134352;IL6ST;5;55230923;55290821;59898;0
11011;ENSG00000134363;FST;5;52776239;52782964;6725;0
11012;ENSG00000134851;TMEM165;4;56262124;56319564;57440;0
11013;ENSG00000134852;CLOCK;4;56294070;56413305;119235;0
11014;ENSG00000134853;PDGFRA;4;55095264;55164414;69150;1
11015;ENSG00000135605;TEC;4;48137800;48271881;134081;0
11016;ENSG00000135617;PRADC1;2;73455134;73460366;5232;0
11017;ENSG00000135622;SEMA4F;2;74881355;74909186;27831;0
11018;ENSG00000135624;CCT7;2;73460548;73480149;19601;0
11019;ENSG00000135631;RAB11FIP5;2;73300510;73383849;83339;0
11020;ENSG00000135632;SMYD5;2;73441350;73454365;13015;0
11021;ENSG00000135636;DYSF;2;71680852;71913898;233046;0
11022;ENSG00000135637;CCDC142;2;74699113;74710535;11422;0
11023;ENSG00000135899;SP110;2;231032009;231090444;58435;0
11024;ENSG00000135900;MRPL44;2;224822121;224832431;10310;0
11025;ENSG00000135903;PAX3;2;223064607;223163715;99108;0
11026;ENSG00000135905;DOCK10;2;225629807;225907162;277355;0
11027;ENSG00000135912;TTLL4;2;219575568;219620139;44571;0
11028;ENSG00000135913;USP37;2;219314974;219433084;118110;0
11029;ENSG00000135916;ITM2C;2;231729354;231743963;14609;0
11030;ENSG00000135917;SLC19A3;2;228549926;228582728;32802;0
11031;ENSG00000135919;SERPINE2;2;224839829;224904036;64207;0
11032;ENSG00000135924;DNAJB2;2;220143989;220151622;7633;0
11033;ENSG00000135926;TMBIM1;2;219138915;219157309;18394;1
11034;ENSG00000135929;CYP27A1;2;219646472;219680016;33544;0
11035;ENSG00000135930;EIF4E2;2;233414762;233448354;33592;0
11036;ENSG00000135931;ARMC9;2;232063260;232239548;176288;0
11037;ENSG00000135932;CAB39;2;231577560;231685790;108230;0
11038;ENSG00000135940;COX5B;2;98262503;98264846;2343;0
11039;ENSG00000135945;REV1;2;100016938;100106497;89559;0
11040;ENSG00000135951;TSGA10;2;99613724;99771427;157703;0
11041;ENSG00000135953;MFSD9;2;103332299;103353347;21048;0
11042;ENSG00000135956;TMEM127;2;96914254;96931732;17478;0
11043;ENSG00000135966;TGFBRAP1;2;105880871;105946491;65620;0
11044;ENSG00000135968;GCC2;2;109065017;109125871;60854;0
11045;ENSG00000135972;MRPS9;2;105654441;105716418;61977;0
11046;ENSG00000135973;GPR45;2;105858200;105859924;1724;1
11047;ENSG00000135974;C2orf49;2;105953816;105965668;11852;0
11048;ENSG00000135976;ANKRD36;2;97779233;97930258;151025;0
11049;ENSG00000135999;EPC2;2;149402009;149545130;143121;0
11050;ENSG00000136002;ARHGEF4;2;131594489;131804836;210347;0
11051;ENSG00000136059;VILL;3;38029550;38048679;19129;0
11052;ENSG00000136068;FLNB;3;57994127;58157982;163855;0
11053;ENSG00000136518;ACTL6A;3;179280668;179306196;25528;0
11054;ENSG00000136521;NDUFB5;3;179322478;179345435;22957;0
11055;ENSG00000136522;MRPL47;3;179306073;179322442;16369;0
11056;ENSG00000136527;TRA2B;3;185633694;185655924;22230;0
11057;ENSG00000136531;SCN2A;2;166095912;166248818;152906;0
11058;ENSG00000136535;TBR1;2;162272605;162282381;9776;0
11059;ENSG00000136536;07-Mar;2;160569000;160627538;58538;0
11060;ENSG00000136546;SCN7A;2;167260083;167350757;90674;0
11061;ENSG00000136560;TANK;2;161993419;162092732;99313;0
11062;ENSG00000136603;SKIL;3;170075466;170114623;39157;0
11063;ENSG00000136682;CBWD2;2;114195268;114253766;58498;0
11064;ENSG00000136699;SMPD4;2;130908981;130940323;31342;0
11065;ENSG00000136709;WDR33;2;128458596;128568761;110165;0
11066;ENSG00000136710;CCDC115;2;131095814;131099922;4108;0
11067;ENSG00000136715;SAP130;2;128698791;128785694;86903;0
11068;ENSG00000136717;BIN1;2;127805603;127864931;59328;0
11069;ENSG00000136718;IMP4;2;131099798;131105383;5585;0
11070;ENSG00000136720;HS6ST1;2;128994290;129076151;81861;0
11071;ENSG00000136731;UGGT1;2;128848774;128953251;104477;0
11072;ENSG00000136732;GYPC;2;127413509;127454246;40737;1
11073;ENSG00000137449;CPEB2;4;15004298;15071777;67479;0
11074;ENSG00000137460;FHDC1;4;153857504;153900848;43344;0
11075;ENSG00000137463;MGARP;4;140187317;140201492;14175;0
11076;ENSG00000137473;TTC29;4;147627790;147867034;239244;0
11077;ENSG00000137601;NEK1;4;170314426;170533780;219354;0
11078;ENSG00000137628;DDX60;4;169137444;169239958;102514;0
11079;ENSG00000138002;IFT172;2;27667238;27712656;45418;0
11080;ENSG00000138018;EPT1;2;26531415;26618759;87344;0
11081;ENSG00000138028;CGREF1;2;27321757;27341995;20238;0
11082;ENSG00000138029;HADHB;2;26466038;26513336;47298;0
11083;ENSG00000138030;KHK;2;27309615;27323640;14025;0
11084;ENSG00000138031;ADCY3;2;25042038;25142708;100670;0
11085;ENSG00000138032;PPM1B;2;44395108;44471523;76415;0
11086;ENSG00000138035;PNPT1;2;55861400;55921045;59645;0
11087;ENSG00000138036;DYNC2LI1;2;44001178;44037149;35971;0
11088;ENSG00000138041;SMEK2;2;55774428;55846015;71587;0
11089;ENSG00000138050;THUMPD2;2;39963200;40006407;43207;0
11090;ENSG00000138061;CYP1B1;2;38294116;38337044;42928;0
11091;ENSG00000138069;RAB1A;2;65297835;65357240;59405;0
11092;ENSG00000138071;ACTR2;2;65454887;65498387;43500;0
11093;ENSG00000138073;PREB;2;27353624;27357543;3919;0
11094;ENSG00000138074;SLC5A6;2;27422455;27435826;13371;0
11095;ENSG00000138078;PREPL;2;44543420;44589001;45581;0
11096;ENSG00000138079;SLC3A1;2;44502599;44548633;46034;0
11097;ENSG00000138080;EMILIN1;2;27301435;27309271;7836;0
11098;ENSG00000138081;FBXO11;2;48016455;48132932;116477;0
11099;ENSG00000138083;SIX3;2;45168902;45173216;4314;0
11100;ENSG00000138085;ATRAID;2;27434895;27440046;5151;0
11101;ENSG00000138092;CENPO;2;25016005;25045245;29240;0
11102;ENSG00000138095;LRPPRC;2;44113647;44223144;109497;0
11103;ENSG00000138101;DTNB;2;25600067;25896503;296436;0
11104;ENSG00000138231;DBR1;3;137879854;137893791;13937;0
11105;ENSG00000138246;DNAJC13;3;132136370;132257876;121506;0
11106;ENSG00000138356;AOX1;2;201450591;201541787;91196;0
11107;ENSG00000138363;ATIC;2;216176540;216214487;37947;0
11108;ENSG00000138375;SMARCAL1;2;217277137;217347776;70639;0
11109;ENSG00000138376;BARD1;2;215590370;215674428;84058;0
11110;ENSG00000138378;STAT4;2;191894302;192016322;122020;0
11111;ENSG00000138379;MSTN;2;190920423;190927455;7032;0
11112;ENSG00000138380;CARF;2;203776937;203851786;74849;0
11113;ENSG00000138381;ASNSD1;2;190526111;190535557;9446;0
11114;ENSG00000138382;METTL5;2;170666591;170681441;14850;0
11115;ENSG00000138385;SSB;2;170648443;170668574;20131;0
11116;ENSG00000138386;NAB1;2;191511472;191557492;46020;0
11117;ENSG00000138395;CDK15;2;202655184;202760273;105089;0
11118;ENSG00000138398;PPIG;2;170440850;170497916;57066;0
11119;ENSG00000138399;FASTKD1;2;170386259;170430385;44126;0
11120;ENSG00000138400;MDH1B;2;207602487;207630271;27784;0
11121;ENSG00000138411;HECW2;2;197059094;197458416;399322;0
11122;ENSG00000138413;IDH1;2;209100951;209130798;29847;0
11123;ENSG00000138430;OLA1;2;174937175;175113426;176251;0
11124;ENSG00000138433;CIR1;2;175212750;175260443;47693;0
11125;ENSG00000138434;SSFA2;2;182756560;182795465;38905;0
11126;ENSG00000138435;CHRNA1;2;175612320;175629200;16880;0
11127;ENSG00000138439;FAM117B;2;203499901;203634480;134579;0
11128;ENSG00000138442;WDR12;2;203739505;203879521;140016;0
11129;ENSG00000138443;ABI2;2;204192942;204312446;119504;0
11130;ENSG00000138448;ITGAV;2;187454792;187545628;90836;0
11131;ENSG00000138449;SLC40A1;2;190425305;190448484;23179;1
11132;ENSG00000138459;SLC35A5;3;112280556;112304424;23868;0
11133;ENSG00000138463;DIRC2;3;122513642;122599986;86344;0
11134;ENSG00000138468;SENP7;3;101043049;101232085;189036;0
11135;ENSG00000138495;COX17;3;119373360;119396301;22941;0
11136;ENSG00000138496;PARP9;3;122246771;122283424;36653;0
11137;ENSG00000138639;ARHGAP24;4;86396267;86923823;527556;0
11138;ENSG00000138640;FAM13A;4;89647106;90032549;385443;0
11139;ENSG00000138641;HERC3;4;89442199;89629693;187494;0
11140;ENSG00000138642;HERC6;4;89299891;89364263;64372;0
11141;ENSG00000138646;HERC5;4;89378268;89427314;49046;0
11142;ENSG00000138650;PCDH10;4;134070470;134129356;58886;0
11143;ENSG00000138653;NDST4;4;115748919;116035032;286113;0
11144;ENSG00000138658;C4orf21;4;113460492;113558151;97659;0
11145;ENSG00000138660;AP1AR;4;113152893;113191203;38310;0
11146;ENSG00000138663;COPS4;4;83955600;83996971;41371;0
11147;ENSG00000138668;HNRNPD;4;83273651;83295656;22005;0
11148;ENSG00000138669;PRKG2;4;82009837;82136218;126381;0
11149;ENSG00000138670;RASGEF1B;4;82347547;82965397;617850;1
11150;ENSG00000138674;SEC31A;4;83739814;83822319;82505;0
11151;ENSG00000138675;FGF5;4;81187753;81257834;70081;0
11152;ENSG00000138678;AGPAT9;4;84457067;84527028;69961;0
11153;ENSG00000138685;FGF2;4;123747863;123819391;71528;0
11154;ENSG00000138686;BBS7;4;122745595;122791652;46057;0
11155;ENSG00000138688;KIAA1109;4;123073488;123283913;210425;0
11156;ENSG00000138696;BMPR1B;4;95679119;96079599;400480;0
11157;ENSG00000138698;RAP1GDS1;4;99182535;99365012;182477;0
11158;ENSG00000138709;LARP1B;4;128982423;129144086;161663;0
11159;ENSG00000138722;MMRN1;4;90800683;90875780;75097;0
11160;ENSG00000138735;PDE5A;4;120415550;120550146;134596;0
11161;ENSG00000138738;PRDM5;4;121606074;121844025;237951;0
11162;ENSG00000138741;TRPC3;4;122800182;122872909;72727;1
11163;ENSG00000138744;NAAA;4;76831809;76862204;30395;0
11164;ENSG00000138750;NUP54;4;77035812;77069668;33856;0
11165;ENSG00000138756;BMP2K;4;79697496;79837526;140030;0
11166;ENSG00000138757;G3BP2;4;76567966;76649709;81743;0
11167;ENSG00000138758;11-Sep;4;77870856;77961537;90681;0
11168;ENSG00000138759;FRAS1;4;78978724;79465423;486699;0
11169;ENSG00000138760;SCARB2;4;77079890;77135046;55156;0
11170;ENSG00000138764;CCNG2;4;78078304;78354542;276238;0
11171;ENSG00000138767;CNOT6L;4;78634541;78740769;106228;0
11172;ENSG00000138768;USO1;4;76649777;76735382;85605;0
11173;ENSG00000138769;CDKL2;4;76503215;76555900;52685;0
11174;ENSG00000138771;SHROOM3;4;77356253;77704406;348153;0
11175;ENSG00000138772;ANXA3;4;79472673;79531597;58924;1
11176;ENSG00000138777;PPA2;4;106290234;106395238;105004;0
11177;ENSG00000138778;CENPE;4;104026963;104119566;92603;0
11178;ENSG00000138780;GSTCD;4;106629935;106768885;138950;0
11179;ENSG00000138785;INTS12;4;106603784;106817143;213359;0
11180;ENSG00000138794;CASP6;4;110609785;110624739;14954;0
11181;ENSG00000138795;LEF1;4;108968701;109090112;121411;1
11182;ENSG00000138796;HADH;4;108910870;108956331;45461;0
11183;ENSG00000138798;EGF;4;110834040;110933422;99382;0
11184;ENSG00000138801;PAPSS1;4;108511433;108641608;130175;0
11185;ENSG00000138802;SEC24B;4;110354928;110462052;107124;0
11186;ENSG00000138814;PPP3CA;4;101944566;102269435;324869;0
11187;ENSG00000138821;SLC39A8;4;103172198;103352415;180217;0
11188;ENSG00000138823;MTTP;4;100484918;100545156;60238;0
11189;ENSG00000138867;GUCD1;22;24936406;24951903;15497;0
11190;ENSG00000138942;RNF185;22;31556168;31603005;46837;0
11191;ENSG00000138944;KIAA1644;22;44639547;44708731;69184;1
11192;ENSG00000138964;PARVG;22;44568836;44615413;46577;0
11193;ENSG00000141956;PRDM15;21;43218385;43299591;81206;0
11194;ENSG00000141959;PFKL;21;45719934;45747259;27325;0
11195;ENSG00000142149;HUNK;21;33245628;33416946;171318;0
11196;ENSG00000142156;COL6A1;21;47401651;47424964;23313;0
11197;ENSG00000142166;IFNAR1;21;34696734;34732168;35434;0
11198;ENSG00000142168;SOD1;21;33031935;33041244;9309;0
11199;ENSG00000142173;COL6A2;21;47518011;47552763;34752;0
11200;ENSG00000142178;SIK1;21;44834395;44847008;12613;1
11201;ENSG00000142188;TMEM50B;21;34804792;34852318;47526;0
11202;ENSG00000142192;APP;21;27252861;27543446;290585;0
11203;ENSG00000142197;DOPEY2;21;37529080;37666572;137492;0
11204;ENSG00000142207;URB1;21;33683329;33765335;82006;0
11205;ENSG00000142327;RNPEPL1;2;241505221;241520789;15568;0
11206;ENSG00000142330;CAPN10;2;241526133;241557122;30989;0
11207;ENSG00000142396;ERVK3-1;19;58816715;58827023;10308;0
11208;ENSG00000142408;CACNG8;19;54466294;54493469;27175;0
11209;ENSG00000142409;ZNF787;19;56598732;56632649;33917;0
11210;ENSG00000142731;PLK4;4;128802016;128820350;18334;0
11211;ENSG00000143429;;2;91805186;91847998;42812;0
11212;ENSG00000143727;ACP1;2;264140;278283;14143;0
11213;ENSG00000143797;MBOAT2;2;8992820;9143942;151122;0
11214;ENSG00000143867;OSR1;2;19551246;19558414;7168;0
11215;ENSG00000143870;PDIA6;2;10923517;10978103;54586;0
11216;ENSG00000143878;RHOB;2;20646835;20649200;2365;0
11217;ENSG00000143882;ATP6V1C2;2;10861775;10925236;63461;0
11218;ENSG00000143889;HNRNPLL;2;38789120;38830728;41608;0
11219;ENSG00000143891;GALM;2;38893052;38968379;75327;0
11220;ENSG00000143919;CAMKMT;2;44589089;44999731;410642;0
11221;ENSG00000143924;EML4;2;42396490;42559688;163198;0
11222;ENSG00000143933;CALM2;2;47387221;47403740;16519;0
11223;ENSG00000143942;CHAC2;2;53994929;54002333;7404;0
11224;ENSG00000143947;RPS27A;2;55459039;55462989;3950;0
11225;ENSG00000143951;WDPCP;2;63348518;64054977;706459;0
11226;ENSG00000143952;VPS54;2;64119280;64246206;126926;0
11227;ENSG00000143970;ASXL2;2;25956622;26101385;144763;0
11228;ENSG00000143971;ETAA1;2;67624451;67637677;13226;0
11229;ENSG00000143977;SNRPG;2;70508494;70520903;12409;0
11230;ENSG00000143994;ABHD1;2;27346682;27353680;6998;0
11231;ENSG00000143995;MEIS1;2;66660584;66801001;140417;0
11232;ENSG00000144021;CIAO1;2;96931870;96939087;7217;0
11233;ENSG00000144026;ZNF514;2;95813075;95831158;18083;0
11234;ENSG00000144028;SNRNP200;2;96940074;96971297;31223;0
11235;ENSG00000144029;MRPS5;2;95752952;95815179;62227;0
11236;ENSG00000144031;ANKRD53;2;71205510;71212626;7116;0
11237;ENSG00000144034;TPRKB;2;73956231;73964527;8296;0
11238;ENSG00000144036;EXOC6B;2;72403113;73053170;650057;0
11239;ENSG00000144040;SFXN5;2;73169165;73302747;133582;0
11240;ENSG00000144043;TEX261;2;71213068;71222075;9007;0
11241;ENSG00000144045;DQX1;2;74745258;74753463;8205;0
11242;ENSG00000144048;DUSP11;2;73989311;74007284;17973;0
11243;ENSG00000144057;ST6GAL2;2;107418056;107503564;85508;0
11244;ENSG00000144061;NPHP1;2;110879888;110962643;82755;0
11245;ENSG00000144115;THNSL2;2;88469835;88486146;16311;1
11246;ENSG00000144118;RALB;2;120997640;121052289;54649;0
11247;ENSG00000144120;TMEM177;2;120436743;120444083;7340;0
11248;ENSG00000144134;RABL2A;2;114384806;114400973;16167;0
11249;ENSG00000144136;SLC20A1;2;113403434;113421404;17970;0
11250;ENSG00000144152;FBLN7;2;112895962;112945791;49829;0
11251;ENSG00000144161;ZC3H8;2;112969102;113012713;43611;0
11252;ENSG00000144182;LIPT1;2;99771418;99779620;8202;0
11253;ENSG00000144191;CNGA3;2;98962618;99015064;52446;0
11254;ENSG00000144199;FAHD2B;2;97749320;97760619;11299;0
11255;ENSG00000144214;LYG1;2;99900701;99921205;20504;0
11256;ENSG00000144218;AFF3;2;100162323;100759201;596878;0
11257;ENSG00000144224;UBXN4;2;136499189;136542625;43436;0
11258;ENSG00000144227;NXPH2;2;139428342;139537918;109576;1
11259;ENSG00000144228;SPOPL;2;139259371;139331117;71746;0
11260;ENSG00000144229;THSD7B;2;137523115;138435287;912172;0
11261;ENSG00000144230;GPR17;2;128403439;128410213;6774;0
11262;ENSG00000144231;POLR2D;2;128603840;128615731;11891;0
11263;ENSG00000144233;AMMECR1L;2;128619204;128643496;24292;0
11264;ENSG00000144278;GALNT13;2;154728426;155310361;581935;0
11265;ENSG00000144283;PKP4;2;159313476;159539391;225915;0
11266;ENSG00000144285;SCN1A;2;166845670;166984523;138853;0
11267;ENSG00000144290;SLC4A10;2;162280843;162841792;560949;1
11268;ENSG00000144306;SCRN3;2;175260458;175294303;33845;0
11269;ENSG00000144320;KIAA1715;2;176788620;176867567;78947;0
11270;ENSG00000144331;ZNF385B;2;180306709;180726232;419523;0
11271;ENSG00000144339;TMEFF2;2;192813769;193060435;246666;0
11272;ENSG00000144354;CDCA7;2;174219548;174233725;14177;0
11273;ENSG00000144357;UBR3;2;170683968;170940641;256673;0
11274;ENSG00000144362;PHOSPHO2;2;170550975;170558218;7243;0
11275;ENSG00000144366;GULP1;2;189156396;189460653;304257;0
11276;ENSG00000144369;FAM171B;2;187558698;187630685;71987;0
11277;ENSG00000144381;HSPD1;2;198351305;198381461;30156;0
11278;ENSG00000144395;CCDC150;2;197504278;197628214;123936;0
11279;ENSG00000144401;METTL21A;2;208445355;208490652;45297;0
11280;ENSG00000144406;UNC80;2;210636717;210864024;227307;0
11281;ENSG00000144407;PTH2R;2;209224438;209719227;494789;0
11282;ENSG00000144410;CPO;2;207804278;207834198;29920;0
11283;ENSG00000144426;NBEAL1;2;203879602;204091101;211499;0
11284;ENSG00000144445;KANSL1L;2;210886147;211036107;149960;0
11285;ENSG00000144451;SPAG16;2;214149113;215275225;1126112;0
11286;ENSG00000144452;ABCA12;2;215796266;216003151;206885;0
11287;ENSG00000144455;SUMF1;3;3742498;4508965;766467;0
11288;ENSG00000144460;NYAP2;2;226265364;226518734;253370;0
11289;ENSG00000144468;RHBDD1;2;227700297;227863931;163634;0
11290;ENSG00000144476;ACKR3;2;237476430;237491001;14571;0
11291;ENSG00000144481;TRPM8;2;234826043;234928166;102123;0
11292;ENSG00000144485;HES6;2;239146908;239149303;2395;0
11293;ENSG00000144488;ESPNL;2;239008798;239041928;33130;0
11294;ENSG00000144504;ANKMY1;2;241418839;241508626;89787;0
11295;ENSG00000144524;COPS7B;2;232646381;232673963;27582;0
11296;ENSG00000144535;DIS3L2;2;232825955;233209060;383105;0
11297;ENSG00000144550;CPNE9;3;9745491;9771592;26101;0
11298;ENSG00000144554;FANCD2;3;10068098;10143614;75516;1
11299;ENSG00000144559;TAMM41;3;11831916;11888393;56477;0
11300;ENSG00000144560;VGLL4;3;11597544;11762220;164676;0
11301;ENSG00000144566;RAB5A;3;19988571;20026667;38096;0
11302;ENSG00000144567;FAM134A;2;220040947;220050201;9254;0
11303;ENSG00000144579;CTDSP1;2;219262979;219270664;7685;0
11304;ENSG00000144580;RQCD1;2;219433303;219461803;28500;0
11305;ENSG00000144583;04-Mar;2;217122588;217236750;114162;0
11306;ENSG00000144589;STK11IP;2;220462582;220481173;18591;0
11307;ENSG00000144591;GMPPA;2;220363589;220371710;8121;0
11308;ENSG00000144596;GRIP2;3;14530619;14583588;52969;1
11309;ENSG00000144597;EAF1;3;15468862;15484120;15258;0
11310;ENSG00000144619;CNTN4;3;2140497;3099645;959148;0
11311;ENSG00000144635;DYNC1LI1;3;32567463;32612366;44903;0
11312;ENSG00000144642;RBMS3;3;29322473;30051886;729413;0
11313;ENSG00000144645;OSBPL10;3;31699382;32119072;419690;0
11314;ENSG00000144647;POMGNT2;3;43120724;43147568;26844;0
11315;ENSG00000144655;CSRNP1;3;39183346;39196053;12707;0
11316;ENSG00000144659;SLC25A38;3;39424839;39438842;14003;0
11317;ENSG00000144668;ITGA9;3;37493606;37865005;371399;0
11318;ENSG00000144671;SLC22A14;3;38323785;38360066;36281;0
11319;ENSG00000144674;GOLGA4;3;37284668;37408242;123574;0
11320;ENSG00000144677;CTDSPL;3;37903451;38025960;122509;0
11321;ENSG00000144681;STAC;3;36421836;36589499;167663;0
11322;ENSG00000144711;IQSEC1;3;12938719;13114617;175898;0
11323;ENSG00000144712;CAND2;3;12837971;12913415;75444;0
11324;ENSG00000144713;RPL32;3;12875984;12883087;7103;0
11325;ENSG00000144724;PTPRG;3;61547243;62283288;736045;0
11326;ENSG00000144730;IL17RD;3;57124010;57204334;80324;0
11327;ENSG00000144736;SHQ1;3;72798428;72911065;112637;0
11328;ENSG00000144741;SLC25A26;3;66119285;66438540;319255;0
11329;ENSG00000144744;UBA3;3;69103881;69129559;25678;0
11330;ENSG00000144746;ARL6IP5;3;69134095;69155217;21122;0
11331;ENSG00000144747;TMF1;3;69068978;69101484;32506;0
11332;ENSG00000144749;LRIG1;3;66429221;66551687;122466;0
11333;ENSG00000144791;LIMD1;3;45596886;45727830;130944;0
11334;ENSG00000144792;ZNF660;3;44619715;44641186;21471;0
11335;ENSG00000144802;NFKBIZ;3;101546835;101579866;33031;0
11336;ENSG00000144810;COL8A1;3;99357319;99518070;160751;0
11337;ENSG00000144815;NXPE3;3;101498046;101547073;49027;0
11338;ENSG00000144821;MYH15;3;108099216;108248169;148953;0
11339;ENSG00000144824;PHLDB2;3;111451344;111695364;244020;1
11340;ENSG00000144827;ABHD10;3;111697857;111712210;14353;0
11341;ENSG00000144834;TAGLN3;3;111717511;111732734;15223;0
11342;ENSG00000144840;RABL3;3;120405528;120461840;56312;0
11343;ENSG00000144843;ADPRH;3;119298115;119308792;10677;0
11344;ENSG00000144847;IGSF11;3;118619404;118864915;245511;0
11345;ENSG00000144848;ATG3;3;112251356;112280893;29537;0
11346;ENSG00000144857;BOC;3;112929850;113006303;76453;0
11347;ENSG00000144867;SRPRB;3;133502877;133544616;41739;0
11348;ENSG00000144868;TMEM108;3;132757235;133116636;359401;0
11349;ENSG00000144891;AGTR1;3;148415571;148460795;45224;0
11350;ENSG00000144893;MED12L;3;150803484;151154860;351376;0
11351;ENSG00000144895;EIF2A;3;150264465;150302029;37564;0
11352;ENSG00000144908;ALDH1L1;3;125822412;125916837;94425;0
11353;ENSG00000144909;OSBPL11;3;125247702;125313934;66232;0
11354;ENSG00000144935;TRPC1;3;142442916;142526730;83814;0
11355;ENSG00000144959;NCEH1;3;172348039;172429008;80969;0
11356;ENSG00000145012;LPP;3;187871072;188608460;737388;0
11357;ENSG00000145014;TMEM44;3;194308402;194354418;46016;0
11358;ENSG00000145016;KIAA0226;3;197398264;197476598;78334;0
11359;ENSG00000145020;AMT;3;49454211;49460186;5975;0
11360;ENSG00000145022;TCTA;3;49449639;49453908;4269;0
11361;ENSG00000145029;NICN1;3;49460379;49466759;6380;0
11362;ENSG00000145040;UCN2;3;48599160;48601206;2046;0
11363;ENSG00000145041;VPRBP;3;51433298;51534010;100712;0
11364;ENSG00000145050;MANF;3;51422478;51426828;4350;0
11365;ENSG00000145075;CCDC39;3;180320646;180588793;268147;0
11366;ENSG00000145087;STXBP5L;3;120626919;121143608;516689;0
11367;ENSG00000145088;EAF2;3;121554030;121605373;51343;0
11368;ENSG00000145113;MUC4;3;195473636;195539148;65512;0
11369;ENSG00000145147;SLIT2;4;20254883;20622184;367301;1
11370;ENSG00000145191;EIF2B5;3;183852826;184402546;549720;0
11371;ENSG00000145192;AHSG;3;186330712;186339107;8395;0
11372;ENSG00000145194;ECE2;3;183967438;184010819;43381;0
11373;ENSG00000145198;VWA5B2;3;183948217;183960117;11900;0
11374;ENSG00000145214;DGKQ;4;952675;980683;28008;0
11375;ENSG00000145216;FIP1L1;4;54243810;55161439;917629;0
11376;ENSG00000145217;SLC26A1;4;972861;987228;14367;0
11377;ENSG00000145220;LYAR;4;4269428;4291896;22468;0
11378;ENSG00000145241;CENPC;4;68337521;68411324;73803;0
11379;ENSG00000145242;EPHA5;4;66185281;66536213;350932;0
11380;ENSG00000145244;CORIN;4;47596015;47840123;244108;1
11381;ENSG00000145246;ATP10D;4;47487305;47595503;108198;0
11382;ENSG00000145247;OCIAD2;4;48887036;48908954;21918;0
11383;ENSG00000145248;SLC10A4;4;48485360;48491213;5853;0
11384;ENSG00000145284;SCD5;4;83550692;83720010;169318;0
11385;ENSG00000145293;ENOPH1;4;83351715;83382244;30529;0
11386;ENSG00000145331;TRMT10A;4;100467866;100485189;17323;0
11387;ENSG00000145332;KLHL8;4;88081255;88161466;80211;0
11388;ENSG00000145335;SNCA;4;90645250;90759466;114216;0
11389;ENSG00000145337;PYURF;4;89442136;89444964;2828;0
11390;ENSG00000145348;TBCK;4;106962756;107242652;279896;0
11391;ENSG00000145349;CAMK2D;4;114372188;114683083;310895;0
11392;ENSG00000145354;CISD2;4;103790135;103810399;20264;0
11393;ENSG00000145358;DDIT4L;4;101107027;101111939;4912;0
11394;ENSG00000145362;ANK2;4;113739265;114304896;565631;0
11395;ENSG00000145365;TIFA;4;113195698;113207059;11361;0
11396;ENSG00000145375;SPATA5;4;123844229;124240605;396376;0
11397;ENSG00000145386;CCNA2;4;122737599;122745087;7488;0
11398;ENSG00000145388;METTL14;4;119606523;119636588;30065;0
11399;ENSG00000145390;USP53;4;120133742;120216672;82930;0
11400;ENSG00000145391;SETD7;4;140417095;140527853;110758;0
11401;ENSG00000145414;NAF1;4;164031225;164088073;56848;0
11402;ENSG00000145416;01-Mar;4;164445450;165305202;859752;0
11403;ENSG00000145423;SFRP2;4;154701744;154710272;8528;0
11404;ENSG00000145425;RPS3A;4;152020725;152025804;5079;0
11405;ENSG00000145428;RNF175;4;154631277;154681387;50110;0
11406;ENSG00000145431;PDGFC;4;157681606;157892546;210940;0
11407;ENSG00000145439;CBR4;4;169784921;169931426;146505;0
11408;ENSG00000145451;GLRA3;4;175558065;175750465;192400;0
11409;ENSG00000145476;CYP4V2;4;187112674;187134610;21936;0
11410;ENSG00000145491;ROPN1L;5;10441636;10472141;30505;0
11411;ENSG00000145494;NDUFS6;5;1801514;1816719;15205;0
11412;ENSG00000145495;06-Mar;5;10353815;10440500;86685;0
11413;ENSG00000145506;NKD2;5;1008944;1039058;30114;0
11414;ENSG00000145526;CDH18;5;19473060;20575982;1102922;0
11415;ENSG00000145536;ADAMTS16;5;5140443;5320417;179974;0
11416;ENSG00000145545;SRD5A1;5;6633456;6669675;36219;0
11417;ENSG00000145555;MYO10;5;16665395;16936372;270977;0
11418;ENSG00000145569;FAM105A;5;14581884;14615116;33232;0
11419;ENSG00000145592;RPL37;5;40825364;40835437;10073;0
11420;ENSG00000145604;SKP2;5;36152091;36184421;32330;0
11421;ENSG00000145623;OSMR;5;38845960;38945698;99738;1
11422;ENSG00000145632;PLK2;5;57749809;57756087;6278;0
11423;ENSG00000145675;PIK3R1;5;67511548;67597649;86101;0
11424;ENSG00000145700;ANKRD31;5;74364100;74532703;168603;0
11425;ENSG00000145734;BDP1;5;70751442;70863649;112207;0
11426;ENSG00000145736;GTF2H2;5;70330784;70363516;32732;0
11427;ENSG00000145740;SLC30A5;5;68389473;68426896;37423;0
11428;ENSG00000145741;BTF3;5;72794233;72801460;7227;0
11429;ENSG00000146205;ANO7;2;242127924;242164792;36868;0
11430;ENSG00000146556;WASH2P;2;114341664;114356655;14991;0
11431;ENSG00000149346;SLX4IP;20;10415951;10617477;201526;0
11432;ENSG00000149451;ADAM33;20;3648612;3662893;14281;0
11433;ENSG00000149474;CSRP2BP;20;18118762;18169031;50269;0
11434;ENSG00000149488;TMC2;20;2517253;2622430;105177;0
11435;ENSG00000149531;FRG1B;20;29611857;29634010;22153;0
11436;ENSG00000149599;DUSP15;20;30435440;30458550;23110;0
11437;ENSG00000149600;COMMD7;20;31290493;31331803;41310;0
11438;ENSG00000149609;C20orf144;20;32250090;32253425;3335;0
11439;ENSG00000149634;SPATA25;20;44515128;44516274;1146;0
11440;ENSG00000149636;DSN1;20;35380194;35402221;22027;0
11441;ENSG00000149639;SOGA1;20;35405845;35492089;86244;0
11442;ENSG00000149654;CDH22;20;44802372;44937137;134765;0
11443;ENSG00000149657;LSM14B;20;60697517;60710434;12917;0
11444;ENSG00000149658;YTHDF1;20;61826781;61847586;20805;0
11445;ENSG00000149679;CABLES2;20;60963688;60982341;18653;0
11446;ENSG00000150471;LPHN3;4;62066976;62944053;877077;0
11447;ENSG00000150540;HNMT;2;138721590;138773930;52340;1
11448;ENSG00000150551;LYPD1;2;133402426;133429152;26726;0
11449;ENSG00000150556;LYPD6B;2;149894621;150071776;177155;0
11450;ENSG00000150625;GPM6A;4;176554085;176923815;369730;0
11451;ENSG00000150627;WDR17;4;176986985;177103978;116993;0
11452;ENSG00000150628;SPATA4;4;177105789;177116822;11033;0
11453;ENSG00000150630;VEGFC;4;177604689;177713881;109192;0
11454;ENSG00000150712;MTMR12;5;32227100;32313115;86015;0
11455;ENSG00000150722;PPP1R1C;2;182818968;182996125;177157;0
11456;ENSG00000150753;CCT5;5;10250033;10266524;16491;0
11457;ENSG00000150756;FAM173B;5;10226442;10250009;23567;0
11458;ENSG00000150873;C2orf50;2;11273179;11286916;13737;0
11459;ENSG00000150938;CRIM1;2;36583069;36778278;195209;0
11460;ENSG00000150961;SEC24D;4;119643978;119759838;115860;0
11461;ENSG00000150995;ITPR1;3;4535032;4889524;354492;1
11462;ENSG00000151005;TKTL2;4;164392257;164395047;2790;0
11463;ENSG00000151012;SLC7A11;4;139085251;139163503;78252;1
11464;ENSG00000151014;CCRN4L;4;139936943;139966906;29963;0
11465;ENSG00000151090;THRB;3;24158651;24536773;378122;0
11466;ENSG00000151092;NGLY1;3;25760435;25831530;71095;0
11467;ENSG00000151093;OXSM;3;25824408;25836025;11617;0
11468;ENSG00000151247;EIF4E;4;99792835;99851788;58953;0
11469;ENSG00000151276;MAGI1;3;65339200;66024509;685309;0
11470;ENSG00000151353;TMEM18;2;667335;677439;10104;0
11471;ENSG00000151360;ALLC;2;3705785;3750261;44476;0
11472;ENSG00000151388;ADAMTS12;5;33523640;33892297;368657;0
11473;ENSG00000151458;ANKRD50;4;125585207;125633887;48680;0
11474;ENSG00000151466;SCLT1;4;129786076;130014764;228688;0
11475;ENSG00000151470;C4orf33;4;130014472;130037795;23323;0
11476;ENSG00000151552;QDPR;4;17461884;17513857;51973;0
11477;ENSG00000151576;QTRTD1;3;113724680;113807269;82589;0
11478;ENSG00000151611;MMAA;4;146539415;146581187;41772;0
11479;ENSG00000151612;ZNF827;4;146678779;146859787;181008;0
11480;ENSG00000151615;POU4F2;4;147560045;147563626;3581;0
11481;ENSG00000151617;EDNRA;4;148402069;148466106;64037;0
11482;ENSG00000151623;NR3C2;4;148999913;149365850;365937;0
11483;ENSG00000151665;PIGF;2;46808076;46844258;36182;0
11484;ENSG00000151687;ANKAR;2;190539016;190625919;86903;0
11485;ENSG00000151689;INPP1;2;191208196;191236391;28195;0
11486;ENSG00000151690;MFSD6;2;191273081;191373931;100850;0
11487;ENSG00000151692;RNF144A;2;7057523;7208417;150894;0
11488;ENSG00000151693;ASAP2;2;9346894;9545812;198918;0
11489;ENSG00000151694;ADAM17;2;9628615;9695921;67306;0
11490;ENSG00000151718;WWC2;4;184020446;184241930;221484;0
11491;ENSG00000151725;CENPU;4;185615772;185655287;39515;0
11492;ENSG00000151726;ACSL1;4;185676749;185747972;71223;0
11493;ENSG00000151729;SLC25A4;4;186064395;186071536;7141;0
11494;ENSG00000151779;NBAS;2;15307032;15701454;394422;0
11495;ENSG00000151789;ZNF385D;3;21459915;22414812;954897;1
11496;ENSG00000151806;GUF1;4;44680444;44702943;22499;0
11497;ENSG00000151834;GABRA2;4;46250444;46477247;226803;0
11498;ENSG00000151876;FBXO4;5;41925356;41941845;16489;0
11499;ENSG00000151881;C5orf28;5;43444354;43483995;39641;0
11500;ENSG00000151883;PARP8;5;49961733;50142356;180623;0
11501;ENSG00000151967;SCHIP1;3;159557650;159615149;57499;0
11502;ENSG00000152056;AP1S3;2;224616403;224702744;86341;0
11503;ENSG00000152076;CCDC74B;2;130896860;130902707;5847;0
11504;ENSG00000152082;MZT2B;2;130939310;130948302;8992;0
11505;ENSG00000152102;FAM168B;2;131805449;131851033;45584;0
11506;ENSG00000152117;;2;132250386;132279146;28760;0
11507;ENSG00000152127;MGAT5;2;134877554;135212192;334638;0
11508;ENSG00000152128;TMEM163;2;135213330;135476570;263240;0
11509;ENSG00000152133;GPATCH11;2;37311594;37326387;14793;0
11510;ENSG00000152147;GEMIN6;2;38978676;39012142;33466;0
11511;ENSG00000152154;TMEM178A;2;39892122;39945103;52981;0
11512;ENSG00000152208;GRID2;4;93225550;94695707;1470157;0
11513;ENSG00000152253;SPC25;2;169690642;169769881;79239;1
11514;ENSG00000152256;PDK1;2;173420101;173489823;69722;0
11515;ENSG00000152284;TCF7L1;2;85360533;85537511;176978;1
11516;ENSG00000152291;TGOLN2;2;85545147;85555548;10401;0
11517;ENSG00000152292;SH2D6;2;85645844;85664152;18308;0
11518;ENSG00000152433;ZNF547;19;57874845;57890933;16088;0
11519;ENSG00000152439;ZNF773;19;58011283;58029772;18489;0
11520;ENSG00000152443;ZNF776;19;58258164;58269527;11363;0
11521;ENSG00000152454;ZNF256;19;58452201;58459043;6842;0
11522;ENSG00000152475;ZNF837;19;58878985;58892427;13442;0
11523;ENSG00000152492;CCDC50;3;191046866;191116459;69593;0
11524;ENSG00000152518;ZFP36L2;2;43449541;43453748;4207;0
11525;ENSG00000152527;PLEKHH2;2;43864412;43995126;130714;0
11526;ENSG00000152580;IGSF10;3;151143172;151176497;33325;0
11527;ENSG00000152582;SPEF2;5;35617946;35814713;196767;0
11528;ENSG00000152583;SPARCL1;4;88394487;88452213;57726;0
11529;ENSG00000152591;DSPP;4;88529681;88538062;8381;0
11530;ENSG00000152592;DMP1;4;88571459;88585513;14054;0
11531;ENSG00000152601;MBNL1;3;151961617;152183569;221952;0
11532;ENSG00000152611;CAPSL;5;35904397;35938881;34484;0
11533;ENSG00000152620;NADK2;5;36192694;36242381;49687;0
11534;ENSG00000152642;GPD1L;3;32147181;32210205;63024;0
11535;ENSG00000152670;DDX4;5;55033845;55112985;79140;0
11536;ENSG00000152672;CLEC4F;2;71035775;71047732;11957;0
11537;ENSG00000152683;SLC30A6;2;32390933;32449448;58515;0
11538;ENSG00000152684;PELO;5;52083774;52099880;16106;0
11539;ENSG00000152689;RASGRP3;2;33661391;33789817;128426;0
11540;ENSG00000152784;PRDM8;4;81105033;81125483;20450;0
11541;ENSG00000152785;BMP3;4;81952119;81978685;26566;0
11542;ENSG00000152795;HNRNPDL;4;83343717;83351294;7577;0
11543;ENSG00000152932;RAB3C;5;57878048;58155213;277165;0
11544;ENSG00000152939;MARVELD2;5;68710939;68740157;29218;0
11545;ENSG00000152942;RAD17;5;68665120;68710628;45508;0
11546;ENSG00000152952;PLOD2;3;145787227;145881440;94213;0
11547;ENSG00000152953;STK32B;4;5053169;5502725;449556;1
11548;ENSG00000152969;JAKMIP1;4;6027926;6202318;174392;0
11549;ENSG00000152977;ZIC1;3;147111209;147228080;116871;0
11550;ENSG00000152990;GPR125;4;22346694;22517677;170983;0
11551;ENSG00000153006;SREK1IP1;5;64013971;64064512;50541;0
11552;ENSG00000153012;LGI2;4;25000469;25032501;32032;1
11553;ENSG00000153015;CWC27;5;64064757;64314590;249833;0
11554;ENSG00000153044;CENPH;5;68485375;68506184;20809;0
11555;ENSG00000153064;BANK1;4;102332443;102995969;663526;0
11556;ENSG00000153071;DAB2;5;39371780;39462402;90622;0
11557;ENSG00000153094;BCL2L11;2;111876955;111926024;49069;0
11558;ENSG00000153107;ANAPC1;2;112523848;112642267;118419;0
11559;ENSG00000153130;SCOC;4;141178440;141306880;128440;0
11560;ENSG00000153132;CLGN;4;141309609;141349122;39513;0
11561;ENSG00000153147;SMARCA5;4;144434616;144478639;44023;0
11562;ENSG00000153165;RGPD3;2;107021446;107084832;63386;0
11563;ENSG00000153201;RANBP2;2;109335937;109402267;66330;0
11564;ENSG00000153208;MERTK;2;112656056;112787138;131082;0
11565;ENSG00000153214;TMEM87B;2;112812800;112876895;64095;0
11566;ENSG00000153234;NR4A2;2;157180944;157198860;17916;1
11567;ENSG00000153237;CCDC148;2;159027593;159313265;285672;0
11568;ENSG00000153246;PLA2R1;2;160788519;160919121;130602;0
11569;ENSG00000153250;RBMS1;2;161128662;161350305;221643;0
11570;ENSG00000153253;SCN3A;2;165944032;166060577;116545;0
11571;ENSG00000153283;CD96;3;111011566;111384597;373031;0
11572;ENSG00000153395;LPCAT1;5;1456595;1524092;67497;0
11573;ENSG00000153404;PLEKHG4B;5;140373;190085;49712;0
11574;ENSG00000153551;CMTM7;3;32433163;32524559;91396;0
11575;ENSG00000153558;FBXL2;3;33318517;33445154;126637;0
11576;ENSG00000153560;UBP1;3;33429828;33482863;53035;0
11577;ENSG00000153561;RMND5A;2;86947296;87005164;57868;0
11578;ENSG00000153563;CD8A;2;87011729;87035519;23790;0
11579;ENSG00000153574;RPIA;2;88991162;89050452;59290;0
11580;ENSG00000153767;GTF2E1;3;120461484;120501916;40432;0
11581;ENSG00000153820;SPHKAP;2;228844666;229046361;201695;0
11582;ENSG00000153823;PID1;2;229715242;230136001;420759;1
11583;ENSG00000153827;TRIP12;2;230628554;230787955;159401;0
11584;ENSG00000153832;FBXO36;2;230787018;230877825;90807;0
11585;ENSG00000153914;SREK1;5;65435799;65479443;43644;0
11586;ENSG00000154122;ANKH;5;14704910;14871887;166977;0
11587;ENSG00000154124;FAM105B;5;14664773;14699820;35047;0
11588;ENSG00000154153;FAM134B;5;16473147;16617167;144020;0
11589;ENSG00000154162;CDH12;5;21750782;22853731;1102949;0
11590;ENSG00000154174;TOMM70A;3;100082275;100120242;37967;0
11591;ENSG00000154175;ABI3BP;3;100468000;100712359;244359;0
11592;ENSG00000154274;C4orf19;4;37455563;37625117;169554;0
11593;ENSG00000154277;UCHL1;4;41258430;41270472;12042;0
11594;ENSG00000154310;TNIK;3;170779128;171178197;399069;0
11595;ENSG00000154447;SH3RF1;4;170015407;170192256;176849;0
11596;ENSG00000154479;CCDC173;2;170501935;170550943;49008;0
11597;ENSG00000154518;ATP5G3;2;176040986;176049335;8349;0
11598;ENSG00000154553;PDLIM3;4;186422851;186456766;33915;0
11599;ENSG00000154556;SORBS2;4;186506598;186877806;371208;0
11600;ENSG00000154608;CEP170P1;4;119388745;119476483;87738;0
11601;ENSG00000154639;CXADR;21;18884700;18965897;81197;0
11602;ENSG00000154640;BTG3;21;18965971;18985265;19294;0
11603;ENSG00000154642;C21orf91;21;19161284;19191703;30419;0
11604;ENSG00000154645;CHODL;21;19273580;19639690;366110;0
11605;ENSG00000154646;TMPRSS15;21;19641433;19858197;216764;0
11606;ENSG00000154654;NCAM2;21;22370633;22915650;545017;0
11607;ENSG00000154719;MRPL39;21;26957968;26979829;21861;0
11608;ENSG00000154721;JAM2;21;27011584;27089874;78290;0
11609;ENSG00000154723;ATP5J;21;27088815;27107984;19169;0
11610;ENSG00000154727;GABPA;21;27106881;27144771;37890;0
11611;ENSG00000154734;ADAMTS1;21;28208066;28217728;9662;0
11612;ENSG00000154736;ADAMTS5;21;28290231;28338832;48601;0
11613;ENSG00000154743;TSEN2;3;12525931;12581122;55191;0
11614;ENSG00000154764;WNT7A;3;13857755;13921618;63863;0
11615;ENSG00000154767;XPC;3;14186647;14220283;33636;0
11616;ENSG00000154781;CCDC174;3;14693271;14714166;20895;0
11617;ENSG00000154783;FGD5;3;14860469;14975895;115426;0
11618;ENSG00000154813;DPH3;3;16299485;16306479;6994;0
11619;ENSG00000154814;OXNAD1;3;16306706;16391806;85100;0
11620;ENSG00000154822;PLCL2;3;16844159;17132086;287927;0
11621;ENSG00000154917;RAB6B;3;133543083;133614680;71597;0
11622;ENSG00000154928;EPHB1;3;134316643;134979309;662666;0
11623;ENSG00000154930;ACSS1;20;24986868;25039616;52748;0
11624;ENSG00000155011;DKK2;4;107842959;108204963;362004;1
11625;ENSG00000155016;CYP2U1;4;108852525;108874613;22088;0
11626;ENSG00000155052;CNTNAP5;2;124782864;125672864;890000;0
11627;ENSG00000155066;PROM2;2;95940201;95957056;16855;0
11628;ENSG00000155275;TRMT44;4;8437867;8495258;57391;0
11629;ENSG00000155304;HSPA13;21;15743436;15755805;12369;0
11630;ENSG00000155313;USP25;21;17102344;17252377;150033;0
11631;ENSG00000155368;DBI;2;120124497;120130126;5629;0
11632;ENSG00000155438;NIFK;2;122484521;122494499;9978;0
11633;ENSG00000155542;SETD9;5;56205087;56221359;16272;0
11634;ENSG00000155545;MIER3;5;56215429;56267502;52073;0
11635;ENSG00000155636;RBM45;2;178977151;179003738;26587;0
11636;ENSG00000155657;TTN;2;179390716;179695529;304813;0
11637;ENSG00000155729;KCTD18;2;201353675;201384507;30832;0
11638;ENSG00000155744;FAM126B;2;201838441;201936394;97953;0
11639;ENSG00000155749;ALS2CR12;2;202152994;202222121;69127;0
11640;ENSG00000155755;TMEM237;2;202484907;202508293;23386;0
11641;ENSG00000155760;FZD7;2;202899310;202903160;3850;0
11642;ENSG00000155893;ACPL2;3;140947568;141013748;66180;0
11643;ENSG00000155903;RASA2;3;141205889;141334184;128295;0
11644;ENSG00000156136;DCK;4;71858255;71896631;38376;0
11645;ENSG00000156140;ADAMTS3;4;73146686;73434516;287830;0
11646;ENSG00000156219;ART3;4;76932337;77033955;101618;0
11647;ENSG00000156239;N6AMT1;21;30244513;30257693;13180;0
11648;ENSG00000156253;RWDD2B;21;30376705;30391699;14994;0
11649;ENSG00000156256;USP16;21;30396950;30426809;29859;0
11650;ENSG00000156261;CCT8;21;30428126;30446118;17992;0
11651;ENSG00000156273;BACH1;21;30566392;31003071;436679;0
11652;ENSG00000156299;TIAM1;21;32490734;32932290;441556;0
11653;ENSG00000156304;SCAF4;21;33043346;33104388;61042;0
11654;ENSG00000156931;VPS8;3;184529931;184770402;240471;0
11655;ENSG00000156959;LHFPL4;3;9543481;9595486;52005;0
11656;ENSG00000156966;B3GNT7;2;232260254;232265875;5621;0
11657;ENSG00000156973;PDE6D;2;232597135;232650982;53847;0
11658;ENSG00000156976;EIF4A2;3;186500994;186507689;6695;0
11659;ENSG00000156983;BRPF1;3;9773413;9789702;16289;0
11660;ENSG00000156990;RPUSD3;3;9879533;9886286;6753;0
11661;ENSG00000157005;SST;3;187386694;187388187;1493;1
11662;ENSG00000157014;TATDN2;3;10289707;10322902;33195;0
11663;ENSG00000157017;GHRL;3;10327359;10334631;7272;0
11664;ENSG00000157020;SEC13;3;10334815;10362862;28047;0
11665;ENSG00000157036;EXOG;3;38537618;38583652;46034;0
11666;ENSG00000157087;ATP2B2;3;10365707;10749716;384009;1
11667;ENSG00000157103;SLC6A1;3;11034410;11080933;46523;1
11668;ENSG00000157107;FCHO2;5;72251808;72386349;134541;0
11669;ENSG00000157150;TIMP4;3;12194551;12200851;6300;0
11670;ENSG00000157152;SYN2;3;12045876;12232900;187024;0
11671;ENSG00000157388;CACNA1D;3;53528683;53847760;319077;0
11672;ENSG00000157404;KIT;4;55524085;55606881;82796;1
11673;ENSG00000157426;AASDH;4;57204456;57253666;49210;0
11674;ENSG00000157445;CACNA2D3;3;54156574;55108584;952010;0
11675;ENSG00000157500;APPL1;3;57261765;57307496;45731;0
11676;ENSG00000157538;DSCR3;21;38595721;38640262;44541;0
11677;ENSG00000157540;DYRK1A;21;38738092;38889753;151661;0
11678;ENSG00000157542;KCNJ6;21;38979678;39288749;309071;0
11679;ENSG00000157557;ETS2;21;40177231;40196879;19648;0
11680;ENSG00000157578;LCA5L;21;40777770;40817731;39961;0
11681;ENSG00000157601;MX1;21;42792231;42831141;38910;0
11682;ENSG00000157617;C2CD2;21;43305221;43373999;68778;0
11683;ENSG00000157765;SLC34A2;4;25656923;25680370;23447;0
11684;ENSG00000157796;WDR19;4;39184024;39287430;103406;0
11685;ENSG00000157827;FMNL2;2;153191751;153506348;314597;0
11686;ENSG00000157833;GAREML;2;26395960;26412532;16572;0
11687;ENSG00000157851;DPYSL5;2;27070615;27173219;102604;0
11688;ENSG00000157856;DRC1;2;26624784;26679579;54795;0
11689;ENSG00000157869;RAB28;4;13362978;13485989;123011;0
11690;ENSG00000157985;AGAP1;2;236402733;237040444;637711;0
11691;ENSG00000157992;KRTCAP3;2;27665233;27669348;4115;0
11692;ENSG00000158019;BRE;2;28112808;28561768;448960;0
11693;ENSG00000158050;DUSP2;2;96808905;96811179;2274;0
11694;ENSG00000158089;GALNT14;2;31133333;31378068;244735;1
11695;ENSG00000158092;NCK1;3;136581050;136668665;87615;0
11696;ENSG00000158125;XDH;2;31557187;31637581;80394;0
11697;ENSG00000158158;CNNM4;2;97426639;97477628;50989;0
11698;ENSG00000158163;DZIP1L;3;137780832;137834660;53828;0
11699;ENSG00000158186;MRAS;3;138066539;138124375;57836;0
11700;ENSG00000158220;ESYT3;3;138153428;138200528;47100;0
11701;ENSG00000158234;FAIM;3;138327448;138352218;24770;0
11702;ENSG00000158258;CLSTN2;3;139654027;140296239;642212;0
11703;ENSG00000158296;SLC13A3;20;45186463;45304714;118251;0
11704;ENSG00000158411;MITD1;2;99777890;99797521;19631;0
11705;ENSG00000158417;EIF5B;2;99953816;100017789;63973;0
11706;ENSG00000158428;C2orf62;2;219221579;219232822;11243;0
11707;ENSG00000158435;CNOT11;2;101869264;101886778;17514;0
11708;ENSG00000158445;KCNB1;20;47980414;48099184;118770;0
11709;ENSG00000158470;B4GALT5;20;48249482;48330415;80933;0
11710;ENSG00000158480;SPATA2;20;48519928;48532080;12152;0
11711;ENSG00000158552;ZFAND2B;2;220059959;220074373;14414;0
11712;ENSG00000159055;MIS18A;21;33640530;33651380;10850;0
11713;ENSG00000159079;C21orf59;21;33964389;33985176;20787;0
11714;ENSG00000159082;SYNJ1;21;34001069;34100359;99290;0
11715;ENSG00000159086;PAXBP1;21;34106210;34144169;37959;0
11716;ENSG00000159110;IFNAR2;21;34602206;34637980;35774;0
11717;ENSG00000159128;IFNGR2;21;34775202;34851655;76453;0
11718;ENSG00000159131;GART;21;34876238;34915797;39559;0
11719;ENSG00000159140;SON;21;34914924;34949812;34888;0
11720;ENSG00000159147;DONSON;21;34931848;34961014;29166;0
11721;ENSG00000159197;KCNE2;21;35736323;35743688;7365;0
11722;ENSG00000159200;RCAN1;21;35885440;35987441;102001;0
11723;ENSG00000159228;CBR1;21;37442239;37445464;3225;0
11724;ENSG00000159231;CBR3;21;37507210;37518864;11654;0
11725;ENSG00000159239;C2orf81;2;74641304;74648718;7414;0
11726;ENSG00000159256;MORC3;21;37692487;37758446;65959;0
11727;ENSG00000159259;CHAF1B;21;37757676;37791313;33637;0
11728;ENSG00000159267;HLCS;21;38123189;38362536;239347;0
11729;ENSG00000159307;SCUBE1;22;43593289;43739394;146105;0
11730;ENSG00000159374;M1AP;2;74785010;74875465;90455;0
11731;ENSG00000159399;HK2;2;75061108;75120486;59378;0
11732;ENSG00000159650;UROC1;3;126200124;126236616;36492;0
11733;ENSG00000159685;CHCHD6;3;126423063;126679249;256186;0
11734;ENSG00000159692;CTBP1;4;1205236;1243741;38505;0
11735;ENSG00000159733;ZFYVE28;4;2271309;2420390;149081;0
11736;ENSG00000159788;RGS12;4;3294755;3441640;146885;0
11737;ENSG00000159873;CCDC117;22;29168662;29185283;16621;0
11738;ENSG00000160124;CCDC58;3;122078438;122102078;23640;0
11739;ENSG00000160145;KALRN;3;123798870;124445172;646302;0
11740;ENSG00000160179;ABCG1;21;43619799;43717354;97555;0
11741;ENSG00000160188;RSPH1;21;43892596;43916464;23868;0
11742;ENSG00000160190;SLC37A1;21;43916118;44001550;85432;0
11743;ENSG00000160191;PDE9A;21;44073746;44195619;121873;0
11744;ENSG00000160193;WDR4;21;44263204;44299678;36474;0
11745;ENSG00000160194;NDUFV3;21;44299754;44333414;33660;0
11746;ENSG00000160199;PKNOX1;21;44394620;44453691;59071;0
11747;ENSG00000160200;CBS;21;44473301;44497053;23752;0
11748;ENSG00000160201;U2AF1;21;44513066;44527697;14631;0
11749;ENSG00000160207;HSF2BP;21;44949072;45079374;130302;0
11750;ENSG00000160208;RRP1B;21;45079429;45115958;36529;0
11751;ENSG00000160209;PDXK;21;45138975;45182188;43213;0
11752;ENSG00000160213;CSTB;21;45192393;45196326;3933;0
11753;ENSG00000160214;RRP1;21;45209394;45225174;15780;0
11754;ENSG00000160216;AGPAT3;21;45285067;45406417;121350;0
11755;ENSG00000160218;TRAPPC10;21;45432200;45526433;94233;0
11756;ENSG00000160221;C21orf33;21;45553487;45565605;12118;0
11757;ENSG00000160226;C21orf2;21;45748827;45759285;10458;0
11758;ENSG00000160233;LRRC3;21;45875369;45878739;3370;0
11759;ENSG00000160256;FAM207A;21;46359925;46396904;36979;0
11760;ENSG00000160284;SPATC1L;21;47581062;47604390;23328;0
11761;ENSG00000160285;LSS;21;47608055;47648738;40683;0
11762;ENSG00000160294;MCM3AP;21;47655047;47706211;51164;0
11763;ENSG00000160298;C21orf58;21;47720095;47743789;23694;0
11764;ENSG00000160299;PCNT;21;47744036;47865682;121646;0
11765;ENSG00000160305;DIP2A;21;47878812;47989926;111114;0
11766;ENSG00000160307;S100B;21;48018875;48025121;6246;1
11767;ENSG00000160310;PRMT2;21;48055079;48085036;29957;0
11768;ENSG00000160439;RDH13;19;55550476;55582659;32183;0
11769;ENSG00000160469;BRSK1;19;55793440;55823901;30461;0
11770;ENSG00000160471;COX6B2;19;55860674;55866182;5508;0
11771;ENSG00000160746;ANO10;3;43396351;43733086;336735;0
11772;ENSG00000160796;NBEAL2;3;47021173;47051193;30020;0
11773;ENSG00000160799;CCDC12;3;46963216;47023500;60284;0
11774;ENSG00000160801;PTH1R;3;46919236;46945287;26051;0
11775;ENSG00000161149;TUBA3FP;22;21357184;21368581;11397;0
11776;ENSG00000161179;YDJC;22;21982378;21984353;1975;0
11777;ENSG00000161180;CCDC116;22;21987005;21991616;4611;0
11778;ENSG00000161202;DVL3;3;183873176;183891398;18222;0
11779;ENSG00000161203;AP2M1;3;183892477;183901879;9402;0
11780;ENSG00000161204;ABCF3;3;183903811;183911800;7989;0
11781;ENSG00000161217;PCYT1A;3;195941093;196014828;73735;0
11782;ENSG00000161267;BDH1;3;197236654;197300194;63540;1
11783;ENSG00000162244;RPL29;3;52027616;52029958;2342;0
11784;ENSG00000162290;DCP1A;3;53317447;53381654;64207;0
11785;ENSG00000162804;SNED1;2;241938255;242034983;96728;0
11786;ENSG00000162869;PPP1R21;2;48667737;48742525;74788;0
11787;ENSG00000162878;PKDCC;2;42275160;42285668;10508;0
11788;ENSG00000162924;REL;2;61108656;61158745;50089;0
11789;ENSG00000162927;PUS10;2;61167357;61245394;78037;0
11790;ENSG00000162928;PEX13;2;61244360;61279125;34765;0
11791;ENSG00000162929;KIAA1841;2;61293006;61391960;98954;0
11792;ENSG00000162944;RFTN2;2;198432948;198540769;107821;0
11793;ENSG00000162951;LRRTM1;2;80515483;80531874;16391;0
11794;ENSG00000162959;MEMO1;2;32090129;32236299;146170;0
11795;ENSG00000162961;DPY30;2;32092878;32264881;172003;0
11796;ENSG00000162971;TYW5;2;200794698;200820459;25761;0
11797;ENSG00000162972;C2orf47;2;200820040;200873263;53223;0
11798;ENSG00000162975;KCNF1;2;11052063;11054350;2287;0
11799;ENSG00000162976;PQLC3;2;11295324;11319000;23676;0
11800;ENSG00000162980;ARL5A;2;152645498;152685006;39508;0
11801;ENSG00000162981;FAM84A;2;14772810;14790933;18123;0
11802;ENSG00000162989;KCNJ3;2;155554811;155714863;160052;0
11803;ENSG00000162992;NEUROD1;2;182537815;182545603;7788;1
11804;ENSG00000162994;CLHC1;2;55401927;55459699;57772;0
11805;ENSG00000162997;PRORSD1P;2;55509455;55511658;2203;0
11806;ENSG00000162998;FRZB;2;183698002;183731890;33888;0
11807;ENSG00000162999;DUSP19;2;183943287;183964733;21446;0
11808;ENSG00000163001;CCDC104;2;55746740;55773015;26275;0
11809;ENSG00000163002;NUP35;2;183982241;184026408;44167;0
11810;ENSG00000163006;CCDC138;2;109403213;109501933;98720;0
11811;ENSG00000163012;ZSWIM2;2;187692562;187713935;21373;0
11812;ENSG00000163013;FBXO41;2;73481810;73511559;29749;0
11813;ENSG00000163016;ALMS1P;2;73872046;73912703;40657;0
11814;ENSG00000163017;ACTG2;2;74119441;74146992;27551;0
11815;ENSG00000163026;C2orf44;2;24252210;24272445;20235;0
11816;ENSG00000163029;SMC6;2;17845079;17981509;136430;0
11817;ENSG00000163032;VSNL1;2;17720393;17838285;117892;0
11818;ENSG00000163040;CCDC74A;2;132285248;132291239;5991;0
11819;ENSG00000163046;ANKRD30BL;2;132905164;133015542;110378;0
11820;ENSG00000163053;SLC16A14;2;230899698;230933715;34017;0
11821;ENSG00000163064;EN1;2;119599747;119605254;5507;1
11822;ENSG00000163067;ZNF2;2;95831177;95850065;18888;0
11823;ENSG00000163069;SGCB;4;52886872;52904648;17776;0
11824;ENSG00000163071;SPATA18;4;52917497;52963458;45961;0
11825;ENSG00000163075;;2;120302008;120419827;117819;0
11826;ENSG00000163081;CCDC140;2;223162866;223169936;7070;0
11827;ENSG00000163082;SGPP2;2;223289236;223425667;136431;0
11828;ENSG00000163083;INHBB;2;121103719;121109384;5665;1
11829;ENSG00000163093;BBS5;2;170335688;170382432;46744;0
11830;ENSG00000163104;SMARCAD1;4;95128762;95212443;83681;0
11831;ENSG00000163110;PDLIM5;4;95373037;95589377;216340;0
11832;ENSG00000163116;STPG2;4;98105244;99064391;959147;0
11833;ENSG00000163126;ANKRD23;2;97490263;97523671;33408;0
11834;ENSG00000163132;MSX1;4;4861393;4865663;4270;0
11835;ENSG00000163138;PACRGL;4;20697905;20754530;56625;0
11836;ENSG00000163145;C1QTNF7;4;15341442;15447790;106348;0
11837;ENSG00000163161;ERCC3;2;128014866;128051752;36886;0
11838;ENSG00000163162;RNF149;2;101887681;101925163;37482;0
11839;ENSG00000163166;IWS1;2;128193783;128284462;90679;0
11840;ENSG00000163170;BOLA3;2;74362525;74375121;12596;0
11841;ENSG00000163171;CDC42EP3;2;37869032;37965611;96579;0
11842;ENSG00000163214;DHX57;2;39024871;39103075;78204;0
11843;ENSG00000163235;TGFA;2;70674412;70781325;106913;0
11844;ENSG00000163249;CCNYL1;2;208576264;208626563;50299;0
11845;ENSG00000163251;FZD5;2;208627310;208634287;6977;0
11846;ENSG00000163257;DCAF16;4;17802278;17812381;10103;0
11847;ENSG00000163273;NPPC;2;232786530;232791113;4583;0
11848;ENSG00000163281;GNPDA2;4;44684217;44728612;44395;0
11849;ENSG00000163285;GABRG1;4;46037786;46126098;88312;0
11850;ENSG00000163288;GABRB1;4;46995740;47428461;432721;0
11851;ENSG00000163291;PAQR3;4;79808281;79860592;52311;0
11852;ENSG00000163293;NIPAL1;4;47916159;48042188;126029;0
11853;ENSG00000163297;ANTXR2;4;80822303;81046608;224305;0
11854;ENSG00000163312;HELQ;4;84328496;84377009;48513;0
11855;ENSG00000163319;MRPS18C;4;84377085;84390888;13803;0
11856;ENSG00000163320;CGGBP1;3;88101094;88199035;97941;0
11857;ENSG00000163322;FAM175A;4;84382092;84444501;62409;0
11858;ENSG00000163328;GPR155;2;175296966;175351822;54856;0
11859;ENSG00000163347;CLDN1;3;190023490;190040264;16774;0
11860;ENSG00000163376;KBTBD8;3;67048727;67061634;12907;0
11861;ENSG00000163377;FAM19A4;3;68780917;68981761;200844;0
11862;ENSG00000163378;EOGT;3;69024365;69063112;38747;0
11863;ENSG00000163389;POGLUT1;3;119187785;119213555;25770;0
11864;ENSG00000163406;SLC15A2;3;121612936;121662949;50013;0
11865;ENSG00000163412;EIF4E3;3;71724567;71803924;79357;0
11866;ENSG00000163428;LRRC58;3;120043356;120068186;24830;0
11867;ENSG00000163430;FSTL1;3;120111140;120170100;58960;0
11868;ENSG00000163449;TMEM169;2;216946589;216967506;20917;0
11869;ENSG00000163466;ARPC2;2;219081817;219119079;37262;0
11870;ENSG00000163481;RNF25;2;219528587;219537134;8547;0
11871;ENSG00000163482;STK36;2;219536749;219567439;30690;0
11872;ENSG00000163491;NEK10;3;27151576;27410951;259375;0
11873;ENSG00000163492;CCDC141;2;179694484;179914813;220329;0
11874;ENSG00000163507;KIAA1524;3;108268716;108308491;39775;0
11875;ENSG00000163508;EOMES;3;27757440;27764206;6766;0
11876;ENSG00000163510;CWC22;2;180809603;180871840;62237;0
11877;ENSG00000163512;AZI2;3;28356494;28390618;34124;0
11878;ENSG00000163513;TGFBR2;3;30647994;30735634;87640;0
11879;ENSG00000163516;ANKZF1;2;220094479;220101391;6912;0
11880;ENSG00000163517;HDAC11;3;13521224;13547916;26692;0
11881;ENSG00000163520;FBLN2;3;13573824;13679922;106098;0
11882;ENSG00000163521;GLB1L;2;220101328;220110200;8872;0
11883;ENSG00000163527;STT3B;3;31574130;31679112;104982;0
11884;ENSG00000163528;CHCHD4;3;14153580;14166370;12790;0
11885;ENSG00000163535;SGOL2;2;201374731;201448505;73774;0
11886;ENSG00000163536;SERPINI1;3;167453031;167543356;90325;0
11887;ENSG00000163539;CLASP2;3;33537737;33759848;222111;0
11888;ENSG00000163541;SUCLG1;2;84650647;84687169;36522;0
11889;ENSG00000163558;PRKCI;3;169940153;170023769;83616;0
11890;ENSG00000163576;EFHB;3;19920964;19988517;67553;0
11891;ENSG00000163577;EIF5A2;3;170606204;170626482;20278;0
11892;ENSG00000163584;RPL22L1;3;170582664;170588272;5608;0
11893;ENSG00000163590;PPM1L;3;160473390;160796695;323305;0
11894;ENSG00000163596;ICA1L;2;203640690;203736708;96018;0
11895;ENSG00000163602;RYBP;3;72420976;72496069;75093;0
11896;ENSG00000163605;PPP4R2;3;73045936;73118350;72414;0
11897;ENSG00000163606;CD200R1;3;112640056;112693969;53913;0
11898;ENSG00000163607;GTPBP8;3;112709765;112733907;24142;0
11899;ENSG00000163608;C3orf17;3;112721287;112738708;17421;0
11900;ENSG00000163611;SPICE1;3;113161565;113234034;72469;0
11901;ENSG00000163617;KIAA1407;3;113682984;113775460;92476;0
11902;ENSG00000163618;CADPS;3;62384022;62861054;477032;1
11903;ENSG00000163624;CDS1;4;85504132;85572491;68359;0
11904;ENSG00000163625;WDFY3;4;85590704;85887544;296840;0
11905;ENSG00000163626;COX18;4;73921797;73935472;13675;0
11906;ENSG00000163629;PTPN13;4;87515468;87736324;220856;0
11907;ENSG00000163630;SYNPR;3;63213991;63602597;388606;1
11908;ENSG00000163631;ALB;4;74262831;74287129;24298;1
11909;ENSG00000163633;C4orf36;4;87797358;87857354;59996;0
11910;ENSG00000163634;THOC7;3;63819546;63849579;30033;0
11911;ENSG00000163635;ATXN7;3;63850233;63989138;138905;0
11912;ENSG00000163636;PSMD6;3;63996225;64009658;13433;0
11913;ENSG00000163637;PRICKLE2;3;64079543;64431152;351609;0
11914;ENSG00000163638;ADAMTS9;3;64501333;64673676;172343;0
11915;ENSG00000163644;PPM1K;4;89178772;89205921;27149;0
11916;ENSG00000163655;GMPS;3;155588325;155661815;73490;0
11917;ENSG00000163659;TIPARP;3;156391024;156424559;33535;0
11918;ENSG00000163660;CCNL1;3;156864297;156878549;14252;0
11919;ENSG00000163661;PTX3;3;157154578;157161417;6839;0
11920;ENSG00000163666;HESX1;3;57231944;57260549;28605;0
11921;ENSG00000163673;DCLK3;3;36753913;36781352;27439;0
11922;ENSG00000163681;SLMAP;3;57741177;57914895;173718;0
11923;ENSG00000163682;RPL9;4;39455744;39460568;4824;0
11924;ENSG00000163683;SMIM14;4;39547950;39640710;92760;0
11925;ENSG00000163684;RPP14;3;58291974;58310422;18448;0
11926;ENSG00000163686;ABHD6;3;58223233;58281420;58187;0
11927;ENSG00000163689;C3orf67;3;58703092;59035810;332718;1
11928;ENSG00000163694;RBM47;4;40425272;40632892;207620;0
11929;ENSG00000163697;APBB2;4;40812044;41218731;406687;0
11930;ENSG00000163701;IL17RE;3;9944296;9958086;13790;0
11931;ENSG00000163702;IL17RC;3;9958758;9975314;16556;0
11932;ENSG00000163703;CRELD1;3;9975506;9987097;11591;0
11933;ENSG00000163704;PRRT3;3;9987226;9994078;6852;0
11934;ENSG00000163710;PCOLCE2;3;142534764;142608045;73281;0
11935;ENSG00000163714;U2SURP;3;142683339;142779567;96228;0
11936;ENSG00000163719;MTMR14;3;9691117;9744077;52960;0
11937;ENSG00000163728;TTC14;3;180319918;180335616;15698;0
11938;ENSG00000163738;MTHFD2L;4;74979891;75168816;188925;0
11939;ENSG00000163743;RCHY1;4;76404247;76439974;35727;0
11940;ENSG00000163754;GYG1;3;148709128;148745419;36291;0
11941;ENSG00000163755;HPS3;3;148847371;148891519;44148;0
11942;ENSG00000163781;TOPBP1;3;133317019;133380737;63718;0
11943;ENSG00000163785;RYK;3;133784147;133969689;185542;0
11944;ENSG00000163788;SNRK;3;43328004;43466256;138252;0
11945;ENSG00000163794;UCN;2;27530268;27531313;1045;0
11946;ENSG00000163795;ZNF513;2;27600098;27603657;3559;0
11947;ENSG00000163798;SLC4A1AP;2;27886338;27917840;31502;0
11948;ENSG00000163803;PLB1;2;28680012;28866654;186642;0
11949;ENSG00000163806;SPDYA;2;29005383;29073477;68094;0
11950;ENSG00000163807;KIAA1143;3;44779153;44803154;24001;0
11951;ENSG00000163808;KIF15;3;44803209;44914868;111659;0
11952;ENSG00000163811;WDR43;2;29117509;29171088;53579;0
11953;ENSG00000163812;ZDHHC3;3;44956749;45017677;60928;0
11954;ENSG00000163818;LZTFL1;3;45864808;45957534;92726;0
11955;ENSG00000163820;FYCO1;3;45959396;46037316;77920;1
11956;ENSG00000163832;ELP6;3;47537130;47555251;18121;0
11957;ENSG00000163840;DTX3L;3;122283085;122294050;10965;0
11958;ENSG00000163848;ZNF148;3;124944405;125094198;149793;0
11959;ENSG00000163864;NMNAT3;3;139279022;139396859;117837;0
11960;ENSG00000163870;TPRA1;3;127291912;127317094;25182;0
11961;ENSG00000163872;YEATS2;3;183415606;183530413;114807;0
11962;ENSG00000163882;POLR2H;3;184079506;184086384;6878;0
11963;ENSG00000163884;KLF15;3;126061478;126076285;14807;0
11964;ENSG00000163885;CCDC37;3;126113782;126155399;41617;0
11965;ENSG00000163888;CAMK2N2;3;183977001;183979251;2250;0
11966;ENSG00000163898;LIPH;3;185224050;185270401;46351;0
11967;ENSG00000163900;TMEM41A;3;185194284;185216845;22561;0
11968;ENSG00000163902;RPN1;3;128338817;128399918;61101;0
11969;ENSG00000163904;SENP2;3;185300284;185351339;51055;0
11970;ENSG00000163913;IFT122;3;129158968;129239198;80230;0
11971;ENSG00000163918;RFC4;3;186507669;186524847;17178;0
11972;ENSG00000163923;RPL39L;3;186838736;186898696;59960;0
11973;ENSG00000163930;BAP1;3;52435029;52444366;9337;0
11974;ENSG00000163931;TKT;3;53258723;53290068;31345;0
11975;ENSG00000163932;PRKCD;3;53190025;53226733;36708;0
11976;ENSG00000163933;RFT1;3;53122499;53164478;41979;0
11977;ENSG00000163935;SFMBT1;3;52937588;53080766;143178;0
11978;ENSG00000163938;GNL3;3;52715172;52728508;13336;0
11979;ENSG00000163939;PBRM1;3;52579368;52719933;140565;0
11980;ENSG00000163945;UVSSA;4;1341054;1381837;40783;0
11981;ENSG00000163946;FAM208A;3;56654161;56717265;63104;0
11982;ENSG00000163947;ARHGEF3;3;56761446;57113357;351911;0
11983;ENSG00000163950;SLBP;4;1694527;1714282;19755;0
11984;ENSG00000163956;LRPAP1;4;3508103;3534286;26183;0
11985;ENSG00000163958;ZDHHC19;3;195924320;195938308;13988;0
11986;ENSG00000163960;UBXN7;3;196074533;196159345;84812;0
11987;ENSG00000163961;RNF168;3;196195654;196230639;34985;0
11988;ENSG00000163964;PIGX;3;196366646;196462878;96232;0
11989;ENSG00000163975;MFI2;3;196715492;196756687;41195;0
11990;ENSG00000163993;S100P;4;6694796;6698897;4101;0
11991;ENSG00000163995;ABLIM2;4;7967039;8160559;193520;0
11992;ENSG00000164022;AIMP1;4;107236701;107270383;33682;0
11993;ENSG00000164023;SGMS2;4;108745719;108836203;90484;1
11994;ENSG00000164024;METAP1;4;99916771;99983964;67193;0
11995;ENSG00000164031;DNAJB14;4;100817405;100867883;50478;0
11996;ENSG00000164032;H2AFZ;4;100869243;100871545;2302;0
11997;ENSG00000164037;SLC9B1;4;103806205;103940896;134691;1
11998;ENSG00000164038;SLC9B2;4;103941025;104006986;65961;0
11999;ENSG00000164039;BDH2;4;104000592;104021040;20448;0
12000;ENSG00000164040;PGRMC2;4;129190397;129209984;19587;0
12001;ENSG00000164045;CDC25A;3;48198636;48229892;31256;0
12002;ENSG00000164048;ZNF589;3;48282590;48340743;58153;0
12003;ENSG00000164049;FBXW12;3;48413709;48442666;28957;0
12004;ENSG00000164050;PLXNB1;3;48445261;48471594;26333;0
12005;ENSG00000164051;CCDC51;3;48473574;48481866;8292;0
12006;ENSG00000164053;ATRIP;3;48488114;48507115;19001;0
12007;ENSG00000164054;SHISA5;3;48509197;48542259;33062;0
12008;ENSG00000164056;SPRY1;4;124317950;124324910;6960;0
12009;ENSG00000164061;BSN;3;49591922;49708978;117056;0
12010;ENSG00000164062;APEH;3;49711435;49721396;9961;0
12011;ENSG00000164066;INTU;4;128544426;128647892;103466;0
12012;ENSG00000164068;RNF123;3;49726932;49758962;32030;0
12013;ENSG00000164070;HSPA4L;4;128702976;128761888;58912;0
12014;ENSG00000164073;MFSD8;4;128838960;128887150;48190;0
12015;ENSG00000164074;C4orf29;4;128886461;128960866;74405;0
12016;ENSG00000164076;CAMKV;3;49895421;49907655;12234;1
12017;ENSG00000164077;MON1A;3;49946302;49967606;21304;0
12018;ENSG00000164078;MST1R;3;49924435;49941299;16864;0
12019;ENSG00000164080;RAD54L2;3;51575160;51702683;127523;0
12020;ENSG00000164081;TEX264;3;51696709;51738339;41630;0
12021;ENSG00000164082;GRM2;3;51741086;51752629;11543;0
12022;ENSG00000164086;DUSP7;3;52082935;52090566;7631;0
12023;ENSG00000164087;POC1A;3;52109269;52188706;79437;0
12024;ENSG00000164088;PPM1M;3;52279841;52284613;4772;0
12025;ENSG00000164089;ETNPPL;4;109663196;109684210;21014;0
12026;ENSG00000164091;WDR82;3;52288437;52322036;33599;0
12027;ENSG00000164096;C4orf3;4;120218207;120225600;7393;0
12028;ENSG00000164099;PRSS12;4;119201193;119274158;72965;0
12029;ENSG00000164100;NDST3;4;118954773;119179803;225030;0
12030;ENSG00000164104;HMGB2;4;174252846;174256276;3430;0
12031;ENSG00000164105;SAP30;4;174291120;174298683;7563;0
12032;ENSG00000164106;SCRG1;4;174305852;174327531;21679;0
12033;ENSG00000164109;MAD2L1;4;120976763;120988229;11466;0
12034;ENSG00000164111;ANXA5;4;122589110;122618268;29158;0
12035;ENSG00000164112;TMEM155;4;122680088;122686582;6494;0
12036;ENSG00000164114;MAP9;4;156263810;156298122;34312;0
12037;ENSG00000164116;GUCY1A3;4;156587863;156653501;65638;0
12038;ENSG00000164117;FBXO8;4;175157809;175205415;47606;0
12039;ENSG00000164118;CEP44;4;175204828;175254531;49703;0
12040;ENSG00000164120;HPGD;4;175411328;175444305;32977;0
12041;ENSG00000164122;ASB5;4;177134824;177198722;63898;0
12042;ENSG00000164123;C4orf45;4;159814286;159959912;145626;0
12043;ENSG00000164124;TMEM144;4;159122756;159176563;53807;0
12044;ENSG00000164125;FAM198B;4;159045626;159094470;48844;0
12045;ENSG00000164128;NPY1R;4;164245113;164265984;20871;0
12046;ENSG00000164129;NPY5R;4;164265091;164273086;7995;0
12047;ENSG00000164134;NAA15;4;140222609;140341187;118578;0
12048;ENSG00000164136;IL15;4;142557752;142655140;97388;0
12049;ENSG00000164144;ARFIP1;4;153701089;153839615;138526;0
12050;ENSG00000164151;KIAA0947;5;5420777;5490347;69570;0
12051;ENSG00000164161;HHIP;4;145567173;145666423;99250;1
12052;ENSG00000164162;ANAPC10;4;145888264;146019693;131429;0
12053;ENSG00000164163;ABCE1;4;146019084;146050331;31247;0
12054;ENSG00000164164;OTUD4;4;146031990;146101313;69323;0
12055;ENSG00000164167;LSM6;4;147096837;147121152;24315;0
12056;ENSG00000164168;TMEM184C;4;148538534;148593195;54661;0
12057;ENSG00000164169;PRMT10;4;148558936;148605381;46445;0
12058;ENSG00000164171;ITGA2;5;52285156;52390609;105453;0
12059;ENSG00000164172;MOCS2;5;52391509;52405893;14384;0
12060;ENSG00000164175;SLC45A2;5;33944721;33984835;40114;0
12061;ENSG00000164181;ELOVL7;5;60047618;60140216;92598;0
12062;ENSG00000164182;NDUFAF2;5;60240956;60448853;207897;0
12063;ENSG00000164187;LMBRD2;5;36098514;36152063;53549;0
12064;ENSG00000164188;RANBP3L;5;36248536;36302216;53680;0
12065;ENSG00000164190;NIPBL;5;36876861;37066515;189654;0
12066;ENSG00000164197;RNF180;5;63461671;63668696;207025;0
12067;ENSG00000164237;CMBL;5;10275987;10308138;32151;0
12068;ENSG00000164258;NDUFS4;5;52856463;52979168;122705;0
12069;ENSG00000164294;GPX8;5;54455946;54462899;6953;1
12070;ENSG00000164305;CASP3;4;185548850;185570663;21813;0
12071;ENSG00000164306;PRIMPOL;4;185570767;185616117;45350;0
12072;ENSG00000164318;EGFLAM;5;38258511;38465123;206612;1
12073;ENSG00000164323;KIAA1430;4;186080819;186130658;49839;0
12074;ENSG00000164327;RICTOR;5;38938021;39074510;136489;0
12075;ENSG00000164331;ANKRA2;5;72848160;72861511;13351;0
12076;ENSG00000164338;UTP15;5;72861268;72877794;16526;0
12077;ENSG00000164342;TLR3;4;186990306;187009223;18917;0
12078;ENSG00000164344;KLKB1;4;187130133;187179625;49492;0
12079;ENSG00000164346;NSA2;5;74062817;74072737;9920;0
12080;ENSG00000164347;GFM2;5;74017029;74063196;46167;0
12081;ENSG00000164366;CCDC127;5;196986;218330;21344;0
12082;ENSG00000164509;IL31RA;5;55147207;55218678;71471;0
12083;ENSG00000164512;ANKRD55;5;55395507;55529186;133679;0
12084;ENSG00000164588;HCN1;5;45259349;45696253;436904;0
12085;ENSG00000166265;CYYR1;21;27838528;27945603;107075;0
12086;ENSG00000166619;BLCAP;20;36120874;36156333;35459;0
12087;ENSG00000166704;ZNF606;19;58488421;58514717;26296;0
12088;ENSG00000166770;ZNF667-AS1;19;56988619;57012035;23416;0
12089;ENSG00000166862;CACNG2;22;36959968;37099603;139635;0
12090;ENSG00000166897;ELFN2;22;37764000;37823505;59505;0
12091;ENSG00000166913;YWHAB;20;43514317;43537173;22856;0
12092;ENSG00000166979;EVA1C;21;33784314;33887707;103393;0
12093;ENSG00000167037;SGSM1;22;25202236;25323545;121309;0
12094;ENSG00000167065;DUSP18;22;31048038;31063877;15839;0
12095;ENSG00000167074;TEF;22;41763337;41795330;31993;0
12096;ENSG00000167614;TTYH1;19;54926393;54948080;21687;0
12097;ENSG00000167615;LENG8;19;54960065;54973217;13152;0
12098;ENSG00000167646;DNAAF3;19;55670031;55678090;8059;0
12099;ENSG00000167685;ZNF444;19;56643968;56672262;28294;0
12100;ENSG00000168016;TRANK1;3;36868311;36986548;118237;0
12101;ENSG00000168026;TTC21A;3;39149152;39180394;31242;0
12102;ENSG00000168028;RPSA;3;39448180;39454033;5853;0
12103;ENSG00000168032;ENTPD3;3;40428647;40470110;41463;0
12104;ENSG00000168036;CTNNB1;3;41236328;41301587;65259;0
12105;ENSG00000168038;ULK4;3;41288090;42003922;715832;0
12106;ENSG00000168135;KCNJ4;22;38822332;38851205;28873;0
12107;ENSG00000168137;SETD5;3;9439299;9520924;81625;1
12108;ENSG00000168152;THAP9;4;83821837;83841122;19285;0
12109;ENSG00000168214;RBPJ;4;26165077;26436541;271464;0
12110;ENSG00000168228;ZCCHC4;4;25314407;25372005;57598;0
12111;ENSG00000168237;GLYCTK;3;52321105;52329272;8167;0
12112;ENSG00000168268;NT5DC2;3;52558386;52569070;10684;0
12113;ENSG00000168273;SMIM4;3;52568029;52613253;45224;0
12114;ENSG00000168280;KIF5C;2;149632819;149883273;250454;0
12115;ENSG00000168288;MMADHC;2;150426148;150444330;18182;0
12116;ENSG00000168291;PDHB;3;58413357;58419584;6227;0
12117;ENSG00000168297;PXK;3;58318607;58411748;93141;0
12118;ENSG00000168301;KCTD6;3;58477841;58488087;10246;0
12119;ENSG00000168309;FAM107A;3;58549844;58613337;63493;1
12120;ENSG00000168310;IRF2;4;185308867;185395734;86867;0
12121;ENSG00000168356;SCN11A;3;38887260;38992052;104792;0
12122;ENSG00000168374;ARF4;3;57557090;57583947;26857;0
12123;ENSG00000168385;02-Sep;2;242254515;242293442;38927;0
12124;ENSG00000168386;FILIP1L;3;99548985;99833357;284372;1
12125;ENSG00000168393;DTYMK;2;242615157;242626406;11249;0
12126;ENSG00000168395;ING5;2;242641450;242668893;27443;0
12127;ENSG00000168397;ATG4B;2;242576628;242613272;36644;0
12128;ENSG00000168491;CCDC110;4;186366336;186392913;26577;0
12129;ENSG00000168505;GBX2;2;237073879;237077012;3133;0
12130;ENSG00000168538;TRAPPC11;4;184580420;184634745;54325;0
12131;ENSG00000168542;COL3A1;2;189839046;189877472;38426;1
12132;ENSG00000168556;ING2;4;184426147;184432249;6102;0
12133;ENSG00000168564;CDKN2AIP;4;184365744;184369351;3607;0
12134;ENSG00000168594;ADAM29;4;175750819;175899331;148512;0
12135;ENSG00000168612;ZSWIM1;20;44509866;44513905;4039;0
12136;ENSG00000168621;GDNF;5;37812779;37839788;27009;0
12137;ENSG00000168658;VWA3B;2;98703579;98929762;226183;0
12138;ENSG00000168702;LRP1B;2;140988992;142889270;1900278;0
12139;ENSG00000168724;DNAJC21;5;34929698;34959069;29371;0
12140;ENSG00000168734;PKIG;20;43160426;43252888;92462;0
12141;ENSG00000168743;NPNT;4;106815932;106925184;109252;0
12142;ENSG00000168758;SEMA4C;2;97525453;97536494;11041;0
12143;ENSG00000168763;CNNM3;2;97481982;97499648;17666;0
12144;ENSG00000168769;TET2;4;106067032;106200973;133941;0
12145;ENSG00000168772;CXXC4;4;105389469;105416058;26589;0
12146;ENSG00000168779;SHOX2;3;157814948;157824292;9344;0
12147;ENSG00000168785;TSPAN5;4;99391518;99579780;188262;0
12148;ENSG00000168811;IL12A;3;159706537;159713806;7269;0
12149;ENSG00000168818;STX18;4;4417469;4544073;126604;0
12150;ENSG00000168824;;4;4349867;4420785;70918;0
12151;ENSG00000168826;ZBTB49;4;4291924;4323513;31589;0
12152;ENSG00000168827;GFM1;3;158362067;158410364;48297;0
12153;ENSG00000168843;FSTL5;4;162305049;163085187;780138;0
12154;ENSG00000168874;ATOH8;2;85978467;86015189;36722;0
12155;ENSG00000168883;USP39;2;85829979;85876403;46424;0
12156;ENSG00000168884;TNIP2;4;2743375;2758103;14728;0
12157;ENSG00000168887;C2orf68;2;85833777;85839189;5412;0
12158;ENSG00000168890;TMEM150A;2;85825671;85830319;4648;0
12159;ENSG00000168894;RNF181;2;85822848;85824736;1888;0
12160;ENSG00000168899;VAMP5;2;85811531;85820535;9004;0
12161;ENSG00000168906;MAT2A;2;85766288;85772403;6115;0
12162;ENSG00000168917;SLC35G2;3;136537489;136574734;37245;0
12163;ENSG00000168918;INPP5D;2;233924677;234116549;191872;0
12164;ENSG00000168924;LETM1;4;1813206;1857974;44768;0
12165;ENSG00000168936;TMEM129;4;1717679;1723085;5406;0
12166;ENSG00000168958;MFF;2;228189867;228222550;32683;0
12167;ENSG00000168993;CPLX1;4;778745;819986;41241;0
12168;ENSG00000169016;E2F6;2;11584501;11606297;21796;0
12169;ENSG00000169019;COMMD8;4;47452885;47465736;12851;0
12170;ENSG00000169020;ATP5I;4;666225;668127;1902;0
12171;ENSG00000169031;COL4A3;2;228029281;228179508;150227;0
12172;ENSG00000169047;IRS1;2;227596033;227664475;68442;0
12173;ENSG00000169064;ZBBX;3;166958075;167099134;141059;0
12174;ENSG00000169087;HSPBAP1;3;122458846;122512671;53825;0
12175;ENSG00000169116;PARM1;4;75858305;75975325;117020;0
12176;ENSG00000169184;MN1;22;28144265;28197486;53221;0
12177;ENSG00000169251;NMD3;3;160822484;160971320;148836;0
12178;ENSG00000169255;B3GALNT1;3;160801671;160823172;21501;0
12179;ENSG00000169282;KCNAB1;3;155755490;156256545;501055;1
12180;ENSG00000169288;MRPL1;4;78783674;78873944;90270;0
12181;ENSG00000169299;PGM2;4;37828255;37864558;36303;1
12182;ENSG00000169359;SLC33A1;3;155538813;155572218;33405;0
12183;ENSG00000169379;ARL13B;3;93698983;93774512;75529;0
12184;ENSG00000169432;SCN9A;2;167051695;167232503;180808;0
12185;ENSG00000169554;ZEB2;2;145141648;145282147;140499;0
12186;ENSG00000169564;PCBP1;2;70314585;70316332;1747;0
12187;ENSG00000169599;NFU1;2;69622882;69664760;41878;0
12188;ENSG00000169604;ANTXR1;2;69240310;69476459;236149;0
12189;ENSG00000169607;CKAP2L;2;113493930;113522254;28324;0
12190;ENSG00000169618;PROKR1;2;68870721;68882708;11987;1
12191;ENSG00000169621;APLF;2;68694693;68858004;163311;0
12192;ENSG00000169629;RGPD8;2;113127669;113192065;64396;0
12193;ENSG00000169635;HIC2;22;21771693;21805752;34059;0
12194;ENSG00000169679;BUB1;2;111395275;111435691;40416;1
12195;ENSG00000169714;CNBP;3;128888327;128902765;14438;0
12196;ENSG00000169744;LDB2;4;16503164;16900432;397268;0
12197;ENSG00000169756;LIMS1;2;109150857;109303702;152845;0
12198;ENSG00000169760;NLGN1;3;173114074;174004434;890360;0
12199;ENSG00000169762;TAPT1;4;16162128;16229033;66905;0
12200;ENSG00000169764;UGP2;2;64068074;64118696;50622;0
12201;ENSG00000169814;BTD;3;15642848;15687329;44481;0
12202;ENSG00000169836;TACR3;4;104507188;104640973;133785;0
12203;ENSG00000169851;PCDH7;4;30722037;31148422;426385;0
12204;ENSG00000169855;ROBO1;3;78646390;79816965;1170575;0
12205;ENSG00000169860;P2RY1;3;152552736;152555841;3105;0
12206;ENSG00000169862;CTNND2;5;10971952;11904155;932203;0
12207;ENSG00000169964;TMEM42;3;44903361;44907162;3801;0
12208;ENSG00000169967;MAP3K2;2;128056306;128146041;89735;0
12209;ENSG00000169981;ZNF35;3;44690219;44702283;12064;0
12210;ENSG00000169989;TIGD4;4;153690506;153700916;10410;0
12211;ENSG00000170006;TMEM154;4;153539784;153601317;61533;0
12212;ENSG00000170011;MYRIP;3;39850405;40301812;451407;0
12213;ENSG00000170017;ALCAM;3;105085753;105295744;209991;0
12214;ENSG00000170035;UBE2E3;2;181831975;181941312;109337;0
12215;ENSG00000170044;ZPLD1;3;101818088;102198685;380597;1
12216;ENSG00000170088;TMEM192;4;165995574;166129701;134127;0
12217;ENSG00000170142;UBE2E1;3;23847394;23932807;85413;0
12218;ENSG00000170144;HNRNPA3;2;178077291;178088686;11395;0
12219;ENSG00000170153;RNF150;4;141780961;142134031;353070;0
12220;ENSG00000170185;USP38;4;144106070;144144983;38913;0
12221;ENSG00000170191;NANP;20;25593571;25604811;11240;0
12222;ENSG00000170248;PDCD6IP;3;33839844;33911194;71350;0
12223;ENSG00000170264;FAM161A;2;62051989;62081278;29289;0
12224;ENSG00000170266;GLB1;3;33038100;33138722;100622;0
12225;ENSG00000170275;CRTAP;3;33155471;33189265;33794;0
12226;ENSG00000170340;B3GNT2;2;62423248;62451866;28618;0
12227;ENSG00000170364;SETMAR;3;4344988;4359251;14263;0
12228;ENSG00000170365;SMAD1;4;146402346;146479231;76885;0
12229;ENSG00000170390;DCLK2;4;150999426;151178609;179183;0
12230;ENSG00000170396;ZNF804A;2;185463093;185804219;341126;0
12231;ENSG00000170417;TMEM182;2;103353367;103460352;106985;0
12232;ENSG00000170448;NFXL1;4;47849257;47916653;67396;0
12233;ENSG00000170471;RALGAPB;20;37101459;37207504;106045;0
12234;ENSG00000170485;NPAS2;2;101436614;101613291;176677;1
12235;ENSG00000170500;LONRF2;2;100889753;100939195;49442;0
12236;ENSG00000170502;NUDT9;4;88343734;88380606;36872;0
12237;ENSG00000170522;ELOVL6;4;110967002;111120355;153353;0
12238;ENSG00000170549;IRX1;5;3596168;3601517;5349;0
12239;ENSG00000170561;IRX2;5;2745959;2752969;7010;0
12240;ENSG00000170571;EMB;5;49692026;49739082;47056;0
12241;ENSG00000170577;SIX2;2;45232300;45236569;4269;0
12242;ENSG00000170634;ACYP2;2;54197975;54532437;334462;0
12243;ENSG00000170638;TRABD;22;50624344;50638027;13683;0
12244;ENSG00000170745;KCNS3;2;18059114;18542882;483768;0
12245;ENSG00000170802;FOXN2;2;48541776;48606433;64657;0
12246;ENSG00000170837;GPR27;3;71803201;71805647;2446;0
12247;ENSG00000170846;;4;6675178;6677774;2596;0
12248;ENSG00000170854;MINA;3;97660662;97691301;30639;0
12249;ENSG00000170860;LSM3;3;14219858;14242619;22761;0
12250;ENSG00000170866;LILRA3;19;54799854;54809952;10098;0
12251;ENSG00000170871;KIAA0232;4;6783102;6885897;102795;0
12252;ENSG00000170876;TMEM43;3;14166440;14185179;18739;0
12253;ENSG00000170889;RPS9;19;54704610;54752862;48252;0
12254;ENSG00000170892;TSEN34;19;54693789;54697585;3796;0
12255;ENSG00000170893;TRH;3;129693148;129696781;3633;0
12256;ENSG00000170906;NDUFA3;19;54606036;54612564;6528;0
12257;ENSG00000170917;NUDT6;4;123809852;123844123;34271;0
12258;ENSG00000171055;FEZ2;2;36778570;36873230;94660;0
12259;ENSG00000171084;FAM86JP;3;125635463;125648867;13404;0
12260;ENSG00000171094;ALK;2;29415640;30144432;728792;0
12261;ENSG00000171103;TRMT61B;2;29072687;29093167;20480;0
12262;ENSG00000171109;MFN1;3;179065480;179112719;47239;0
12263;ENSG00000171121;KCNMB3;3;178957530;178984790;27260;0
12264;ENSG00000171126;KCNG3;2;42669157;42721237;52080;0
12265;ENSG00000171132;PRKCE;2;45878484;46415129;536645;0
12266;ENSG00000171135;JAGN1;3;9932238;9936033;3795;0
12267;ENSG00000171148;TADA3;3;9821544;9834695;13151;0
12268;ENSG00000171150;SOCS5;2;46926091;46990268;64177;0
12269;ENSG00000171174;RBKS;2;28004231;28113965;109734;0
12270;ENSG00000171189;GRIK1;21;30909254;31312351;403097;1
12271;ENSG00000171222;SCAND1;20;34541539;34547394;5855;0
12272;ENSG00000171303;KCNK3;2;26915619;26956288;40669;0
12273;ENSG00000171368;TPPP;5;660883;693510;32627;0
12274;ENSG00000171421;MRPL36;5;1798500;1801480;2980;0
12275;ENSG00000171425;ZNF581;19;56146825;56156988;10163;0
12276;ENSG00000171443;ZNF524;19;56111388;56114504;3116;0
12277;ENSG00000171450;CDK5R2;2;219824377;219826876;2499;0
12278;ENSG00000171456;ASXL1;20;30946155;31027122;80967;0
12279;ENSG00000171476;HOPX;4;57514155;57548065;33910;0
12280;ENSG00000171497;PPID;4;159630286;159644548;14262;0
12281;ENSG00000171503;ETFDH;4;159593277;159630775;37498;0
12282;ENSG00000171522;PTGER4;5;40679600;40693837;14237;0
12283;ENSG00000171551;ECEL1;2;233344537;233352538;8001;1
12284;ENSG00000171552;BCL2L1;20;30252255;30311792;59537;0
12285;ENSG00000171566;PLRG1;4;155456158;155471587;15429;0
12286;ENSG00000171574;ZNF584;19;58912871;58929694;16823;0
12287;ENSG00000171587;DSCAM;21;41382926;42219065;836139;0
12288;ENSG00000171596;NMUR1;2;232387871;232395206;7335;0
12289;ENSG00000171606;ZNF274;19;58694396;58724928;30532;0
12290;ENSG00000171617;ENC1;5;73923234;73937249;14015;0
12291;ENSG00000171649;ZIK1;19;58089824;58105145;15321;0
12292;ENSG00000171700;RGS19;20;62704534;62711323;6789;0
12293;ENSG00000171703;TCEA2;20;62681189;62703700;22511;0
12294;ENSG00000171757;LRRC34;3;169511216;169530774;19558;0
12295;ENSG00000171848;RRM2;2;10262455;10271545;9090;1
12296;ENSG00000171853;TRAPPC12;2;3383446;3488865;105419;0
12297;ENSG00000171858;RPS21;20;60962172;60963576;1404;0
12298;ENSG00000171863;RPS7;2;3622795;3628509;5714;0
12299;ENSG00000171865;RNASEH1;2;3592383;3606206;13823;0
12300;ENSG00000171867;PRNP;20;4666882;4682236;15354;0
12301;ENSG00000171873;ADRA1D;20;4201329;4229721;28392;0
12302;ENSG00000171940;ZNF217;20;52183604;52226446;42842;0
12303;ENSG00000171951;SCG2;2;224461658;224467221;5563;0
12304;ENSG00000171984;C20orf196;20;5731039;5844558;113519;0
12305;ENSG00000172005;MAL;2;95691422;95719737;28315;0
12306;ENSG00000172007;RAB33B;4;140374386;140397763;23377;0
12307;ENSG00000172020;GAP43;3;115342171;115440337;98166;0
12308;ENSG00000172037;LAMB2;3;49158547;49170551;12004;0
12309;ENSG00000172046;USP19;3;49145479;49158371;12892;0
12310;ENSG00000172053;QARS;3;49133365;49142553;9188;0
12311;ENSG00000172059;KLF11;2;10182976;10194963;11987;0
12312;ENSG00000172062;SMN1;5;70220768;70249769;29001;0
12313;ENSG00000172071;EIF2AK3;2;88856259;88927094;70835;1
12314;ENSG00000172086;KRCC1;2;88326724;88355248;28524;0
12315;ENSG00000172113;NME6;3;48334754;48343175;8421;0
12316;ENSG00000172216;CEBPB;20;48807376;48809212;1836;0
12317;ENSG00000172239;PAIP1;5;43526369;43557860;31491;0
12318;ENSG00000172244;C5orf34;5;43486803;43515247;28444;0
12319;ENSG00000172262;ZNF131;5;43065278;43192123;126845;0
12320;ENSG00000172264;MACROD2;20;13976015;16033842;2057827;0
12321;ENSG00000172292;CERS6;2;169312372;169631644;319272;0
12322;ENSG00000172315;TP53RK;20;45313004;45318418;5414;0
12323;ENSG00000172318;B3GALT1;2;168675182;168730551;55369;0
12324;ENSG00000172340;SUCLG2;3;67410884;67705038;294154;0
12325;ENSG00000172346;CSDC2;22;41956767;41973745;16978;0
12326;ENSG00000172403;SYNPO2;4;119809996;119982402;172406;0
12327;ENSG00000172428;MYEOV2;2;241065980;241076224;10244;0
12328;ENSG00000172493;AFF1;4;87856154;88062206;206052;0
12329;ENSG00000172554;SNTG2;2;946554;1371385;424831;0
12330;ENSG00000172667;ZMAT3;3;178735011;178790067;55056;0
12331;ENSG00000172752;COL6A5;3;130064359;130203688;139329;0
12332;ENSG00000172765;TMCC1;3;129366635;129612419;245784;0
12333;ENSG00000172771;EFCAB12;3;129120164;129147494;27330;0
12334;ENSG00000172780;RAB43;3;128806412;128841644;35232;0
12335;ENSG00000172799;ZBTB8OSP2;2;232298634;232299137;503;0
12336;ENSG00000172845;SP3;2;174771187;174830430;59243;0
12337;ENSG00000172878;METAP1D;2;172864490;172947158;82668;0
12338;ENSG00000172888;ZNF621;3;40566369;40616176;49807;0
12339;ENSG00000172936;MYD88;3;38179969;38184513;4544;1
12340;ENSG00000172939;OXSR1;3;38206580;38296979;90399;0
12341;ENSG00000172954;LCLAT1;2;30670092;30867091;196999;0
12342;ENSG00000172965;MIR4435-1HG;2;111953927;112252677;298750;1
12343;ENSG00000172974;;2;65432137;65433396;1259;0
12344;ENSG00000172985;SH3RF3;2;109745804;110262207;516403;0
12345;ENSG00000172986;GXYLT2;3;72937224;73047289;110065;0
12346;ENSG00000172995;ARPP21;3;35680437;35835988;155551;0
12347;ENSG00000173011;TADA2B;4;7043626;7059679;16053;0
12348;ENSG00000173013;CCDC96;4;7042579;7044728;2149;0
12349;ENSG00000173083;HPSE;4;84213614;84256306;42692;0
12350;ENSG00000173085;COQ2;4;84182689;84206067;23378;0
12351;ENSG00000173163;COMMD1;2;62115859;62374382;258523;0
12352;ENSG00000173166;RAPH1;2;204259068;204400133;141065;0
12353;ENSG00000173175;ADCY5;3;123001143;123168605;167462;0
12354;ENSG00000173193;PARP14;3;122399465;122449687;50222;0
12355;ENSG00000173209;AHSA2;2;61404553;61418338;13785;0
12356;ENSG00000173226;IQCB1;3;121488610;121553926;65316;0
12357;ENSG00000173230;GOLGB1;3;121382046;121468602;86556;0
12358;ENSG00000173272;MZT2A;2;132222473;132250316;27843;0
12359;ENSG00000173276;ZBTB21;21;43406940;43430496;23556;0
12360;ENSG00000173320;STOX2;4;184774584;184944679;170095;0
12361;ENSG00000173349;SFT2D3;2;128458597;128461385;2788;0
12362;ENSG00000173376;NDNF;4;121956768;121994176;37408;0
12363;ENSG00000173402;DAG1;3;49506146;49573048;66902;0
12364;ENSG00000173404;INSM1;20;20348765;20351590;2825;0
12365;ENSG00000173418;NAA20;20;19997760;20014299;16539;0
12366;ENSG00000173473;SMARCC1;3;47626762;47823596;196834;0
12367;ENSG00000173480;ZNF417;19;58411664;58427978;16314;0
12368;ENSG00000173531;MST1;3;49721380;49726934;5554;0
12369;ENSG00000173542;MOB1B;4;71768043;71888166;120123;0
12370;ENSG00000173545;ZNF622;5;16451628;16465901;14273;0
12371;ENSG00000173559;NABP1;2;192542794;192561385;18591;0
12372;ENSG00000173567;GPR113;2;26531041;26569685;38644;0
12373;ENSG00000173581;CCDC106;19;56152428;56164527;12099;0
12374;ENSG00000173638;SLC19A1;21;46913486;46964325;50839;0
12375;ENSG00000173692;PSMD1;2;231921578;232037541;115963;0
12376;ENSG00000173705;SUSD5;3;33191537;33260707;69170;0
12377;ENSG00000173706;HEG1;3;124684554;124774802;90248;1
12378;ENSG00000173744;AGFG1;2;228336868;228425930;89062;0
12379;ENSG00000173889;PHC3;3;169804520;169899537;95017;0
12380;ENSG00000173890;GPR160;3;169755717;169803191;47474;0
12381;ENSG00000173905;GOLIM4;3;167726465;167813763;87298;1
12382;ENSG00000173950;XXYLT1;3;194789008;194991896;202888;0
12383;ENSG00000173960;UBXN2A;2;24150155;24227779;77624;0
12384;ENSG00000174007;CEP19;3;196433148;196439164;6016;0
12385;ENSG00000174013;FBXO45;3;196295482;196315930;20448;0
12386;ENSG00000174125;TLR1;4;38792298;38858438;66140;1
12387;ENSG00000174137;FAM53A;4;1619642;1686029;66387;0
12388;ENSG00000174145;KIAA1239;4;37245842;37451087;205245;0
12389;ENSG00000174173;TRMT10C;3;101280706;101285290;4584;0
12390;ENSG00000174227;PIGG;4;492989;533985;40996;0
12391;ENSG00000174306;ZHX3;20;39807088;39946312;139224;0
12392;ENSG00000174343;CHRNA9;4;40337346;40357234;19888;0
12393;ENSG00000174365;SNHG11;20;37075221;37079564;4343;0
12394;ENSG00000174453;VWC2L;2;215275789;215443683;167894;1
12395;ENSG00000174473;GALNTL6;4;172733405;173962710;1229305;0
12396;ENSG00000174501;ANKRD36C;2;96514587;96657541;142954;0
12397;ENSG00000174564;IL20RB;3;136665072;136729927;64855;1
12398;ENSG00000174579;MSL2;3;135867764;135916083;48319;0
12399;ENSG00000174586;ZNF497;19;58865723;58874214;8491;0
12400;ENSG00000174599;TRAM1L1;4;118004718;118006736;2018;0
12401;ENSG00000174607;UGT8;4;115519611;115599380;79769;0
12402;ENSG00000174611;KY;3;134321980;134370478;48498;0
12403;ENSG00000174680;GRIK1-AS1;21;31120494;31136321;15827;1
12404;ENSG00000174720;LARP7;4;113558120;113578748;20628;0
12405;ENSG00000174738;NR1D2;3;23986751;24022109;35358;0
12406;ENSG00000174748;RPL15;3;23958036;23965183;7147;0
12407;ENSG00000174749;C4orf32;4;113066553;113116412;49859;0
12408;ENSG00000174776;WDR49;3;167196472;167371771;175299;0
12409;ENSG00000174780;SRP72;4;57333081;57369839;36758;0
12410;ENSG00000174796;THAP6;4;76439156;76475683;36527;0
12411;ENSG00000174799;CEP135;4;56815037;56899529;84492;0
12412;ENSG00000174839;DENND6A;3;57611184;57678816;67632;0
12413;ENSG00000174840;PDE12;3;57542003;57552571;10568;0
12414;ENSG00000174844;DNAH12;3;57327727;57530071;202344;0
12415;ENSG00000174891;RSRC1;3;157823644;158263519;439875;0
12416;ENSG00000174928;C3orf33;3;155480401;155524140;43739;0
12417;ENSG00000174948;GPR149;3;154055461;154147504;92043;0
12418;ENSG00000174953;DHX36;3;153990335;154042286;51951;0
12419;ENSG00000174963;ZIC4;3;147103833;147124647;20814;0
12420;ENSG00000175040;CHST2;3;142838173;142841800;3627;0
12421;ENSG00000175054;ATR;3;142168077;142297668;129591;0
12422;ENSG00000175063;UBE2C;20;44441215;44445596;4381;1
12423;ENSG00000175066;GK5;3;141882414;141944449;62035;0
12424;ENSG00000175077;RTP1;3;186915274;186919253;3979;1
12425;ENSG00000175093;SPSB4;3;140770244;140867453;97209;0
12426;ENSG00000175105;ZNF654;3;88188254;88193815;5561;0
12427;ENSG00000175110;MRPS22;3;138724648;139076065;351417;0
12428;ENSG00000175161;CADM2;3;85008132;86123579;1115447;0
12429;ENSG00000175166;PSMD2;3;184016497;184026842;10345;0
12430;ENSG00000175170;FAM182B;20;25744102;25848861;104759;0
12431;ENSG00000175182;FAM131A;3;184053714;184064063;10349;0
12432;ENSG00000175193;PARL;3;183547173;183602721;55548;0
12433;ENSG00000175455;CCDC14;3;123616152;123680564;64412;0
12434;ENSG00000175497;DPP10;2;115199876;116603328;1403452;0
12435;ENSG00000175697;GPR156;3;119883492;120003941;120449;0
12436;ENSG00000175701;LINC00116;2;110969106;111002997;33891;0
12437;ENSG00000175730;BAK1P1;20;31276723;31278816;2093;0
12438;ENSG00000175772;LINC01106;2;111132715;111142019;9304;0
12439;ENSG00000175792;RUVBL1;3;127783621;127872757;89136;0
12440;ENSG00000175874;CREG2;2;101962013;102004057;42044;0
12441;ENSG00000175928;LRRN1;3;3841121;3889387;48266;0
12442;ENSG00000176040;TMPRSS7;3;111753690;111800116;46426;0
12443;ENSG00000176054;RPL23P2;21;30369934;30370354;420;0
12444;ENSG00000176095;IP6K1;3;49761727;49823975;62248;0
12445;ENSG00000176142;TMEM39A;3;119148347;119187677;39330;0
12446;ENSG00000176204;LRRTM4;2;76974845;77820445;845600;0
12447;ENSG00000176293;ZNF135;19;58570607;58597677;27070;0
12448;ENSG00000176407;KCMF1;2;85198216;85286595;88379;0
12449;ENSG00000176542;KIAA2018;3;113367232;113415493;48261;0
12450;ENSG00000176593;;19;58513429;58522600;9171;0
12451;ENSG00000176597;B3GNT5;3;182971032;183016292;45260;0
12452;ENSG00000176601;MAP3K19;2;135722061;135805038;82977;0
12453;ENSG00000176714;CCDC121;2;27848506;27851879;3373;0
12454;ENSG00000176720;BOK;2;242498136;242513546;15410;0
12455;ENSG00000176732;PFN4;2;24338241;24346347;8106;0
12456;ENSG00000176771;NCKAP5;2;133429374;134326034;896660;0
12457;ENSG00000176788;BASP1;5;17065707;17276943;211236;0
12458;ENSG00000176887;SOX11;2;5832799;5841516;8717;0
12459;ENSG00000176928;GCNT4;5;74323289;74326724;3435;0
12460;ENSG00000176945;MUC20;3;195447753;195467994;20241;0
12461;ENSG00000176946;THAP4;2;242523820;242576864;53044;0
12462;ENSG00000177025;C19orf18;19;58469805;58485902;16097;0
12463;ENSG00000177058;SLC38A9;5;54921673;55069022;147349;0
12464;ENSG00000177096;FAM109B;22;42470255;42475445;5190;0
12465;ENSG00000177311;ZBTB38;3;141043055;141168634;125579;0
12466;ENSG00000177352;CCDC71;3;49199968;49203754;3786;0
12467;ENSG00000177383;MAGEF1;3;184428156;184429836;1680;0
12468;ENSG00000177410;ZFAS1;20;47894715;47905797;11082;0
12469;ENSG00000177432;NAP1L5;4;89617066;89619386;2320;0
12470;ENSG00000177453;NIM1K;5;43192173;43280952;88779;0
12471;ENSG00000177463;NR2C2;3;14989091;15095107;106016;0
12472;ENSG00000177479;ARIH2;3;48956254;49023815;67561;0
12473;ENSG00000177483;RBM44;2;238707032;238751451;44419;0
12474;ENSG00000177519;RPRM;2;154333852;154335322;1470;0
12475;ENSG00000177565;TBL1XR1;3;176737143;176915261;178118;0
12476;ENSG00000177646;ACAD9;3;128598439;128634910;36471;0
12477;ENSG00000177663;IL17RA;22;17565844;17596583;30739;0
12478;ENSG00000177692;DNAJC28;21;34860497;34864027;3530;0
12479;ENSG00000177694;NAALADL2;3;174156363;175523428;1367065;0
12480;ENSG00000177707;PVRL3;3;110788918;110994410;205492;0
12481;ENSG00000177721;ANXA2R;5;43039335;43043272;3937;0
12482;ENSG00000177732;SOX12;20;306207;310865;4658;0
12483;ENSG00000177738;;5;43014516;43067521;53005;0
12484;ENSG00000177752;YIPF7;4;44624086;44680573;56487;0
12485;ENSG00000177764;ZCCHC3;20;277737;280965;3228;0
12486;ENSG00000177822;;4;182795591;183066402;270811;0
12487;ENSG00000177842;ZNF620;3;40547483;40560227;12744;0
12488;ENSG00000177855;CACYBPP2;2;184472170;184472847;677;0
12489;ENSG00000177873;ZNF619;3;40518604;40531727;13123;0
12490;ENSG00000177917;ARL6IP6;2;153574407;153617767;43360;0
12491;ENSG00000177989;ODF3B;22;50968139;50971009;2870;0
12492;ENSG00000177994;C2orf73;2;54557171;54610879;53708;1
12493;ENSG00000178021;TSPYL6;2;54480315;54483409;3094;0
12494;ENSG00000178026;FAM211B;22;24981588;24989175;7587;0
12495;ENSG00000178035;IMPDH2;3;49061758;49066841;5083;0
12496;ENSG00000178038;ALS2CL;3;46710487;46735194;24707;0
12497;ENSG00000178053;MLF1;3;158288952;158325041;36089;0
12498;ENSG00000178057;NDUFAF3;3;49057892;49060928;3036;0
12499;ENSG00000178074;C2orf69;2;200775979;200820658;44679;0
12500;ENSG00000178075;GRAMD1C;3;113547029;113666021;118992;0
12501;ENSG00000178149;DALRD3;3;49052921;49059726;6805;0
12502;ENSG00000178162;FAR2P2;2;131174328;131188936;14608;0
12503;ENSG00000178163;ZNF518B;4;10441498;10459034;17536;0
12504;ENSG00000178171;AMER3;2;131513008;131525707;12699;1
12505;ENSG00000178177;LCORL;4;17842822;18023499;180677;0
12506;ENSG00000178201;VN1R1;19;57966542;57967854;1312;0
12507;ENSG00000178229;ZNF543;19;57831877;57842144;10267;0
12508;ENSG00000178252;WDR6;3;49044495;49053386;8891;0
12509;ENSG00000178295;GEN1;2;17935125;17966632;31507;0
12510;ENSG00000178385;PLEKHM3;2;208693027;208890284;197257;0
12511;ENSG00000178394;HTR1A;5;63256183;63258334;2151;0
12512;ENSG00000178403;NEUROG2;4;113434672;113437328;2656;0
12513;ENSG00000178458;H3F3AP6;4;140619298;140619708;410;0
12514;ENSG00000178467;P4HTM;3;49027319;49044587;17268;0
12515;ENSG00000178537;SLC25A20;3;48894369;48936426;42057;0
12516;ENSG00000178567;EPM2AIP1;3;37027357;37034795;7438;0
12517;ENSG00000178568;ERBB4;2;212240446;213403565;1163119;0
12518;ENSG00000178623;GPR35;2;241544848;241570676;25828;0
12519;ENSG00000178631;ACTG1P1;3;139212651;139213779;1128;0
12520;ENSG00000178662;CSRNP3;2;166326157;166545917;219760;0
12521;ENSG00000178694;NSUN3;3;93781760;93847389;65629;0
12522;ENSG00000178700;DHFRL1;3;93766680;93782233;15553;0
12523;ENSG00000178722;C5orf64;5;60933535;61047590;114055;0
12524;ENSG00000178752;FAM132B;2;239067623;239077541;9918;0
12525;ENSG00000178917;ZNF852;3;44540462;44552128;11666;0
12526;ENSG00000178935;ZNF552;19;58315209;58326281;11072;0
12527;ENSG00000178950;GAK;4;843064;926161;83097;0
12528;ENSG00000178988;MRFAP1L1;4;6709428;6711607;2179;0
12529;ENSG00000178996;SNX18;5;53813589;53842415;28826;0
12530;ENSG00000179010;MRFAP1;4;6641818;6644472;2654;0
12531;ENSG00000179021;C3orf38;3;88198893;88217879;18986;0
12532;ENSG00000179061;;2;25592818;25593185;367;0
12533;ENSG00000179152;TCAIM;3;44379611;44450943;71332;0
12534;ENSG00000179242;CDH4;20;59827482;60515673;688191;0
12535;ENSG00000179299;NSUN7;4;40751914;40812002;60088;1
12536;ENSG00000179387;ELMOD2;4;141445312;141474924;29612;0
12537;ENSG00000179564;LSMEM2;3;50316458;50325545;9087;0
12538;ENSG00000179750;APOBEC3B;22;39378352;39388809;10457;1
12539;ENSG00000179796;LRRC3B;3;26664297;26752267;87970;1
12540;ENSG00000179818;PCBP1-AS1;2;70189395;70315978;126583;0
12541;ENSG00000179833;SERTAD2;2;64858755;64978139;119384;0
12542;ENSG00000179837;RBM15B;3;51428731;51435330;6599;0
12543;ENSG00000179909;ZNF154;19;58208735;58220579;11844;0
12544;ENSG00000179915;NRXN1;2;50145643;51259674;1114031;0
12545;ENSG00000179922;ZNF784;19;56132108;56135967;3859;0
12546;ENSG00000179935;LINC00652;20;18768295;18774979;6684;0
12547;ENSG00000179943;FIZ1;19;56102746;56113336;10590;0
12548;ENSG00000179954;SSC5D;19;55999771;56030465;30694;0
12549;ENSG00000179967;PPP1R14BP3;4;140036084;140036528;444;0
12550;ENSG00000179978;;5;69390202;69424261;34059;0
12551;ENSG00000179979;CRIPAK;4;1385340;1389780;4440;0
12552;ENSG00000180044;C3orf80;3;159943423;159945999;2576;0
12553;ENSG00000180089;TMEM86B;19;55738007;55741647;3640;0
12554;ENSG00000180104;EXOC3;5;443273;472052;28779;0
12555;ENSG00000180178;FAR2P1;2;130748029;130808704;60675;0
12556;ENSG00000180228;PRKRA;2;179296141;179316239;20098;1
12557;ENSG00000180245;RRH;4;110749150;110765760;16610;0
12558;ENSG00000180346;TIGD2;4;90033968;90036050;2082;0
12559;ENSG00000180353;HCLS1;3;121350246;121379774;29528;0
12560;ENSG00000180370;PAK2;3;196466728;196559518;92790;0
12561;ENSG00000180376;CCDC66;3;56591189;56655846;64657;0
12562;ENSG00000180385;EMC3-AS1;3;10028577;10048674;20097;0
12563;ENSG00000180398;MCFD2;2;47129009;47168994;39985;0
12564;ENSG00000180509;KCNE1;21;35818988;35884573;65585;0
12565;ENSG00000180530;NRIP1;21;16333556;16437321;103765;0
12566;ENSG00000180611;MB21D2;3;192514604;192635950;121346;0
12567;ENSG00000180672;;2;206642540;206644433;1893;1
12568;ENSG00000180697;C3orf22;3;126245842;126277808;31966;0
12569;ENSG00000180712;;4;185261909;185275130;13221;0
12570;ENSG00000180769;WDFY3-AS2;4;85887538;85932430;44892;0
12571;ENSG00000180801;ARSJ;4;114821440;114900883;79443;0
12572;ENSG00000180834;MAP6D1;3;183533664;183543382;9718;0
12573;ENSG00000180902;D2HGDH;2;242673994;242708231;34237;0
12574;ENSG00000180914;OXTR;3;8792094;8811314;19220;0
12575;ENSG00000180957;PITPNB;22;28247657;28316122;68465;0
12576;ENSG00000181004;BBS12;4;123653857;123666098;12241;0
12577;ENSG00000181061;HIGD1A;3;42798669;42846023;47354;0
12578;ENSG00000181215;C4orf50;4;5958845;5991545;32700;0
12579;ENSG00000181322;NME9;3;137980279;138048728;68449;1
12580;ENSG00000181378;CCDC108;2;219867568;219906249;38681;0
12581;ENSG00000181381;DDX60L;4;169277886;169458937;181051;1
12582;ENSG00000181449;SOX2;3;181429714;181432221;2507;0
12583;ENSG00000181458;TMEM45A;3;100211463;100296288;84825;0
12584;ENSG00000181467;RAP2B;3;152880029;152886265;6236;0
12585;ENSG00000181541;MAB21L2;4;151503077;151505843;2766;0
12586;ENSG00000181555;SETD2;3;47057919;47205457;147538;0
12587;ENSG00000181585;TMIE;3;46742823;46752376;9553;0
12588;ENSG00000181722;ZBTB20;3;114056941;114866118;809177;0
12589;ENSG00000181744;C3orf58;3;143690640;143767561;76921;0
12590;ENSG00000181788;SIAH2;3;150458914;150481264;22350;0
12591;ENSG00000181789;COPG1;3;128968449;128996614;28165;0
12592;ENSG00000181798;LINC00471;2;232373137;232379050;5913;0
12593;ENSG00000181804;SLC9A9;3;142984064;143567373;583309;0
12594;ENSG00000181826;RELL1;4;37592422;37687998;95576;0
12595;ENSG00000181847;TIGIT;3;113995760;114029135;33375;0
12596;ENSG00000181894;ZNF329;19;58637619;58666477;28858;0
12597;ENSG00000181982;CCDC149;4;24807739;24981826;174087;0
12598;ENSG00000182093;WRB;21;40752170;40800454;48284;0
12599;ENSG00000182168;UNC5C;4;96083655;96470357;386702;1
12600;ENSG00000182179;UBA7;3;49842640;49851379;8739;0
12601;ENSG00000182240;BACE2;21;42539728;42654445;114717;1
12602;ENSG00000182247;UBE2E2;3;23244511;23633284;388773;0
12603;ENSG00000182263;FIGN;2;164449906;164592522;142616;0
12604;ENSG00000182308;DCAF4L1;4;41983713;41988476;4763;0
12605;ENSG00000182318;ZSCAN22;19;58838385;58853698;15313;0
12606;ENSG00000182329;;2;202937978;203062585;124607;0
12607;ENSG00000182362;YBEY;21;47706251;47717665;11414;0
12608;ENSG00000182389;CACNB4;2;152689290;152955593;266303;0
12609;ENSG00000182447;OTOL1;3;161214596;161221730;7134;0
12610;ENSG00000182463;TSHZ2;20;51588946;52111869;522923;0
12611;ENSG00000182504;CEP97;3;101442769;101489406;46637;0
12612;ENSG00000182541;LIMK2;22;31608225;31676066;67841;0
12613;ENSG00000182551;ADI1;2;3501132;3523507;22375;0
12614;ENSG00000182552;RWDD4;4;184560788;184580378;19590;0
12615;ENSG00000182568;SATB1;3;18386879;18487080;100201;0
12616;ENSG00000182580;EPHB3;3;184279572;184300197;20625;0
12617;ENSG00000182585;EPGN;4;75174190;75181024;6834;0
12618;ENSG00000182600;C2orf82;2;233721980;233743418;21438;0
12619;ENSG00000182606;TRAK1;3;42055294;42267381;212087;0
12620;ENSG00000182621;PLCB1;20;8112824;8949003;836179;0
12621;ENSG00000182670;TTC3;21;38445526;38575413;129887;0
12622;ENSG00000182836;PLCXD3;5;41307056;41510730;203674;0
12623;ENSG00000182841;RRP7B;22;42951229;42978044;26815;0
12624;ENSG00000182858;ALG12;22;50293877;50312106;18229;0
12625;ENSG00000182871;COL18A1;21;46825052;46933634;108582;0
12626;ENSG00000182899;RPL35A;3;197676858;197683481;6623;0
12627;ENSG00000182902;SLC25A18;22;18043139;18073760;30621;0
12628;ENSG00000182903;ZNF721;4;419604;492945;73341;0
12629;ENSG00000182912;C21orf90;21;45937099;45945835;8736;0
12630;ENSG00000182923;CEP63;3;134204585;134293859;89274;0
12631;ENSG00000182944;EWSR1;22;29663998;29696515;32517;0
12632;ENSG00000182973;CNOT10;3;32726637;32815367;88730;0
12633;ENSG00000183023;SLC8A1;2;40324410;40838193;513783;0
12634;ENSG00000183036;PCP4;21;41239243;41301322;62079;1
12635;ENSG00000183067;IGSF5;21;41117334;41174023;56689;0
12636;ENSG00000183090;FREM3;4;144498455;144621828;123373;0
12637;ENSG00000183091;NEB;2;152341850;152591001;249151;0
12638;ENSG00000183145;RIPPLY3;21;38378450;38391959;13509;0
12639;ENSG00000183172;SMDT1;22;42475695;42480288;4593;0
12640;ENSG00000183199;HSP90AB3P;4;88812995;88815167;2172;0
12641;ENSG00000183250;C21orf67;21;46352729;46359828;7099;0
12642;ENSG00000183255;PTTG1IP;21;46269500;46293752;24252;0
12643;ENSG00000183281;PLGLB1;2;87229682;87248975;19293;0
12644;ENSG00000183307;CECR6;22;17597189;17602257;5068;0
12645;ENSG00000183323;CCDC125;5;68576002;68628636;52634;0
12646;ENSG00000183423;LRIT3;4;110769358;110793471;24113;1
12647;ENSG00000183473;SSTR3;22;37600278;37608362;8084;1
12648;ENSG00000183474;GTF2H2C;5;68856035;68890550;34515;0
12649;ENSG00000183506;PI4KAP2;22;21827289;21871822;44533;0
12650;ENSG00000183513;COA5;2;99215773;99224978;9205;0
12651;ENSG00000183527;PSMG1;21;40546695;40555777;9082;0
12652;ENSG00000183530;PRR14L;22;32072242;32146126;73884;0
12653;ENSG00000183569;SERHL2;22;42949623;42970388;20765;0
12654;ENSG00000183570;PCBP3;21;47063608;47362368;298760;0
12655;ENSG00000183579;ZNRF3;22;29279580;29453475;173895;0
12656;ENSG00000183580;FBXL7;5;15500305;15939900;439595;0
12657;ENSG00000183597;TANGO2;22;20004537;20053449;48912;0
12658;ENSG00000183624;HMCES;3;128997671;129025029;27358;0
12659;ENSG00000183628;DGCR6;22;18893541;18901751;8210;0
12660;ENSG00000183647;ZNF530;19;58111253;58124090;12837;0
12661;ENSG00000183654;11-Mar;5;16067248;16180871;113623;0
12662;ENSG00000183662;FAM19A1;3;68053359;68594776;541417;0
12663;ENSG00000183666;GUSBP1;5;21341942;21589481;247539;0
12664;ENSG00000183671;GPR1;2;207040040;207082771;42731;1
12665;ENSG00000183741;CBX6;22;39257455;39268319;10864;0
12666;ENSG00000183762;KREMEN1;22;29469066;29564321;95255;0
12667;ENSG00000183763;TRAIP;3;49866034;49894007;27973;0
12668;ENSG00000183765;CHEK2;22;29083731;29138410;54679;0
12669;ENSG00000183773;AIFM3;22;21319396;21335649;16253;0
12670;ENSG00000183778;B3GALT5;21;40928369;41045064;116695;0
12671;ENSG00000183783;KCTD8;4;44175926;44450824;274898;0
12672;ENSG00000183785;TUBA8;22;18593097;18629321;36224;0
12673;ENSG00000183798;EMILIN3;20;39988606;39995467;6861;0
12674;ENSG00000183833;MAATS1;3;119421869;119485949;64080;0
12675;ENSG00000183840;GPR39;2;133174147;133404132;229985;1
12676;ENSG00000183864;TOB2;22;41829496;41843027;13531;0
12677;ENSG00000183891;TTC32;2;20096404;20101747;5343;0
12678;ENSG00000183960;KCNH8;3;19189946;19577138;387192;0
12679;ENSG00000183963;SMTN;22;31460091;31500743;40652;0
12680;ENSG00000184068;;22;42227219;42230669;3450;0
12681;ENSG00000184076;UQCR10;22;30163358;30166402;3044;0
12682;ENSG00000184117;NIPSNAP1;22;29950797;29977326;26529;0
12683;ENSG00000184164;CRELD2;22;50311815;50321188;9373;0
12684;ENSG00000184178;SCFD2;4;53739149;54232242;493093;0
12685;ENSG00000184182;UBE2F;2;238875469;238951236;75767;0
12686;ENSG00000184203;PPP1R2;3;195241221;195270209;28988;0
12687;ENSG00000184208;C22orf46;22;42084943;42094140;9197;0
12688;ENSG00000184220;CMSS1;3;99536678;99897447;360769;0
12689;ENSG00000184261;KCNK12;2;47743720;47798078;54358;1
12690;ENSG00000184305;CCSER1;4;91048686;92523064;1474378;0
12691;ENSG00000184307;ZDHHC23;3;113666748;113684248;17500;0
12692;ENSG00000184319;RPL23AP82;22;51195376;51239737;44361;0
12693;ENSG00000184378;ACTRT3;3;169484709;169487683;2974;0
12694;ENSG00000184381;PLA2G6;22;38507502;38601697;94195;0
12695;ENSG00000184402;SS18L1;20;60718822;60757540;38718;0
12696;ENSG00000184432;COPB2;3;139074442;139108574;34132;0
12697;ENSG00000184436;THAP7;22;21353393;21356485;3092;0
12698;ENSG00000184441;;21;45751117;45755734;4617;0
12699;ENSG00000184470;TXNRD2;22;19863040;19929341;66301;0
12700;ENSG00000184492;FOXD4L1;2;114256661;114258728;2067;0
12701;ENSG00000184500;PROS1;3;93591881;93692910;101029;0
12702;ENSG00000184611;KCNH7;2;163227917;163695240;467323;0
12703;ENSG00000184674;GSTT1;22;24376133;24384680;8547;0
12704;ENSG00000184702;05-Sep;22;19701987;19712295;10308;0
12705;ENSG00000184708;EIF4ENIF1;22;31832963;31892094;59131;0
12706;ENSG00000184731;FAM110C;2;38814;46870;8056;0
12707;ENSG00000184787;UBE2G2;21;46188955;46221934;32979;0
12708;ENSG00000184792;OSBP2;22;31089769;31303811;214042;0
12709;ENSG00000184809;C21orf88;21;40969074;40984748;15674;0
12710;ENSG00000184897;H1FX;3;129033615;129035120;1505;0
12711;ENSG00000184898;RBM43;2;152104454;152118393;13939;0
12712;ENSG00000184900;SUMO3;21;46225532;46238694;13162;0
12713;ENSG00000184924;PTRHD1;2;25012603;25016251;3648;0
12714;ENSG00000184949;FAM227A;22;38974125;39052634;78509;0
12715;ENSG00000184979;USP18;22;18632666;18660164;27498;0
12716;ENSG00000184983;NDUFA6;22;42481529;42486959;5430;0
12717;ENSG00000184985;SORCS2;4;7194265;7744554;550289;0
12718;ENSG00000185008;ROBO2;3;75955846;77699115;1743269;0
12719;ENSG00000185019;UBOX5;20;3088219;3140842;52623;0
12720;ENSG00000185022;MAFF;22;38597889;38612518;14629;0
12721;ENSG00000185049;NELFA;4;1984441;2043630;59189;0
12722;ENSG00000185052;SLC24A3;20;19193290;19703581;510291;0
12723;ENSG00000185065;;22;19435416;19437628;2212;0
12724;ENSG00000185112;FAM43A;3;194406622;194409762;3140;0
12725;ENSG00000185133;INPP5J;22;31518717;31530682;11965;0
12726;ENSG00000185149;NPY2R;4;156129781;156138230;8449;0
12727;ENSG00000185186;LINC00313;21;44881974;44899414;17440;0
12728;ENSG00000185219;ZNF445;3;44481262;44519162;37900;0
12729;ENSG00000185252;ZNF74;22;20748405;20762745;14340;0
12730;ENSG00000185272;RBM11;21;15588451;15600693;12242;0
12731;ENSG00000185304;RGPD2;2;88055474;88285309;229835;0
12732;ENSG00000185305;ARL15;5;53179775;53606412;426637;0
12733;ENSG00000185339;TCN2;22;31002825;31023265;20440;0
12734;ENSG00000185340;GAS2L1;22;29702572;29708774;6202;0
12735;ENSG00000185386;MAPK11;22;50702142;50709196;7054;0
12736;ENSG00000185433;LINC00158;21;26758133;26804013;45880;1
12737;ENSG00000185437;SH3BGR;21;40817781;40887433;69652;0
12738;ENSG00000185477;GPRIN3;4;90157537;90229161;71624;0
12739;ENSG00000185485;SDHAP1;3;195686619;195717189;30570;0
12740;ENSG00000185513;L3MBTL1;20;42136320;42179590;43270;0
12741;ENSG00000185565;LSAMP;3;115521235;117716095;2194860;0
12742;ENSG00000185608;MRPL40;22;19419425;19423598;4173;0
12743;ENSG00000185614;FAM212A;3;49840687;49842463;1776;0
12744;ENSG00000185619;PCGF3;4;699537;764428;64891;0
12745;ENSG00000185621;LMLN;3;197687071;197770591;83520;0
12746;ENSG00000185651;UBE2L3;22;21903736;21978323;74587;0
12747;ENSG00000185658;BRWD1;21;40556102;40693485;137383;0
12748;ENSG00000185666;SYN3;22;32908539;33454358;545819;1
12749;ENSG00000185686;PRAME;22;22890123;22901768;11645;0
12750;ENSG00000185721;DRG1;22;31795509;31924726;129217;0
12751;ENSG00000185774;KCNIP4;4;20730239;21950422;1220183;0
12752;ENSG00000185798;WDR53;3;196281056;196295545;14489;0
12753;ENSG00000185808;PIGP;21;38431470;38445470;14000;0
12754;ENSG00000185818;NAT8L;4;2061239;2070816;9577;0
12755;ENSG00000185834;RPL12P4;20;53691155;53691685;530;0
12756;ENSG00000185838;GNB1L;22;19770747;19842462;71715;0
12757;ENSG00000185909;KLHDC8B;3;49209044;49213917;4873;0
12758;ENSG00000185917;SETD4;21;37406839;37451687;44848;0
12759;ENSG00000185986;SDHAP3;5;1568637;1594735;26098;0
12760;ENSG00000186001;LRCH3;3;197518097;197615307;97210;0
12761;ENSG00000186132;C2orf76;2;120059801;120124404;64603;0
12762;ENSG00000186162;CIDECP;3;10055932;10068049;12117;0
12763;ENSG00000186212;SOWAHB;4;77816082;77819002;2920;0
12764;ENSG00000186222;BLOC1S4;4;6717842;6719387;1545;0
12765;ENSG00000186230;ZNF749;19;57946697;57956853;10156;0
12766;ENSG00000186235;;2;239133193;239140318;7125;0
12767;ENSG00000186265;BTLA;3;112182815;112218408;35593;0
12768;ENSG00000186272;ZNF17;19;57922531;57933307;10776;0
12769;ENSG00000186352;ANKRD37;4;186317175;186321782;4607;0
12770;ENSG00000186432;KPNA4;3;160212783;160283376;70593;0
12771;ENSG00000186446;ZNF501;3;44771088;44778575;7487;0
12772;ENSG00000186448;ZNF197;3;44626380;44689963;63583;0
12773;ENSG00000186453;FAM228A;2;24397938;24423718;25780;0
12774;ENSG00000186479;RGS7BP;5;63802084;63908139;106055;0
12775;ENSG00000186487;MYT1L;2;1792885;2335032;542147;0
12776;ENSG00000186493;C5orf38;5;2752245;2755508;3263;0
12777;ENSG00000186522;10-Sep;2;110300559;110371783;71224;0
12778;ENSG00000186575;NF2;22;29999545;30094587;95042;0
12779;ENSG00000186654;PRR5;22;45064593;45133561;68968;0
12780;ENSG00000186684;CYP27C1;2;127941696;127977654;35958;0
12781;ENSG00000186716;BCR;22;23521891;23660224;138333;0
12782;ENSG00000186732;MPPED1;22;43807202;43903728;96526;0
12783;ENSG00000186792;HYAL3;3;50330262;50336899;6637;0
12784;ENSG00000186842;LINC00846;21;33944548;33948191;3643;0
12785;ENSG00000186854;TRABD2A;2;85048774;85134132;85358;0
12786;ENSG00000186866;POFUT2;21;46683843;46707813;23970;0
12787;ENSG00000186889;TMEM17;2;62727356;62739029;11673;0
12788;ENSG00000186951;PPARA;22;46546424;46639653;93229;0
12789;ENSG00000186976;EFCAB6;22;43924624;44208217;283593;0
12790;ENSG00000186998;EMID1;22;29601840;29655586;53746;0
12791;ENSG00000187051;RPS19BP1;22;39925098;39928860;3762;0
12792;ENSG00000187068;C3orf70;3;184795838;184870802;74964;0
12793;ENSG00000187091;PLCD1;3;38048987;38071253;22266;0
12794;ENSG00000187098;MITF;3;69788586;70017488;228902;0
12795;ENSG00000187118;CMC1;3;28283075;28366633;83558;0
12796;ENSG00000187123;LYPD6;2;150186499;150330662;144163;0
12797;ENSG00000187231;SESTD1;2;179966419;180129517;163098;0
12798;ENSG00000187514;PTMA;2;232571605;232578251;6646;0
12799;ENSG00000187605;TET3;2;74229840;74335303;105463;0
12800;ENSG00000187627;RGPD1;2;87135076;87241104;106028;0
12801;ENSG00000187653;TMSB4XP8;4;91759652;91760263;611;0
12802;ENSG00000187672;ERC2;3;55542336;56502391;960055;0
12803;ENSG00000187695;;3;128628717;128690173;61456;0
12804;ENSG00000187699;C2orf88;2;190744335;191068210;323875;0
12805;ENSG00000187792;ZNF70;22;24083769;24093279;9510;0
12806;ENSG00000187860;CCDC157;22;30752624;30774647;22023;0
12807;ENSG00000187902;SHISA7;19;55940107;55954230;14123;0
12808;ENSG00000187944;C2orf66;2;197669726;197675000;5274;0
12809;ENSG00000187957;DNER;2;230222345;230579274;356929;1
12810;ENSG00000188001;TPRG1;3;188665003;189043093;378090;0
12811;ENSG00000188002;;5;1599035;1634120;35085;0
12812;ENSG00000188010;MORN2;2;39103103;39156213;53110;0
12813;ENSG00000188011;CXXC11;2;242811752;242815975;4223;0
12814;ENSG00000188042;ARL4C;2;235401685;235405697;4012;0
12815;ENSG00000188064;WNT7B;22;46316242;46373009;56767;0
12816;ENSG00000188130;MAPK12;22;50683879;50700254;16375;0
12817;ENSG00000188167;TMPPE;3;33131913;33138293;6380;0
12818;ENSG00000188177;ZC3H6;2;113033171;113097640;64469;0
12819;ENSG00000188219;POTEE;2;131975882;132022965;47083;0
12820;ENSG00000188242;;5;466239;473213;6974;0
12821;ENSG00000188306;LRRIQ4;3;169539710;169555563;15853;0
12822;ENSG00000188313;PLSCR1;3;146232967;146262651;29684;0
12823;ENSG00000188315;C3orf62;3;49306035;49315342;9307;1
12824;ENSG00000188338;SLC38A3;3;50242679;50258411;15732;0
12825;ENSG00000188452;CERKL;2;182401403;182545392;143989;0
12826;ENSG00000188517;COL25A1;4;109731877;110223813;491936;0
12827;ENSG00000188542;DUSP28;2;241499471;241503431;3960;0
12828;ENSG00000188559;RALGAPA2;20;20370196;20693131;322935;0
12829;ENSG00000188582;PAQR9;3;142668006;142682178;14172;0
12830;ENSG00000188636;LDOC1L;22;44888452;44894178;5726;0
12831;ENSG00000188674;C2orf80;2;209030067;209054797;24730;0
12832;ENSG00000188677;PARVB;22;44395091;44568829;173738;0
12833;ENSG00000188681;TEKT4P2;21;9907190;9968585;61395;0
12834;ENSG00000188687;SLC4A5;2;74443369;74570541;127172;1
12835;ENSG00000188725;SMIM15;5;60453536;60458301;4765;0
12836;ENSG00000188738;FSIP2;2;186603355;186698017;94662;0
12837;ENSG00000188760;TMEM198;2;220408385;220415317;6932;0
12838;ENSG00000188785;ZNF548;19;57901218;57912786;11568;0
12839;ENSG00000188818;ZDHHC11;5;710471;851101;140630;0
12840;ENSG00000188846;RPL14;3;40498783;40503861;5078;0
12841;ENSG00000188848;BEND4;4;42112955;42154895;41940;0
12842;ENSG00000188958;UTS2B;3;190984957;191048325;63368;0
12843;ENSG00000188971;;2;69685129;69693664;8535;0
12844;ENSG00000188981;MSANTD1;4;3246096;3273465;27369;0
12845;ENSG00000188993;LRRC66;4;52859868;52883786;23918;0
12846;ENSG00000189060;H1F0;22;38201114;38203442;2328;0
12847;ENSG00000189157;FAM47E;4;77135193;77204933;69740;0
12848;ENSG00000189184;PCDH18;4;138440072;138453648;13576;1
12849;ENSG00000189223;PAX8-AS1;2;113969099;114034158;65059;0
12850;ENSG00000189229;;3;6532166;6777816;245650;0
12851;ENSG00000189269;C22orf43;22;23950639;23974508;23869;1
12852;ENSG00000189283;FHIT;3;59735036;61237133;1502097;0
12853;ENSG00000189292;FAM150B;2;279558;288851;9293;1
12854;ENSG00000189306;RRP7A;22;42905974;42915808;9834;0
12855;ENSG00000189308;LIN54;4;83831126;83934079;102953;0
12856;ENSG00000189350;FAM179A;2;29179477;29284239;104762;0
12857;ENSG00000189362;TMEM194B;2;191369068;191399448;30380;0
12858;ENSG00000196074;SYCP2;20;58438618;58508710;70092;1
12859;ENSG00000196083;IL1RAP;3;190231840;190375843;144003;0
12860;ENSG00000196096;;2;214141276;214148929;7653;1
12861;ENSG00000196104;SPOCK3;4;167654535;168155947;501412;1
12862;ENSG00000196132;MYT1;20;62783144;62873604;90460;0
12863;ENSG00000196141;SPATS2L;2;201170604;201346986;176382;0
12864;ENSG00000196151;WDSUB1;2;160092304;160143310;51006;0
12865;ENSG00000196159;FAT4;4;126237554;126414087;176533;0
12866;ENSG00000196208;GREB1;2;11674242;11782914;108672;0
12867;ENSG00000196220;SRGAP3;3;9022275;9404737;382462;0
12868;ENSG00000196227;FAM217B;20;58508819;58523735;14916;0
12869;ENSG00000196236;XPNPEP3;22;41253081;41363838;110757;0
12870;ENSG00000196263;ZNF471;19;57019212;57041590;22378;0
12871;ENSG00000196277;GRM7;3;6811688;7783215;971527;0
12872;ENSG00000196290;NIF3L1;2;201754050;201768655;14605;0
12873;ENSG00000196345;ZKSCAN7;3;44596685;44624975;28290;0
12874;ENSG00000196353;CPNE4;3;131252399;132004254;751855;0
12875;ENSG00000196355;;4;38628029;38666430;38401;1
12876;ENSG00000196396;PTPN1;20;49126891;49201299;74408;0
12877;ENSG00000196419;XRCC6;22;42017123;42060044;42921;0
12878;ENSG00000196421;LINC00176;20;62665697;62671315;5618;0
12879;ENSG00000196428;TSC22D2;3;150126122;150184218;58096;0
12880;ENSG00000196455;PIK3R4;3;130397779;130465673;67894;0
12881;ENSG00000196476;C20orf96;20;251504;271390;19886;0
12882;ENSG00000196504;PRPF40A;2;153508107;153574511;66404;0
12883;ENSG00000196526;AFAP1;4;7760441;7941653;181212;0
12884;ENSG00000196542;SPTSSB;3;161062580;161090668;28088;0
12885;ENSG00000196549;MME;3;154741913;154901497;159584;1
12886;ENSG00000196562;SULF2;20;46285092;46415360;130268;0
12887;ENSG00000196576;PLXNB2;22;50713408;50746056;32648;0
12888;ENSG00000196588;MKL1;22;40806285;41032706;226421;0
12889;ENSG00000196604;POTEF;2;130831108;130886795;55687;0
12890;ENSG00000196622;RIMBP3;22;20456003;20461786;5783;0
12891;ENSG00000196639;HRH1;3;11178779;11305243;126464;0
12892;ENSG00000196653;ZNF502;3;44754135;44765323;11188;0
12893;ENSG00000196656;;4;114135137;114138326;3189;0
12894;ENSG00000196659;TTC30B;2;178413726;178417742;4016;0
12895;ENSG00000196700;ZNF512B;20;62588055;62680113;92058;0
12896;ENSG00000196724;ZNF418;19;58433252;58446761;13509;0
12897;ENSG00000196756;SNHG17;20;37049235;37063996;14761;0
12898;ENSG00000196776;CD47;3;107762145;107809872;47727;0
12899;ENSG00000196782;MAML3;4;140637907;141075338;437431;0
12900;ENSG00000196810;CTBP1-AS2;4;1243088;1282079;38991;0
12901;ENSG00000196839;ADA;20;43248163;43280874;32711;0
12902;ENSG00000196843;ARID5A;2;97202480;97218375;15895;0
12903;ENSG00000196867;ZFP28;19;57050317;57068169;17852;0
12904;ENSG00000196872;KIAA1211L;2;99410309;99552722;142413;0
12905;ENSG00000196912;ANKRD36B;2;98108978;98206428;97450;0
12906;ENSG00000196934;RIMBP3B;22;21737663;21743446;5783;0
12907;ENSG00000196950;SLC39A10;2;196440701;196602426;161725;0
12908;ENSG00000196951;;4;141204878;141294535;89657;0
12909;ENSG00000196975;ANXA4;2;69871557;70053596;182039;0
12910;ENSG00000196981;WDR5B;3;122130715;122134882;4167;0
12911;ENSG00000197016;ZNF470;19;57078880;57100279;21399;0
12912;ENSG00000197077;KIAA1671;22;25348697;25593415;244718;0
12913;ENSG00000197114;ZGPAT;20;62338817;62367494;28677;0
12914;ENSG00000197121;PGAP1;2;197697728;197792520;94792;0
12915;ENSG00000197122;SRC;20;35973088;36034453;61365;0
12916;ENSG00000197128;ZNF772;19;57978031;57988938;10907;0
12917;ENSG00000197182;;22;46449749;46509808;60059;0
12918;ENSG00000197183;C20orf112;20;31030862;31172876;142014;0
12919;ENSG00000197223;C1D;2;68268262;68338080;69818;0
12920;ENSG00000197296;FITM2;20;42931478;42939809;8331;0
12921;ENSG00000197329;PELI1;2;64319786;64371588;51802;0
12922;ENSG00000197381;ADARB1;21;46493768;46646478;152710;0
12923;ENSG00000197385;ZNF860;3;32023263;32033120;9857;0
12924;ENSG00000197386;HTT;4;3076408;3245676;169268;0
12925;ENSG00000197410;DCHS2;4;155153399;155412930;259531;0
12926;ENSG00000197415;VEPH1;3;156977531;157251408;273877;0
12927;ENSG00000197457;STMN3;20;62271061;62284780;13719;0
12928;ENSG00000197483;ZNF628;19;55987699;55995854;8155;0
12929;ENSG00000197496;SLC2A10;20;45338126;45364965;26839;0
12930;ENSG00000197548;ATG7;3;11313995;11599139;285144;0
12931;ENSG00000197557;TTC30A;2;178477720;178483694;5974;0
12932;ENSG00000197584;KCNMB2;3;177990720;178562217;571497;0
12933;ENSG00000197586;ENTPD6;20;25176329;25207365;31036;0
12934;ENSG00000197603;C5orf42;5;37106330;37249530;143200;0
12935;ENSG00000197701;ZNF595;4;53179;88099;34920;0
12936;ENSG00000197712;FAM114A1;4;38869298;38947360;78062;0
12937;ENSG00000197713;RPE;2;210867289;210886300;19011;0
12938;ENSG00000197714;ZNF460;19;57791419;57804937;13518;0
12939;ENSG00000197756;RPL37A;2;217362912;217443903;80991;0
12940;ENSG00000197763;TXNRD3;3;126290622;126373998;83376;0
12941;ENSG00000197818;SLC9A8;20;48429250;48508779;79529;0
12942;ENSG00000197822;OCLN;5;68788119;68853931;65812;0
12943;ENSG00000197860;SGTB;5;64961755;65018862;57107;0
12944;ENSG00000197872;FAM49A;2;16730727;16847599;116872;0
12945;ENSG00000197885;NKIRAS1;3;23933151;23988082;54931;0
12946;ENSG00000197894;ADH5;4;99992132;100009952;17820;0
12947;ENSG00000197927;C2orf27A;2;132479948;132524973;45025;0
12948;ENSG00000197934;;21;27765954;27941571;175617;0
12949;ENSG00000197951;ZNF71;19;57106632;57137849;31217;0
12950;ENSG00000197980;LEKR1;3;156543270;156763918;220648;0
12951;ENSG00000198026;ZNF335;20;44577292;44600833;23541;0
12952;ENSG00000198046;ZNF667;19;56950694;56989434;38740;0
12953;ENSG00000198053;SIRPA;20;1875154;1920543;45389;0
12954;ENSG00000198075;SULT1C4;2;108994367;109004513;10146;0
12955;ENSG00000198089;SFI1;22;31884674;32014572;129898;0
12956;ENSG00000198099;ADH4;4;100044808;100078949;34141;0
12957;ENSG00000198130;HIBCH;2;191054461;191208919;154458;0
12958;ENSG00000198131;ZNF544;19;58739960;58788815;48855;0
12959;ENSG00000198142;SOWAHC;2;110371911;110376563;4652;0
12960;ENSG00000198155;ZNF876P;4;206399;249774;43375;1
12961;ENSG00000198171;DDRGK1;20;3170996;3185331;14335;0
12962;ENSG00000198185;ZNF334;20;45129701;45142198;12497;0
12963;ENSG00000198189;HSD17B11;4;88257762;88312538;54776;0
12964;ENSG00000198218;QRICH1;3;49067140;49131796;64656;0
12965;ENSG00000198237;;5;69171098;69274436;103338;0
12966;ENSG00000198276;UCKL1;20;62571186;62587769;16583;0
12967;ENSG00000198301;SDAD1;4;76862103;76912115;50012;0
12968;ENSG00000198355;PIM3;22;50354161;50357728;3567;0
12969;ENSG00000198369;SPRED2;2;65537985;65659771;121786;0
12970;ENSG00000198380;GFPT1;2;69546905;69614382;67477;0
12971;ENSG00000198399;ITSN2;2;24425733;24583583;157850;0
12972;ENSG00000198406;BZW1P2;3;116364592;116365574;982;0
12973;ENSG00000198440;ZNF583;19;56909335;56947404;38069;0
12974;ENSG00000198466;ZNF587;19;58361225;58376480;15255;0
12975;ENSG00000198477;ZNF280B;22;22838767;22863505;24738;0
12976;ENSG00000198498;TMA16;4;164415594;164441691;26097;0
12977;ENSG00000198522;GPN1;2;27851114;27874375;23261;0
12978;ENSG00000198547;C20orf203;20;31219428;31261743;42315;0
12979;ENSG00000198585;NUDT16;3;131100515;131107674;7159;0
12980;ENSG00000198586;TLK1;2;171847333;172087824;240491;0
12981;ENSG00000198589;LRBA;4;151185594;151936879;751285;0
12982;ENSG00000198590;C3orf35;3;37427760;37476988;49228;0
12983;ENSG00000198612;COPS8;2;237993955;238009109;15154;0
12984;ENSG00000198618;PPIAP22;21;20230097;20230594;497;0
12985;ENSG00000198646;NCOA6;20;33284722;33413452;128730;0
12986;ENSG00000198648;STK39;2;168810530;169104651;294121;0
12987;ENSG00000198780;FAM169A;5;74073399;74162776;89377;0
12988;ENSG00000198792;TMEM184B;22;38615298;38669040;53742;0
12989;ENSG00000198832;;22;31500758;31516055;15297;0
12990;ENSG00000198836;OPA1;3;193310933;193415612;104679;0
12991;ENSG00000198843;;3;150320662;150348222;27560;0
12992;ENSG00000198856;OSTC;4;109571740;109588976;17236;0
12993;ENSG00000198862;LTN1;21;30300466;30365270;64804;0
12994;ENSG00000198865;CCDC152;5;42756903;42802462;45559;0
12995;ENSG00000198885;ITPRIPL1;2;96991069;96994091;3022;0
12996;ENSG00000198900;TOP1;20;39657458;39753127;95669;0
12997;ENSG00000198911;SREBF2;22;42229109;42303312;74203;0
12998;ENSG00000198914;POU3F3;2;105471969;105476929;4960;0
12999;ENSG00000198919;DZIP3;3;108308529;108413693;105164;0
13000;ENSG00000198925;ATG9A;2;220074494;220094439;19945;0
13001;ENSG00000198948;MFAP3L;4;170907748;170954182;46434;0
13002;ENSG00000198951;NAGA;22;42454358;42466846;12488;0
13003;ENSG00000198959;TGM2;20;36756863;36794980;38117;0
13004;ENSG00000199266;SNORA60;20;37078013;37078146;133;0
13005;ENSG00000199476;;3;48330077;48330184;107;0
13006;ENSG00000199645;RNU6-1330P;5;74075134;74075238;104;0
13007;ENSG00000201025;;21;17657017;17657089;72;0
13008;ENSG00000201441;RNU6-646P;3;196435730;196435835;105;0
13009;ENSG00000201499;RNU6-312P;2;201746438;201746544;106;0
13010;ENSG00000202058;RN7SKP80;22;42961054;42961336;282;0
13011;ENSG00000202358;RNU6-652P;4;56751761;56751867;106;0
13012;ENSG00000203327;;2;55441523;55443262;1739;0
13013;ENSG00000203344;;2;91693219;91693945;726;1
13014;ENSG00000203435;;2;196858983;196860404;1421;0
13015;ENSG00000203644;;3;129565893;129566800;907;1
13016;ENSG00000203880;PCMTD2;20;62887094;62926855;39761;0
13017;ENSG00000203896;LIME1;20;62366815;62370456;3641;0
13018;ENSG00000203900;;20;61991340;62002529;11189;0
13019;ENSG00000204044;;20;44642141;44650712;8571;0
13020;ENSG00000204070;SYS1;20;43990577;44005438;14861;0
13021;ENSG00000204099;NEU4;2;242749920;242758739;8819;0
13022;ENSG00000204103;MAFB;20;39314488;39317880;3392;1
13023;ENSG00000204104;TRAF3IP1;2;239229082;239309541;80459;0
13024;ENSG00000204120;GIGYF2;2;233562009;233725285;163276;0
13025;ENSG00000204128;C2orf72;2;231902205;231914434;12229;0
13026;ENSG00000204186;ZDBF2;2;207139387;207179148;39761;0
13027;ENSG00000204217;BMPR2;2;203241659;203432474;190815;0
13028;ENSG00000204253;HNRNPCP2;2;190788062;190788942;880;0
13029;ENSG00000204262;COL5A2;2;189896622;190044605;147983;1
13030;ENSG00000204311;DFNB59;2;179316163;179326117;9954;0
13031;ENSG00000204334;ERICH2;2;171640296;171655481;15185;0
13032;ENSG00000204406;MBD5;2;148778580;149275805;497225;0
13033;ENSG00000204514;ZNF814;19;58360099;58400442;40343;0
13034;ENSG00000204519;ZNF551;19;58193337;58228669;35332;0
13035;ENSG00000204524;ZNF805;19;57751973;57766503;14530;0
13036;ENSG00000204556;;20;25999468;26001320;1852;1
13037;ENSG00000204588;LINC01123;2;110744640;110753717;9077;0
13038;ENSG00000204634;TBC1D8;2;101624079;101869328;245249;0
13039;ENSG00000204685;STARD7-AS1;2;96874154;96908359;34205;0
13040;ENSG00000204745;;2;87352513;87423770;71257;0
13041;ENSG00000204822;MRPL53;2;74699085;74700449;1364;0
13042;ENSG00000204843;DCTN1;2;74588281;74619214;30933;0
13043;ENSG00000204923;FBXO48;2;68686551;68694390;7839;0
13044;ENSG00000204929;;2;65663845;66311773;647928;0
13045;ENSG00000205129;C4orf47;4;186347394;186370980;23586;0
13046;ENSG00000205181;LINC00654;20;5476713;5485259;8546;0
13047;ENSG00000205208;C4orf46;4;159587831;159593407;5576;0
13048;ENSG00000205403;CFI;4;110661852;110723335;61483;1
13049;ENSG00000205559;CHKB-AS1;22;51021455;51022306;851;0
13050;ENSG00000205560;CPT1B;22;51007290;51017899;10609;0
13051;ENSG00000205571;SMN2;5;69345350;69374349;28999;0
13052;ENSG00000205572;SERF1B;5;69321074;69338940;17866;0
13053;ENSG00000205581;HMGN1;21;40714241;40721573;7332;0
13054;ENSG00000205593;DENND6B;22;50747459;50765489;18030;0
13055;ENSG00000205611;;20;29513582;29521213;7631;0
13056;ENSG00000205639;MFSD2B;2;24232951;24286191;53240;0
13057;ENSG00000205643;CDPF1;22;46639908;46646576;6668;0
13058;ENSG00000205670;SMIM11;21;35747779;35780164;32385;0
13059;ENSG00000205678;TECRL;4;65140975;65275186;134211;0
13060;ENSG00000205702;CYP2D7P;22;42536214;42540576;4362;0
13061;ENSG00000205704;LINC00634;22;42348169;42354937;6768;0
13062;ENSG00000205726;ITSN1;21;35014706;35272165;257459;0
13063;ENSG00000205758;CRYZL1;21;34961647;35016232;54585;0
13064;ENSG00000205765;C5orf51;5;41904290;41921738;17448;0
13065;ENSG00000205795;CYS1;2;10196907;10221071;24164;0
13066;ENSG00000205838;TTC23L;5;34838938;34899561;60623;0
13067;ENSG00000205853;RFPL3S;22;32755893;32778039;22146;0
13068;ENSG00000205856;C22orf42;22;32544993;32555309;10316;0
13069;ENSG00000205927;OLIG2;21;34398153;34401504;3351;0
13070;ENSG00000205929;C21orf62;21;34162985;34186053;23068;0
13071;ENSG00000205930;C21orf49;21;34144411;34266043;121632;0
13072;ENSG00000205959;;4;8483997;8514337;30340;0
13073;ENSG00000205981;DNAJC19;3;180701497;180707562;6065;0
13074;ENSG00000206028;;22;27063656;27068617;4961;0
13075;ENSG00000206077;ZDHHC11B;5;710475;767067;56592;0
13076;ENSG00000206113;;4;2420701;2452087;31386;0
13077;ENSG00000206120;EGFEM1P;3;167967310;168548387;581077;0
13078;ENSG00000206140;TMEM191C;22;21820712;21825558;4846;0
13079;ENSG00000206199;ANKUB1;3;149478892;149686172;207280;0
13080;ENSG00000206417;H1FX-AS1;3;129034235;129045068;10833;0
13081;ENSG00000206527;PTPLB;3;123209667;123304032;94365;0
13082;ENSG00000206530;WDR52;3;113005777;113160457;154680;0
13083;ENSG00000206532;;3;110607231;110612323;5092;1
13084;ENSG00000206535;LNP1;3;100120037;100175163;55126;0
13085;ENSG00000206538;VGLL3;3;86987119;87040269;53150;1
13086;ENSG00000206557;TRIM71;3;32859510;32939318;79808;0
13087;ENSG00000206559;ZCWPW2;3;28390637;28579613;188976;0
13088;ENSG00000206560;ANKRD28;3;15708743;15901278;192535;0
13089;ENSG00000206561;COLQ;3;15491640;15563258;71618;0
13090;ENSG00000206562;METTL6;3;15422782;15482073;59291;0
13091;ENSG00000206567;;3;10048102;10052893;4791;0
13092;ENSG00000206573;SETD5-AS1;3;9391373;9440263;48890;0
13093;ENSG00000206712;RNU6-26P;3;98523822;98523928;106;0
13094;ENSG00000206814;;5;17117685;17117795;110;0
13095;ENSG00000207195;;4;40828672;40828782;110;0
13096;ENSG00000207383;;2;113337061;113337161;100;0
13097;ENSG00000207524;RNU6-33P;4;89605999;89606105;106;0
13098;ENSG00000207554;MIR647;20;62573984;62574079;95;0
13099;ENSG00000207650;MIR570;3;195426272;195426368;96;0
13100;ENSG00000207697;MIR573;4;24521815;24521913;98;0
13101;ENSG00000207770;MIR568;3;114035322;114035416;94;0
13102;ENSG00000207815;MIR563;3;15915278;15915356;78;0
13103;ENSG00000207863;MIR125B2;21;17962557;17962645;88;0
13104;ENSG00000207926;MIR135A1;3;52328235;52328324;89;0
13105;ENSG00000208772;SNORD94;2;86362993;86363129;136;0
13106;ENSG00000211456;SACM1L;3;45730548;45786916;56368;0
13107;ENSG00000211460;TSN;2;122494679;122525429;30750;0
13108;ENSG00000211553;;4;130242;130349;107;0
13109;ENSG00000211644;IGLV1-51;22;22676828;22677336;508;0
13110;ENSG00000211683;;22;23972805;23981128;8323;0
13111;ENSG00000212304;SNORD12;20;47897220;47897309;89;0
13112;ENSG00000212493;SNORD19;3;52723264;52723331;67;0
13113;ENSG00000212536;RNA5SP474;20;5079033;5079122;89;0
13114;ENSG00000212588;SNORA26;4;53579416;53579537;121;0
13115;ENSG00000212978;;2;61368732;61372104;3372;0
13116;ENSG00000213013;RPS15AP36;19;58727546;58727927;381;0
13117;ENSG00000213015;ZNF580;19;56146382;56154835;8453;0
13118;ENSG00000213090;;2;202275267;202278031;2764;0
13119;ENSG00000213123;TCTEX1D2;3;196018090;196045170;27080;1
13120;ENSG00000213139;CRYGS;3;186256230;186264491;8261;0
13121;ENSG00000213160;KLHL23;2;170550998;170633499;82501;0
13122;ENSG00000213178;;3;169201459;169201868;409;0
13123;ENSG00000213186;TRIM59;3;160150233;160203561;53328;0
13124;ENSG00000213189;BTF3L4P2;2;159860287;159861065;778;0
13125;ENSG00000213236;YWHAZP2;2;127315012;127315739;727;0
13126;ENSG00000213300;HNRNPA3P6;3;75263782;75264787;1005;0
13127;ENSG00000213337;ANKRD39;2;97502348;97523832;21484;0
13128;ENSG00000213375;;2;87596356;87596632;276;0
13129;ENSG00000213430;HSPD1P1;5;21882694;21884421;1727;0
13130;ENSG00000213519;;3;197307215;197307500;285;0
13131;ENSG00000213533;TMEM110;3;52870235;52931612;61377;0
13132;ENSG00000213553;RPLP0P6;2;38708920;38710012;1092;0
13133;ENSG00000213600;;3;50277054;50277416;362;0
13134;ENSG00000213608;SLC25A14P1;4;84398677;84399577;900;0
13135;ENSG00000213626;LBH;2;30454397;30546596;92199;0
13136;ENSG00000213639;PPP1CB;2;28974506;29025806;51300;0
13137;ENSG00000213672;NCKIPSD;3;48701364;48723797;22433;0
13138;ENSG00000213689;TREX1;3;48506445;48509044;2599;0
13139;ENSG00000213699;SLC35F6;2;26987152;27004099;16947;0
13140;ENSG00000213707;HMGB1P10;22;26956492;26957054;562;0
13141;ENSG00000213714;FAM209B;20;55108302;55111576;3274;1
13142;ENSG00000213742;ZNF337-AS1;20;25604681;25658710;54029;1
13143;ENSG00000213753;CENPBD1P1;19;59084870;59111168;26298;0
13144;ENSG00000213762;ZNF134;19;58125601;58134724;9123;0
13145;ENSG00000213790;OLA1P1;22;42503769;42504957;1188;0
13146;ENSG00000213846;;3;27674467;27675211;744;0
13147;ENSG00000213888;;22;31742875;31744670;1795;0
13148;ENSG00000213901;SLC23A3;2;219940051;220035549;95498;0
13149;ENSG00000213923;CSNK1E;22;38686697;38794527;107830;0
13150;ENSG00000213949;ITGA1;5;52083730;52255040;171310;0
13151;ENSG00000213963;;2;178148236;178257419;109183;0
13152;ENSG00000213979;RPL7AP14;20;36073135;36073936;801;0
13153;ENSG00000213981;;2;171475138;171551884;76746;0
13154;ENSG00000214021;TTLL3;3;9849770;9896822;47052;0
13155;ENSG00000214076;CPSF1P1;22;32665368;32669097;3729;0
13156;ENSG00000214077;GNAQP1;2;132181374;132182440;1066;0
13157;ENSG00000214078;CPNE1;20;34213953;34252878;38925;0
13158;ENSG00000214135;;3;197305084;197354777;49693;0
13159;ENSG00000214160;ALG3;3;183960089;183967336;7247;0
13160;ENSG00000214164;;2;91723049;91723916;867;0
13161;ENSG00000214273;AGGF1P1;4;190962497;190964569;2072;1
13162;ENSG00000214289;RPL39P5;3;134070694;134075403;4709;0
13163;ENSG00000214367;HAUS3;4;2229191;2243891;14700;0
13164;ENSG00000214369;;2;170646603;170647395;792;0
13165;ENSG00000214381;LINC00488;3;108897012;108904104;7092;0
13166;ENSG00000214491;SEC14L6;22;30918786;30942669;23883;0
13167;ENSG00000214535;RPS15AP1;20;21146846;21147236;390;0
13168;ENSG00000214595;EML6;2;54950636;55199157;248521;0
13169;ENSG00000214694;ARHGEF33;2;39117021;39202590;85569;1
13170;ENSG00000214706;IFRD2;3;50325163;50330349;5186;0
13171;ENSG00000214711;CAPN14;2;31395924;31456724;60800;0
13172;ENSG00000214842;RAD51AP2;2;17691851;17699706;7855;1
13173;ENSG00000214944;ARHGEF28;5;72921983;73237818;315835;0
13174;ENSG00000214988;RPL7AP26;4;83411976;83412788;812;0
13175;ENSG00000215012;C22orf29;22;19833661;19842419;8758;0
13176;ENSG00000215032;GNL3LP1;5;60187762;60189404;1642;0
13177;ENSG00000215068;;5;43041677;43045492;3815;0
13178;ENSG00000215158;;5;34164803;34244901;80098;0
13179;ENSG00000215193;PEX26;22;18560689;18613905;53216;0
13180;ENSG00000215196;;5;17130137;17217156;87019;0
13181;ENSG00000215217;C5orf49;5;7830491;7851603;21112;0
13182;ENSG00000215218;UBE2QL1;5;6448736;6495022;46286;0
13183;ENSG00000215246;;5;987295;997423;10128;0
13184;ENSG00000215251;FASTKD5;20;3127165;3140543;13378;0
13185;ENSG00000215305;VPS16;20;2821349;2847378;26029;0
13186;ENSG00000215375;MYL5;4;667369;675822;8453;0
13187;ENSG00000215386;LINC00478;21;17442842;17999716;556874;0
13188;ENSG00000215388;ACTG1P3;20;1141228;1142341;1113;0
13189;ENSG00000215397;SCRT2;20;642240;656823;14583;0
13190;ENSG00000215424;MCM3AP-AS1;21;47649131;47679304;30173;0
13191;ENSG00000215440;NPEPL1;20;57264187;57294294;30107;0
13192;ENSG00000215447;;21;46707967;46711653;3686;0
13193;ENSG00000215452;ZNF663P;20;45042867;45087915;45048;0
13194;ENSG00000215481;BCRP3;22;25028882;25046799;17917;0
13195;ENSG00000215513;PI4KAP1;22;20383524;20427835;44311;0
13196;ENSG00000215559;ANKRD20A11P;21;15281895;15352758;70863;0
13197;ENSG00000215595;C20orf202;20;1184098;1188918;4820;0
13198;ENSG00000215612;HMX1;4;8847802;8873543;25741;0
13199;ENSG00000215630;GUSBP9;5;70435716;70585611;149895;0
13200;ENSG00000217236;SP9;2;175199674;175203220;3546;0
13201;ENSG00000217702;;2;74361599;74362521;922;0
13202;ENSG00000218336;TENM3;4;183065140;183724177;659037;0
13203;ENSG00000218416;;2;241388732;241396131;7399;0
13204;ENSG00000218422;;4;1741078;1743830;2752;0
13205;ENSG00000218537;;22;24236613;24241117;4504;0
13206;ENSG00000218739;CEBPZ-AS1;2;37423631;37443336;19705;0
13207;ENSG00000218891;ZNF579;19;56088899;56092211;3312;0
13208;ENSG00000219438;FAM19A5;22;48885272;49246724;361452;0
13209;ENSG00000219626;FAM228B;2;24299396;24392509;93113;0
13210;ENSG00000220804;;2;243030784;243102304;71520;0
13211;ENSG00000221055;MIR1302-3;2;114340536;114340673;137;0
13212;ENSG00000221211;;3;122645843;122645968;125;0
13213;ENSG00000221319;;20;29637162;29637300;138;0
13214;ENSG00000221413;;3;127383547;127383653;106;0
13215;ENSG00000221531;;2;27804756;27804813;57;0
13216;ENSG00000221598;MIR1249;22;45596835;45596900;65;0
13217;ENSG00000221639;;4;74129677;74129801;124;0
13218;ENSG00000221823;PPP3R1;2;68405989;68483369;77380;0
13219;ENSG00000221843;C2orf16;2;27799389;27805588;6199;0
13220;ENSG00000221883;ARIH2OS;3;48955221;48956818;1597;0
13221;ENSG00000221890;NPTXR;22;39214457;39239987;25530;0
13222;ENSG00000221944;TIGD1;2;233412779;233415226;2447;0
13223;ENSG00000221955;SLC12A8;3;124801480;124998021;196541;0
13224;ENSG00000221990;C5orf55;5;441645;443258;1613;0
13225;ENSG00000222000;;2;98947852;98972468;24616;0
13226;ENSG00000222014;RAB6C;2;130737235;130740311;3076;1
13227;ENSG00000222030;;2;59444843;59506535;61692;0
13228;ENSG00000222035;;2;202978349;202981781;3432;0
13229;ENSG00000222041;LINC00152;2;87754887;87906324;151437;1
13230;ENSG00000222345;;3;52725394;52725469;75;0
13231;ENSG00000222872;RNU4-78P;3;42263332;42263457;125;0
13232;ENSG00000223198;RNU2-22P;2;232366701;232366912;211;0
13233;ENSG00000223249;;2;190618190;190618285;95;0
13234;ENSG00000223361;FTH1P10;5;17353804;17354733;929;0
13235;ENSG00000223431;MTND6P21;21;45892778;45893622;844;0
13236;ENSG00000223461;;22;19109042;19112016;2974;0
13237;ENSG00000223529;EEF1A1P8;3;183744157;183745544;1387;0
13238;ENSG00000223669;;20;61363918;61366699;2781;0
13239;ENSG00000223695;;22;36784671;36792562;7891;0
13240;ENSG00000223704;;22;27254597;27261749;7152;0
13241;ENSG00000223734;;2;20251895;20254257;2362;1
13242;ENSG00000223751;;2;742488;747767;5279;0
13243;ENSG00000223760;MED15P9;2;130887194;130896990;9796;0
13244;ENSG00000223768;LINC00205;21;46713200;46717269;4069;0
13245;ENSG00000223797;ENTPD3-AS1;3;40355293;40494820;139527;0
13246;ENSG00000223812;;3;191275113;191308145;33032;0
13247;ENSG00000223891;OSER1-AS1;20;42839600;42854667;15067;1
13248;ENSG00000223922;ASS1P2;2;39037574;39038796;1222;0
13249;ENSG00000223930;;3;177919838;178103205;183367;0
13250;ENSG00000223935;;2;64622354;64680932;58578;0
13251;ENSG00000223960;;2;179278666;179304970;26304;0
13252;ENSG00000224003;;22;26043228;26045199;1971;1
13253;ENSG00000224043;CCNT2-AS1;2;135493034;135676280;183246;0
13254;ENSG00000224050;;22;32669407;32673173;3766;0
13255;ENSG00000224080;UBE2FP1;3;37185003;37185449;446;0
13256;ENSG00000224086;;22;22292609;22297799;5190;0
13257;ENSG00000224097;;4;39481875;39483525;1650;0
13258;ENSG00000224152;;2;160471807;160473593;1786;0
13259;ENSG00000224165;DNAJC27-AS1;2;25194259;25262563;68304;0
13260;ENSG00000224184;;2;11988748;12718474;729726;0
13261;ENSG00000224287;MSL3P1;2;234774083;234777090;3007;0
13262;ENSG00000224376;;2;232253687;232259702;6015;0
13263;ENSG00000224424;PRKAR2A-AS1;3;48885005;48889414;4409;0
13264;ENSG00000224479;;3;63727969;63813121;85152;0
13265;ENSG00000224514;LINC00620;3;13692196;13788132;95936;0
13266;ENSG00000224635;;20;37034658;37045444;10786;1
13267;ENSG00000224660;SH3BP5-AS1;3;15295691;15306000;10309;1
13268;ENSG00000224728;;3;15919554;15921078;1524;0
13269;ENSG00000224769;;3;195341818;195347104;5286;0
13270;ENSG00000224786;CETN4P;4;123651703;123653348;1645;0
13271;ENSG00000224790;;21;38338812;38344128;5316;0
13272;ENSG00000224831;;3;149699965;149701095;1130;0
13273;ENSG00000224885;TSSC1-IT1;2;3302112;3305236;3124;0
13274;ENSG00000224905;;21;15399742;15516789;117047;0
13275;ENSG00000224928;KRT8P30;2;219818123;219818772;649;0
13276;ENSG00000225138;;5;473351;480999;7648;0
13277;ENSG00000225218;;21;44251150;44256587;5437;0
13278;ENSG00000225330;;21;41002198;41098012;95814;0
13279;ENSG00000225335;;22;18559293;18561650;2357;0
13280;ENSG00000225377;;20;300957;328868;27911;0
13281;ENSG00000225439;BOLA3-AS1;2;74375136;74377188;2052;0
13282;ENSG00000225449;RAB6C-AS1;2;130724165;130738039;13874;0
13283;ENSG00000225465;RFPL1S;22;29832818;29874164;41346;0
13284;ENSG00000225490;;20;29521637;29522987;1350;0
13285;ENSG00000225526;C3orf83;3;12556433;12602558;46125;0
13286;ENSG00000225539;;2;195208993;195284369;75376;0
13287;ENSG00000225555;;21;35743101;35747647;4546;0
13288;ENSG00000225649;;2;13106910;13147138;40228;0
13289;ENSG00000225697;SLC26A6;3;48663156;48672926;9770;0
13290;ENSG00000225724;;22;22693926;22695567;1641;0
13291;ENSG00000225733;FGD5-AS1;3;14961854;14989931;28077;0
13292;ENSG00000225742;;3;193920805;193967942;47137;0
13293;ENSG00000225783;MIAT;22;27042392;27072438;30046;0
13294;ENSG00000225794;;2;217469494;217475925;6431;1
13295;ENSG00000225806;;20;57438583;57463864;25281;0
13296;ENSG00000225822;UBXN7-AS1;3;196158235;196160242;2007;0
13297;ENSG00000225849;MKRN7P;20;45092541;45093763;1222;0
13298;ENSG00000225889;;2;64370373;64479993;109620;0
13299;ENSG00000225892;;4;119553429;119555914;2485;0
13300;ENSG00000225978;HAR1A;20;61733483;61735738;2255;0
13301;ENSG00000226121;AHCTF1P1;2;162357396;162364216;6820;0
13302;ENSG00000226124;FTCDNL1;2;200625267;200715896;90629;0
13303;ENSG00000226239;;20;30615556;30619378;3822;0
13304;ENSG00000226259;GTF2H2B;5;69711179;69743885;32706;0
13305;ENSG00000226266;;2;160527219;160568946;41727;0
13306;ENSG00000226287;TMEM191A;22;21055220;21058894;3674;0
13307;ENSG00000226328;;22;45528901;45559662;30761;1
13308;ENSG00000226340;;2;149629822;149630366;544;1
13309;ENSG00000226360;RPL10AP6;3;61728129;61728780;651;0
13310;ENSG00000226383;;2;156868129;156881125;12996;1
13311;ENSG00000226450;CYP2D8P;22;42545877;42551007;5130;0
13312;ENSG00000226465;;20;25731854;25733397;1543;0
13313;ENSG00000226471;;22;29196671;29244547;47876;0
13314;ENSG00000226479;TMEM185B;2;120978854;120980984;2130;0
13315;ENSG00000226508;;2;105760571;105761882;1311;0
13316;ENSG00000226564;FTH1P20;2;181737594;181738141;547;0
13317;ENSG00000226567;LINC00606;3;10801169;10805877;4708;0
13318;ENSG00000226580;RPL39P40;21;18872997;18873142;145;0
13319;ENSG00000226608;FTLP3;20;4004552;4005091;539;0
13320;ENSG00000226648;;20;39726969;39766643;39674;0
13321;ENSG00000226696;LENG8-AS1;19;54955991;54960223;4232;0
13322;ENSG00000226702;;2;56190326;56274461;84135;0
13323;ENSG00000226741;;22;27706612;27713417;6805;0
13324;ENSG00000226756;;2;64871746;64873832;2086;1
13325;ENSG00000226833;;2;28931819;28959071;27252;0
13326;ENSG00000226853;;2;175352117;175353114;997;0
13327;ENSG00000226856;;2;118889704;118943962;54258;0
13328;ENSG00000226913;BSN-AS2;3;49586739;49591799;5060;0
13329;ENSG00000226950;DANCR;4;53578597;53586518;7921;0
13330;ENSG00000226953;;2;134022540;134042334;19794;0
13331;ENSG00000227028;SLC8A1-AS1;2;40013593;40482349;468756;0
13332;ENSG00000227063;RPL41P1;20;21735866;21736171;305;0
13333;ENSG00000227098;;2;177710721;177714156;3435;0
13334;ENSG00000227110;LMCD1-AS1;3;7994492;8653610;659118;0
13335;ENSG00000227124;ZNF717;3;75758794;75834734;75940;0
13336;ENSG00000227195;MIR663A;20;26167556;26232162;64606;0
13337;ENSG00000227210;;2;20189978;20203971;13993;0
13338;ENSG00000227252;;2;237968077;237994460;26383;0
13339;ENSG00000227256;MIS18A-AS1;21;33650174;33653299;3125;0
13340;ENSG00000227304;;4;83415939;83417431;1492;0
13341;ENSG00000227370;;22;42528550;42529005;455;0
13342;ENSG00000227394;;2;65187187;65187768;581;0
13343;ENSG00000227398;KIF9-AS1;3;47205987;47288091;82104;0
13344;ENSG00000227407;;19;54941832;54945878;4046;0
13345;ENSG00000227456;LINC00310;21;35552978;35562220;9242;0
13346;ENSG00000227470;;2;109494764;109494916;152;0
13347;ENSG00000227542;;2;192093891;192110898;17007;0
13348;ENSG00000227632;;2;130959885;130970201;10316;0
13349;ENSG00000227698;;21;43294865;43297722;2857;0
13350;ENSG00000227745;;2;132890429;132897002;6573;0
13351;ENSG00000227906;SNAP25-AS1;20;10002620;10349424;346804;0
13352;ENSG00000227908;;5;55290995;55299477;8482;0
13353;ENSG00000227946;;2;206949329;206951288;1959;0
13354;ENSG00000227987;;2;98963458;98967603;4145;0
13355;ENSG00000227992;;2;111961541;111963792;2251;1
13356;ENSG00000228016;RAPGEF4-AS1;2;173541869;173600934;59065;0
13357;ENSG00000228043;;2;139175854;139259268;83414;0
13358;ENSG00000228107;;21;37732928;37734338;1410;0
13359;ENSG00000228109;MFI2-AS1;3;196726331;196731615;5284;0
13360;ENSG00000228137;;21;47666804;47667596;792;0
13361;ENSG00000228203;RNF144A-AS1;2;7052408;7058840;6432;0
13362;ENSG00000228206;;2;226562970;226563255;285;0
13363;ENSG00000228214;LINC00693;3;28616282;28799831;183549;0
13364;ENSG00000228242;;3;14186223;14189784;3561;0
13365;ENSG00000228251;;2;113348373;113349516;1143;0
13366;ENSG00000228252;COL6A4P2;3;129931666;129992649;60983;0
13367;ENSG00000228265;;20;32570858;32582163;11305;0
13368;ENSG00000228274;;22;39063590;39077825;14235;1
13369;ENSG00000228315;GUSBP11;22;23980674;24059543;78869;0
13370;ENSG00000228350;;3;48701209;48706607;5398;0
13371;ENSG00000228389;;2;172629992;172632354;2362;0
13372;ENSG00000228400;;2;124774435;124782750;8315;0
13373;ENSG00000228446;;2;225364104;225364817;713;0
13374;ENSG00000228474;OST4;2;27293340;27294641;1301;0
13375;ENSG00000228486;LINC01125;2;98280680;98319527;38847;0
13376;ENSG00000228528;;2;105320216;105321967;1751;0
13377;ENSG00000228638;FCF1P2;3;48332283;48332865;582;0
13378;ENSG00000228643;;2;286419;301515;15096;0
13379;ENSG00000228709;;21;45905460;45910171;4711;0
13380;ENSG00000228766;RPL7L1P8;3;182328462;182329202;740;0
13381;ENSG00000228798;;21;18003146;18013002;9856;0
13382;ENSG00000228817;BACH1-IT2;21;30742944;30746029;3085;0
13383;ENSG00000228857;;2;114588626;114600933;12307;0
13384;ENSG00000228956;;3;18486516;18959184;472668;0
13385;ENSG00000228973;;2;220489781;220491415;1634;0
13386;ENSG00000228989;;2;242629829;242633704;3875;0
13387;ENSG00000229122;AGBL5-IT1;2;27283906;27284683;777;0
13388;ENSG00000229127;;2;210895457;210929080;33623;0
13389;ENSG00000229178;;3;195382436;195384798;2362;0
13390;ENSG00000229267;;2;215674953;215827998;153045;1
13391;ENSG00000229299;;20;62376042;62377311;1269;0
13392;ENSG00000229320;KRT8P12;3;160283235;160287036;3801;0
13393;ENSG00000229325;ACAP2-IT1;3;195001452;195003470;2018;0
13394;ENSG00000229334;;3;194353652;194366130;12478;0
13395;ENSG00000229356;LRRC3-AS1;21;45870869;45875167;4298;0
13396;ENSG00000229385;;2;79720842;79727970;7128;0
13397;ENSG00000229472;;20;32668955;32669754;799;0
13398;ENSG00000229536;;2;130626766;130635126;8360;0
13399;ENSG00000229539;;20;3868886;3869515;629;0
13400;ENSG00000229585;RPL21P44;4;54852754;54853225;471;0
13401;ENSG00000229589;ACVR2B-AS1;3;38492518;38496311;3793;1
13402;ENSG00000229619;MBNL1-AS1;3;151980405;151987344;6939;0
13403;ENSG00000229638;RPL4P4;3;185135283;185136566;1283;0
13404;ENSG00000229692;SOS1-IT1;2;39219420;39220998;1578;0
13405;ENSG00000229727;;2;7561392;7590385;28993;0
13406;ENSG00000229728;;20;1342266;1343229;963;0
13407;ENSG00000229729;;3;88108424;88188123;79699;0
13408;ENSG00000229743;LINC01159;2;105481955;105489053;7098;0
13409;ENSG00000229766;;20;7999870;8024159;24289;0
13410;ENSG00000229816;DDX50P1;2;32426669;32429068;2399;0
13411;ENSG00000229867;STEAP3-AS1;2;120001998;120006647;4649;0
13412;ENSG00000229891;;22;42760406;42765242;4836;0
13413;ENSG00000229920;RPS4XP5;2;63869589;63871172;1583;0
13414;ENSG00000230002;ALMS1-IT1;2;73683891;73686611;2720;0
13415;ENSG00000230006;ANKRD36BP2;2;89065324;89106126;40802;0
13416;ENSG00000230069;LRRC37A15P;4;103648431;103651878;3447;0
13417;ENSG00000230071;RPL4P6;22;40982704;40984007;1303;0
13418;ENSG00000230076;;2;215711852;215712169;317;0
13419;ENSG00000230082;PRRT3-AS1;3;9989088;9996471;7383;0
13420;ENSG00000230090;;2;5758459;5831250;72791;0
13421;ENSG00000230149;;22;39130735;39134995;4260;0
13422;ENSG00000230251;PHBP4;2;155143102;155143938;836;0
13423;ENSG00000230327;;2;50815828;50816553;725;0
13424;ENSG00000230366;DSCR9;21;38580804;38594037;13233;0
13425;ENSG00000230393;;2;100721381;100723966;2585;1
13426;ENSG00000230409;TCEA1P2;3;37317087;37318089;1002;0
13427;ENSG00000230454;;3;50297735;50300790;3055;0
13428;ENSG00000230513;THAP7-AS1;22;21356175;21364631;8456;0
13429;ENSG00000230530;LIMD1-AS1;3;45720535;45730626;10091;0
13430;ENSG00000230552;;2;177588996;177684038;95042;1
13431;ENSG00000230562;FAM133DP;2;158236236;158236926;690;0
13432;ENSG00000230606;;2;98081083;98099107;18024;0
13433;ENSG00000230732;;3;196639821;196641450;1629;0
13434;ENSG00000230772;VN1R108P;20;25714900;25715729;829;0
13435;ENSG00000230783;;2;160545728;160546802;1074;0
13436;ENSG00000230847;;5;70370052;70389020;18968;0
13437;ENSG00000230870;FBXW11P1;21;32999440;33000913;1473;0
13438;ENSG00000230876;LINC00486;2;33050510;33151760;101250;0
13439;ENSG00000230912;;22;39062513;39064755;2242;0
13440;ENSG00000230922;;22;45396446;45399500;3054;0
13441;ENSG00000230964;;2;91766537;91766632;95;0
13442;ENSG00000230979;;2;47917855;47918385;530;0
13443;ENSG00000230992;FAM201B;2;133110240;133112412;2172;0
13444;ENSG00000231015;;20;24660183;24661627;1444;0
13445;ENSG00000231043;;2;58687427;58689167;1740;0
13446;ENSG00000231086;TSSK1A;22;19112392;19113159;767;0
13447;ENSG00000231125;;21;30430394;30432416;2022;0
13448;ENSG00000231160;;4;38614322;38666504;52182;1
13449;ENSG00000231173;;2;741977;749856;7879;0
13450;ENSG00000231177;LINC00852;3;10326103;10327430;1327;0
13451;ENSG00000231213;PLSCR5;3;146294342;146324003;29661;1
13452;ENSG00000231249;ITPR1-AS1;3;4532575;4534847;2272;0
13453;ENSG00000231259;;2;87257800;87303536;45736;0
13454;ENSG00000231290;APCDD1L-AS1;20;57090435;57194944;104509;0
13455;ENSG00000231305;;3;128580156;128590383;10227;0
13456;ENSG00000231307;RPS3P2;20;37166401;37167101;700;0
13457;ENSG00000231312;;2;39663778;39892483;228705;0
13458;ENSG00000231327;;2;70351168;70352449;1281;1
13459;ENSG00000231355;;21;34854806;34856565;1759;0
13460;ENSG00000231431;FAR2P4;2;132046326;132066641;20315;0
13461;ENSG00000231466;;22;25745510;25746289;779;0
13462;ENSG00000231584;FAHD2CP;2;96676299;96689128;12829;1
13463;ENSG00000231646;;2;186648418;186664878;16460;0
13464;ENSG00000231672;DIRC3;2;218148742;218621316;472574;1
13465;ENSG00000231713;;21;41099682;41102607;2925;0
13466;ENSG00000231747;;2;113379386;113379744;358;0
13467;ENSG00000231770;TMEM44-AS1;3;194304740;194310989;6249;0
13468;ENSG00000231890;;2;136742746;136779888;37142;0
13469;ENSG00000231918;;2;51259739;52635055;1375316;0
13470;ENSG00000231934;;20;29558488;29596406;37918;0
13471;ENSG00000231948;HS1BP3-IT1;2;20790535;20792308;1773;0
13472;ENSG00000231969;;2;150443710;150704747;261037;0
13473;ENSG00000232044;LINC01105;2;6072819;6141407;68588;0
13474;ENSG00000232046;;2;66801162;66957289;156127;0
13475;ENSG00000232098;;19;58915605;58919851;4246;0
13476;ENSG00000232112;TMA7;3;48481667;48485616;3949;0
13477;ENSG00000232388;LINC00493;20;18548064;18550207;2143;0
13478;ENSG00000232403;;2;63335253;63335564;311;0
13479;ENSG00000232442;;20;62258580;62260177;1597;0
13480;ENSG00000232479;;2;203789332;203790627;1295;0
13481;ENSG00000232485;;2;217343753;217363484;19731;0
13482;ENSG00000232503;CYCSP8;2;131534219;131534530;311;1
13483;ENSG00000232520;;2;231751215;231761806;10591;0
13484;ENSG00000232528;;20;1748603;1760641;12038;0
13485;ENSG00000232545;;22;24497652;24499317;1665;0
13486;ENSG00000232648;;4;184416091;184425647;9556;0
13487;ENSG00000232710;;22;42532442;42535938;3496;0
13488;ENSG00000232713;;2;61165339;61165739;400;0
13489;ENSG00000232732;;2;200732119;200775882;43763;0
13490;ENSG00000232742;RHOQP2;2;132218533;132219150;617;0
13491;ENSG00000232784;;2;226264426;226265304;878;0
13492;ENSG00000232838;PET117;20;18118517;18123813;5296;0
13493;ENSG00000232855;;21;29811667;30047170;235503;0
13494;ENSG00000232931;LINC00342;2;96472866;96481963;9097;0
13495;ENSG00000232953;HSPA8P18;3;19981761;19984802;3041;0
13496;ENSG00000233058;LINC00884;3;194208183;194239008;30825;0
13497;ENSG00000233087;;2;132118066;132121731;3665;0
13498;ENSG00000233121;VN1R20P;3;13968310;13969275;965;0
13499;ENSG00000233131;;2;176048943;176049335;392;0
13500;ENSG00000233230;;2;48132817;48134949;2132;0
13501;ENSG00000233251;;2;56400669;56412905;12236;0
13502;ENSG00000233266;HMGB1P31;2;54278471;54278897;426;0
13503;ENSG00000233276;GPX1;3;49394609;49396033;1424;0
13504;ENSG00000233280;;3;97540884;97594132;53248;0
13505;ENSG00000233293;;20;31148895;31161690;12795;0
13506;ENSG00000233324;EEF1A1P34;20;18763068;18764334;1266;0
13507;ENSG00000233416;;2;20806040;20806414;374;0
13508;ENSG00000233426;EIF3FP3;2;58478575;58479703;1128;0
13509;ENSG00000233493;TMEM238;19;55890613;55895966;5353;0
13510;ENSG00000233509;ZNF197-AS1;3;44658620;44666289;7669;0
13511;ENSG00000233611;;2;237076090;237203570;127480;0
13512;ENSG00000233639;LINC01158;2;105424030;105469641;45611;0
13513;ENSG00000233654;;2;191399581;191432828;33247;0
13514;ENSG00000233718;MYCNOS;2;16061159;16082371;21212;0
13515;ENSG00000233723;LINC01122;2;58654934;59290901;635967;0
13516;ENSG00000233757;;2;95873283;95881351;8068;0
13517;ENSG00000233762;;2;172373749;172374232;483;0
13518;ENSG00000233806;;2;242823514;243020873;197359;0
13519;ENSG00000233862;;2;30273932;30366670;92738;0
13520;ENSG00000233885;YEATS2-AS1;3;183524245;183528571;4326;0
13521;ENSG00000233895;;20;19738352;19790319;51967;0
13522;ENSG00000234009;RPL5P34;22;43172412;43173302;890;0
13523;ENSG00000234022;;2;15704294;15713992;9698;0
13524;ENSG00000234028;;2;88927057;88931339;4282;0
13525;ENSG00000234072;;2;27579113;27590489;11376;0
13526;ENSG00000234165;;3;26753798;26754855;1057;1
13527;ENSG00000234171;RNASEH1-AS1;2;3606082;3609324;3242;0
13528;ENSG00000234177;LINC01114;2;105363096;105374177;11081;1
13529;ENSG00000234231;;2;88000503;88038766;38263;1
13530;ENSG00000234287;;3;40803036;40803290;254;0
13531;ENSG00000234350;;2;171579719;171627276;47557;0
13532;ENSG00000234353;;22;23980679;23982949;2270;0
13533;ENSG00000234409;;22;20135950;20138399;2449;0
13534;ENSG00000234423;;2;2898820;3129798;230978;0
13535;ENSG00000234492;RPL34-AS1;4;109459346;109541616;82270;0
13536;ENSG00000234572;;2;65073264;65090760;17496;0
13537;ENSG00000234617;SNRK-AS1;3;43391136;43393454;2318;0
13538;ENSG00000234684;SDCBP2-AS1;20;1306049;1359378;53329;1
13539;ENSG00000234690;;2;47419544;47572213;152669;0
13540;ENSG00000234832;;20;23327578;23332123;4545;0
13541;ENSG00000234841;;4;113747463;113748763;1300;0
13542;ENSG00000234851;;3;161146915;161147398;483;0
13543;ENSG00000234869;;22;46937392;46944093;6701;0
13544;ENSG00000234884;;22;25957084;25960429;3345;0
13545;ENSG00000234948;;20;50827184;51266970;439786;0
13546;ENSG00000235023;;21;44068381;44071354;2973;0
13547;ENSG00000235024;;2;219809351;219826625;17274;0
13548;ENSG00000235026;DPP10-AS1;2;115888512;115918920;30408;0
13549;ENSG00000235043;TECRP1;4;87870818;87871276;458;0
13550;ENSG00000235072;;2;25592042;25598714;6672;0
13551;ENSG00000235078;;2;3523046;3526968;3922;0
13552;ENSG00000235091;;22;46271879;46283628;11749;0
13553;ENSG00000235092;;2;8806766;8821993;15227;0
13554;ENSG00000235209;;22;39317232;39320713;3481;0
13555;ENSG00000235217;TSPY26P;20;30774280;30778330;4050;0
13556;ENSG00000235231;;22;24373117;24374043;926;0
13557;ENSG00000235236;;3;49017351;49021418;4067;0
13558;ENSG00000235257;;3;37786923;37903271;116348;0
13559;ENSG00000235313;HM13-IT1;20;30150969;30151879;910;0
13560;ENSG00000235369;RPL36AP15;2;48024965;48025230;265;0
13561;ENSG00000235374;SSR4P1;21;46491648;46494080;2432;0
13562;ENSG00000235408;SNORA71B;20;37053843;37053979;136;0
13563;ENSG00000235478;;22;17602476;17612994;10518;0
13564;ENSG00000235499;;2;74212259;74213470;1211;0
13565;ENSG00000235513;;22;41605126;41613631;8505;0
13566;ENSG00000235568;NFAM1;22;42776416;42828401;51985;0
13567;ENSG00000235597;LINC01102;2;105049725;105137290;87565;1
13568;ENSG00000235609;;21;16191164;16254296;63132;0
13569;ENSG00000235655;H3F3AP4;2;175584505;175585526;1021;0
13570;ENSG00000235701;PCBP2P1;21;40543056;40544032;976;0
13571;ENSG00000235760;;2;47754676;47762338;7662;0
13572;ENSG00000235770;LINC00607;2;216476286;216708445;232159;0
13573;ENSG00000235776;;22;19779817;19780617;800;0
13574;ENSG00000235779;;2;305111;314367;9256;0
13575;ENSG00000235831;BHLHE40-AS1;3;4938493;5021646;83153;0
13576;ENSG00000235878;;21;47612391;47613673;1282;0
13577;ENSG00000235888;;21;40360633;40378079;17446;0
13578;ENSG00000235890;TSPEAR-AS1;21;45926690;45935738;9048;0
13579;ENSG00000235897;TM4SF19-AS1;3;196045201;196052441;7240;0
13580;ENSG00000235934;;2;171672803;171674547;1744;0
13581;ENSG00000235949;;2;155552974;155554329;1355;0
13582;ENSG00000235954;TTC28-AS1;22;28315364;28404569;89205;0
13583;ENSG00000235989;MORC2-AS1;22;31318295;31328436;10141;0
13584;ENSG00000235997;;2;30569525;30575297;5772;0
13585;ENSG00000236047;;2;203385124;203385712;588;0
13586;ENSG00000236106;;2;5866581;5870474;3893;0
13587;ENSG00000236204;;2;19167729;19546509;378780;0
13588;ENSG00000236255;;2;118591513;118599234;7721;0
13589;ENSG00000236296;GUSBP5;4;144480625;144570458;89833;0
13590;ENSG00000236297;;3;193296601;193310879;14278;0
13591;ENSG00000236352;;20;52556699;52559047;2348;1
13592;ENSG00000236397;DDX11L2;2;114356606;114359144;2538;0
13593;ENSG00000236411;NDUFAF4P3;3;37831412;37831936;524;0
13594;ENSG00000236432;;2;228085768;228189917;104149;0
13595;ENSG00000236438;FAM157A;3;197879237;197925886;46649;0
13596;ENSG00000236474;GCNT1P1;20;18400804;18402098;1294;0
13597;ENSG00000236501;;2;177855236;178029244;174008;1
13598;ENSG00000236519;;21;46222492;46224632;2140;0
13599;ENSG00000236611;;22;23668803;23670680;1877;0
13600;ENSG00000236670;KRT18P5;22;20837102;20838392;1290;0
13601;ENSG00000236682;;2;128146706;128158156;11450;0
13602;ENSG00000236695;HNRNPA1P47;2;195052103;195053033;930;0
13603;ENSG00000236780;;2;67350489;67442451;91962;0
13604;ENSG00000236794;BCRP8;22;23522058;23522465;407;0
13605;ENSG00000236824;BCYRN1;2;47558199;47571656;13457;0
13606;ENSG00000236830;CBR3-AS1;21;37504065;37528615;24550;0
13607;ENSG00000236850;BMS1P20;22;22657589;22677203;19614;0
13608;ENSG00000236858;;22;27444106;27456480;12374;0
13609;ENSG00000236859;NIFK-AS1;2;122407226;122485784;78558;0
13610;ENSG00000236869;;3;44598849;44727145;128296;0
13611;ENSG00000236941;;4;165869231;165899980;30749;0
13612;ENSG00000237037;NDUFA6-AS1;22;42486935;42535286;48351;0
13613;ENSG00000237133;;2;33780114;33788614;8500;0
13614;ENSG00000237194;SNAI1P1;2;210673528;210674304;776;0
13615;ENSG00000237232;ZNF295-AS1;21;43429303;43445060;15757;0
13616;ENSG00000237260;;2;177203365;177203805;440;0
13617;ENSG00000237298;TTN-AS1;2;179385910;179639402;253492;0
13618;ENSG00000237350;CDC42P6;4;22728998;22729573;575;0
13619;ENSG00000237418;;3;196024932;196025086;154;1
13620;ENSG00000237438;CECR7;22;17517460;17541715;24255;0
13621;ENSG00000237474;;2;90512495;90512771;276;0
13622;ENSG00000237517;DGCR5;22;18958027;19018755;60728;0
13623;ENSG00000237522;NONOP2;2;61163954;61165184;1230;0
13624;ENSG00000237594;;21;32931558;32932800;1242;0
13625;ENSG00000237667;LINC01115;2;779837;864112;84275;0
13626;ENSG00000237689;;22;17350368;17352016;1648;0
13627;ENSG00000237697;LINC00312;3;8613468;8615561;2093;0
13628;ENSG00000237732;;2;223182994;223217708;34714;0
13629;ENSG00000237737;DCTN1-AS1;2;74612613;74621009;8396;0
13630;ENSG00000237753;;2;113399409;113403267;3858;0
13631;ENSG00000237765;FAM200B;4;15683285;15707188;23903;0
13632;ENSG00000237838;;3;24729410;25215796;486386;0
13633;ENSG00000237877;;2;186897618;186947960;50342;0
13634;ENSG00000237892;KLF7-IT1;2;207985608;207986768;1160;0
13635;ENSG00000237940;;2;242912834;242919427;6593;0
13636;ENSG00000237945;LINC00649;21;35287838;35349992;62154;0
13637;ENSG00000237961;;4;49239116;49247436;8320;0
13638;ENSG00000237977;EIF4HP2;22;31298206;31298768;562;0
13639;ENSG00000237978;;3;178244293;178578193;333900;0
13640;ENSG00000238057;ZEB2-AS1;2;145275664;145279058;3394;0
13641;ENSG00000238082;;2;179319443;179320155;712;0
13642;ENSG00000238151;MLLT10P1;20;29637799;29638060;261;0
13643;ENSG00000238180;;2;128975162;128975646;484;0
13644;ENSG00000238197;PAXBP1-AS1;21;34100426;34115433;15007;0
13645;ENSG00000238207;;2;118515139;118561750;46611;0
13646;ENSG00000238250;ST6GAL2-IT1;2;107439379;107441487;2108;0
13647;ENSG00000238390;;21;33036619;33036795;176;0
13648;ENSG00000238465;;2;70139827;70139931;104;0
13649;ENSG00000238910;;22;32349391;32349493;102;0
13650;ENSG00000239040;;4;56278803;56278905;102;0
13651;ENSG00000239122;RNU2-11P;3;195655460;195655646;186;0
13652;ENSG00000239127;SNORD125;22;29729152;29729247;95;0
13653;ENSG00000239213;;3;136560568;136580896;20328;0
13654;ENSG00000239219;;3;169657141;169684522;27381;1
13655;ENSG00000239268;;3;117391001;117716439;325438;0
13656;ENSG00000239300;;2;9645574;9652541;6967;0
13657;ENSG00000239305;RNF103;2;86830516;86850989;20473;0
13658;ENSG00000239332;LINC01119;2;47043836;47086146;42310;0
13659;ENSG00000239402;CYP4F62P;2;131187400;131199048;11648;0
13660;ENSG00000239415;;21;47671463;47674047;2584;0
13661;ENSG00000239445;ST3GAL6-AS1;3;98433174;98451495;18321;0
13662;ENSG00000239455;;3;106823758;106825847;2089;0
13663;ENSG00000239462;;3;98621268;98737406;116138;0
13664;ENSG00000239467;;2;171627623;171634658;7035;0
13665;ENSG00000239474;KLHL41;2;170366212;170382772;16560;0
13666;ENSG00000239523;MYLK-AS1;3;123304389;123363415;59026;0
13667;ENSG00000239557;;3;52407668;52408898;1230;0
13668;ENSG00000239605;C2orf61;2;47272677;47382517;109840;0
13669;ENSG00000239653;PSMD6-AS2;3;63989698;63997824;8126;0
13670;ENSG00000239677;PDZRN3-AS1;3;73670864;73675149;4285;0
13671;ENSG00000239779;WBP1;2;74685456;74688018;2562;0
13672;ENSG00000239899;RN7SL674P;2;11724899;11725176;277;0
13673;ENSG00000239900;ADSL;22;40742507;40786467;43960;0
13674;ENSG00000239922;;3;147657791;147724542;66751;0
13675;ENSG00000240024;LINC00888;3;183165396;183173801;8405;0
13676;ENSG00000240045;;3;155008018;155011564;3546;1
13677;ENSG00000240057;;3;112738379;112902148;163769;0
13678;ENSG00000240086;;3;135074909;135158730;83821;0
13679;ENSG00000240137;;3;150421351;150437933;16582;0
13680;ENSG00000240207;;3;158450052;158501859;51807;0
13681;ENSG00000240225;ZNF542;19;56879468;56891197;11729;0
13682;ENSG00000240288;GHRLOS;3;10327438;10335133;7695;0
13683;ENSG00000240303;ACAD11;3;132276982;132379567;102585;0
13684;ENSG00000240344;PPIL3;2;201735630;201754026;18396;0
13685;ENSG00000240356;RPL23AP7;2;114368079;114384667;16588;0
13686;ENSG00000240393;;3;117393189;117393991;802;0
13687;ENSG00000240429;LRRFIP1P1;3;178976816;178979061;2245;0
13688;ENSG00000240455;RN7SL671P;4;1870787;1871064;277;0
13689;ENSG00000240489;SETP14;3;155705093;155705965;872;0
13690;ENSG00000240682;ISY1;3;128846258;128880136;33878;0
13691;ENSG00000240761;;2;203638443;203639083;640;0
13692;ENSG00000240849;TMEM189;20;48697663;48770335;72672;0
13693;ENSG00000240857;RDH14;2;18735989;18741946;5957;0
13694;ENSG00000240875;LINC00886;3;156465135;156534851;69716;0
13695;ENSG00000240891;PLCXD2;3;111393523;111565294;171771;0
13696;ENSG00000240906;;22;25047814;25048364;550;0
13697;ENSG00000240935;PLGLA;2;106998562;107010027;11465;0
13698;ENSG00000240972;MIF;22;24236191;24237414;1223;0
13699;ENSG00000241155;ARHGAP31-AS1;3;119033140;119041607;8467;0
13700;ENSG00000241163;LINC00877;3;72084451;72291716;207265;0
13701;ENSG00000241278;ENPP7P4;3;125567066;125628215;61149;0
13702;ENSG00000241288;;3;125546081;125607918;61837;1
13703;ENSG00000241313;WWTR1-AS1;3;149374807;149379151;4344;0
13704;ENSG00000241316;;3;67705121;67998137;293016;0
13705;ENSG00000241469;LINC00635;3;107559075;107600847;41772;1
13706;ENSG00000241472;PTPRG-AS1;3;62246540;62355005;108465;0
13707;ENSG00000241484;ARHGAP8;22;45098355;45258665;160310;0
13708;ENSG00000241490;;3;113933160;113955051;21891;0
13709;ENSG00000241506;PSMC1P1;3;68684856;68686175;1319;0
13710;ENSG00000241520;;2;217347755;217351919;4164;0
13711;ENSG00000241527;CA15P1;22;19019077;19022077;3000;0
13712;ENSG00000241528;;22;30770930;30773862;2932;0
13713;ENSG00000241532;AGGF1P3;3;75702712;75703924;1212;1
13714;ENSG00000241553;ARPC4;3;9834179;9849410;15231;0
13715;ENSG00000241570;;3;142681796;142720401;38605;0
13716;ENSG00000241634;;3;108262214;108262722;508;0
13717;ENSG00000241679;;3;142842204;142850735;8531;0
13718;ENSG00000241684;ADAMTS9-AS2;3;64670585;64997143;326558;0
13719;ENSG00000241732;;3;152557179;152559228;2049;0
13720;ENSG00000241770;;3;156881241;156886922;5681;0
13721;ENSG00000241829;RPL21P54;5;34883162;34883625;463;0
13722;ENSG00000241837;ATP5O;21;35275757;35288284;12527;0
13723;ENSG00000241878;PISD;22;32014477;32058418;43941;0
13724;ENSG00000241889;;3;113604145;113604878;733;0
13725;ENSG00000241945;PWP2;21;45527171;45551063;23892;0
13726;ENSG00000241962;C2orf15;2;99757948;99939204;181256;0
13727;ENSG00000241973;PI4KA;22;21061979;21213705;151726;0
13728;ENSG00000241990;;22;46449585;46453090;3505;1
13729;ENSG00000242082;;22;32601102;32665653;64551;0
13730;ENSG00000242083;RPL7AP31;4;57222301;57223098;797;0
13731;ENSG00000242086;LINC00969;3;195384933;195460422;75489;0
13732;ENSG00000242094;FOXP1-IT1;3;71619406;71623608;4202;0
13733;ENSG00000242110;AMACR;5;33986283;34008220;21937;0
13734;ENSG00000242220;TCP10L;21;33948862;33959683;10821;0
13735;ENSG00000242242;PVRL3-AS1;3;110612555;110790400;177845;0
13736;ENSG00000242247;ARFGAP3;22;43192508;43254112;61604;0
13737;ENSG00000242259;C22orf39;22;19338891;19435755;96864;0
13738;ENSG00000242268;;3;168621154;168639784;18630;0
13739;ENSG00000242282;;2;3579403;3584463;5060;0
13740;ENSG00000242299;;3;101295333;101295791;458;0
13741;ENSG00000242337;TFP1;3;133380842;133473420;92578;0
13742;ENSG00000242372;EIF6;20;33866714;33872788;6074;0
13743;ENSG00000242390;RPL6P9;3;142299752;142301241;1489;0
13744;ENSG00000242479;;3;142168944;142170991;2047;1
13745;ENSG00000242516;LINC00960;3;75721542;75728454;6912;0
13746;ENSG00000242539;;3;179114749;179116979;2230;0
13747;ENSG00000242540;;2;5836352;5848227;11875;0
13748;ENSG00000242551;POU5F1P6;3;128393578;128395848;2270;0
13749;ENSG00000242575;;2;154277191;154278471;1280;1
13750;ENSG00000242622;;3;119813742;119855630;41888;0
13751;ENSG00000242628;;2;24437250;24444385;7135;0
13752;ENSG00000242748;RPL23AP81;20;39825331;39825797;466;0
13753;ENSG00000242759;LINC00882;3;106555658;106959488;403830;0
13754;ENSG00000242791;;3;149694542;149697142;2600;0
13755;ENSG00000242797;GLYCTK-AS1;3;52322599;52333083;10484;0
13756;ENSG00000242808;SOX2-OT;3;180707558;181554668;847110;0
13757;ENSG00000242828;;3;80810193;80838114;27921;0
13758;ENSG00000243069;ARHGEF26-AS1;3;153742190;153839121;96931;0
13759;ENSG00000243147;MRPL33;2;27994584;28210954;216370;0
13760;ENSG00000243156;MICAL3;22;18270415;18507325;236910;0
13761;ENSG00000243176;;3;156893012;157099054;206042;0
13762;ENSG00000243199;;4;66439177;66440046;869;0
13763;ENSG00000243224;;3;52273274;52275113;1839;0
13764;ENSG00000243244;STON1;2;48756522;48826025;69503;0
13765;ENSG00000243389;;2;113346617;113372008;25391;1
13766;ENSG00000243422;;3;75673837;75674304;467;0
13767;ENSG00000243449;C4orf48;4;2043689;2045697;2008;0
13768;ENSG00000243477;NAT6;3;50333833;50336852;3019;0
13769;ENSG00000243620;;3;146627472;147088443;460971;0
13770;ENSG00000243646;IL10RB;21;34638663;34669539;30876;0
13771;ENSG00000243667;WDR92;2;68350068;68384692;34624;0
13772;ENSG00000243694;;3;81043019;81144798;101779;0
13773;ENSG00000243696;;3;52847298;52869745;22447;1
13774;ENSG00000243701;LINC00883;3;106959539;107045811;86272;0
13775;ENSG00000243819;RN7SL832P;2;10830470;10832225;1755;0
13776;ENSG00000243902;;22;37735624;37823480;87856;0
13777;ENSG00000243926;TIPARP-AS1;3;156389651;156392167;2516;0
13778;ENSG00000243927;MRPS6;21;35445524;35515334;69810;0
13779;ENSG00000243943;ZNF512;2;27805897;27858041;52144;0
13780;ENSG00000243989;ACY1;3;52009066;52023213;14147;1
13781;ENSG00000244005;NFS1;20;34255977;34287281;31304;0
13782;ENSG00000244026;FAM86DP;3;75470703;75484261;13558;0
13783;ENSG00000244040;IL12A-AS1;3;159631189;159943086;311897;0
13784;ENSG00000244063;;2;114586967;114588696;1729;0
13785;ENSG00000244119;PDCL3P4;3;101431316;101432035;719;0
13786;ENSG00000244128;;3;164924748;165373211;448463;0
13787;ENSG00000244227;;3;167613736;167641799;28063;0
13788;ENSG00000244274;DBNDD2;20;44034697;44039250;4553;0
13789;ENSG00000244327;;3;142184157;142191179;7022;0
13790;ENSG00000244357;RN7SL145P;3;45784167;45784460;293;0
13791;ENSG00000244405;ETV5;3;185764097;185828107;64010;0
13792;ENSG00000244462;RBM12;20;34236847;34252878;16031;0
13793;ENSG00000244486;SCARF2;22;20778874;20792146;13272;0
13794;ENSG00000244509;APOBEC3C;22;39410088;39416357;6269;0
13795;ENSG00000244558;;20;43323533;43374662;51129;0
13796;ENSG00000244567;;2;208686014;208687493;1479;0
13797;ENSG00000244607;CCDC13;3;42734155;42814745;80590;0
13798;ENSG00000244617;ASPRV1;2;70187226;70189397;2171;0
13799;ENSG00000244625;;22;27068730;27176170;107440;0
13800;ENSG00000244627;;22;38731767;38794934;63167;0
13801;ENSG00000244671;RN7SL280P;22;22077172;22077471;299;0
13802;ENSG00000244687;UBE2V1;20;48697661;48732496;34835;0
13803;ENSG00000244723;ASLP1;22;23991400;23995521;4121;0
13804;ENSG00000244968;LIFR-AS1;5;38556888;38671318;114430;0
13805;ENSG00000245112;SMARCA5-AS1;4;144434625;144435788;1163;0
13806;ENSG00000245213;;4;174053079;174090803;37724;0
13807;ENSG00000245384;;4;105412122;105618749;206627;0
13808;ENSG00000245685;;4;190701490;190861426;159936;0
13809;ENSG00000245958;;4;120375946;120473180;97234;0
13810;ENSG00000246090;;4;100010008;100222513;212505;0
13811;ENSG00000246375;;4;89206094;89252573;46479;0
13812;ENSG00000246560;;4;103749212;103765232;16020;0
13813;ENSG00000247516;MIR4458HG;5;8450856;8463208;12352;0
13814;ENSG00000247596;TWF2;3;52262626;52273276;10650;0
13815;ENSG00000247624;CPEB2-AS1;4;14911585;15003669;92084;0
13816;ENSG00000247626;MARS2;2;198570087;198573113;3026;0
13817;ENSG00000247708;STX18-AS1;4;4543858;4712665;168807;0
13818;ENSG00000247775;;4;90757559;90763129;5570;0
13819;ENSG00000247796;;5;52405672;52410956;5284;0
13820;ENSG00000247950;SEC24B-AS1;4;110268631;110354973;86342;0
13821;ENSG00000248019;FAM13A-AS1;4;89630940;89651254;20314;1
13822;ENSG00000248049;UBA6-AS1;4;68566998;68946670;379672;0
13823;ENSG00000248092;NNT-AS1;5;43571696;43603332;31636;0
13824;ENSG00000248150;;5;16373470;16440190;66720;0
13825;ENSG00000248161;;4;103339759;103371167;31408;0
13826;ENSG00000248174;;4;175015811;175141549;125738;0
13827;ENSG00000248206;;4;184908831;184909903;1072;1
13828;ENSG00000248215;;4;36498159;36643522;145363;0
13829;ENSG00000248240;;5;43515376;43525412;10036;0
13830;ENSG00000248280;;4;120361716;120371312;9596;0
13831;ENSG00000248283;;4;42563474;42564442;968;0
13832;ENSG00000248313;CYP4F27P;2;130805999;130807013;1014;0
13833;ENSG00000248360;LINC00504;4;14472089;14889793;417704;0
13834;ENSG00000248371;;5;71869947;71956496;86549;0
13835;ENSG00000248405;PRR5-ARHGAP8;22;45098113;45258586;160473;0
13836;ENSG00000248476;BACH1-IT1;21;30723955;30734215;10260;0
13837;ENSG00000248479;;4;66567920;66571271;3351;0
13838;ENSG00000248487;ABHD14A;3;52005442;52015212;9770;0
13839;ENSG00000248587;GDNF-AS1;5;37840540;37875901;35361;0
13840;ENSG00000248632;;4;165889739;165891154;1415;0
13841;ENSG00000248664;;5;68408939;68432221;23282;0
13842;ENSG00000248668;OXCT1-AS1;5;41870132;41871059;927;0
13843;ENSG00000248677;;5;6686438;6707824;21386;0
13844;ENSG00000248698;LINC01085;4;14113592;14141676;28084;0
13845;ENSG00000248713;;4;100557686;100575805;18119;0
13846;ENSG00000248719;;4;81104434;81111323;6889;0
13847;ENSG00000248724;NPHP3-AS1;3;132440594;132593067;152473;0
13848;ENSG00000248774;;4;174243357;174250845;7488;0
13849;ENSG00000248787;;3;125626848;125629115;2267;0
13850;ENSG00000248840;;4;3314239;3314785;546;0
13851;ENSG00000248863;;4;140347453;140352038;4585;0
13852;ENSG00000248866;USP46-AS1;4;53525573;53527835;2262;0
13853;ENSG00000248890;HHIP-AS1;4;145564074;145582509;18435;0
13854;ENSG00000248925;;5;269973;271631;1658;0
13855;ENSG00000248932;;3;139108657;139302161;193504;0
13856;ENSG00000248971;KRT8P46;4;103649903;103651328;1425;0
13857;ENSG00000249006;;4;2090445;2092344;1899;0
13858;ENSG00000249085;;5;72090232;72112392;22160;0
13859;ENSG00000249096;;4;185286336;185303460;17124;0
13860;ENSG00000249159;;5;8387751;8457677;69926;0
13861;ENSG00000249212;ATP1B1P1;4;42031226;42032140;914;0
13862;ENSG00000249241;;4;40318502;40332436;13934;0
13863;ENSG00000249242;TMEM150C;4;83404323;83483510;79187;0
13864;ENSG00000249274;PDLIM1P4;3;98501032;98502037;1005;0
13865;ENSG00000249286;;5;43587020;43588325;1305;0
13866;ENSG00000249307;LINC01088;4;79892902;80229952;337050;0
13867;ENSG00000249348;UGDH-AS1;4;39529639;39596327;66688;0
13868;ENSG00000249359;;5;21323982;21341484;17502;0
13869;ENSG00000249413;;4;66864564;67015730;151166;0
13870;ENSG00000249425;;4;161460406;161507969;47563;0
13871;ENSG00000249430;;5;92266;139978;47712;0
13872;ENSG00000249437;NAIP;5;70264310;70320941;56631;0
13873;ENSG00000249464;LINC01091;4;124571422;124851561;280139;1
13874;ENSG00000249465;RBMXP4;4;110267482;110268615;1133;0
13875;ENSG00000249471;ZNF324B;19;58962971;58969200;6229;0
13876;ENSG00000249509;;4;113436541;113468037;31496;0
13877;ENSG00000249572;;5;33424131;33440725;16594;0
13878;ENSG00000249592;;4;756175;775637;19462;0
13879;ENSG00000249635;;4;106924474;106943635;19161;0
13880;ENSG00000249650;;5;602735;612325;9590;0
13881;ENSG00000249661;TNRC18P1;4;141562994;141566643;3649;0
13882;ENSG00000249673;NOP14-AS1;4;2936626;2963465;26839;0
13883;ENSG00000249679;;4;186392670;186393417;747;0
13884;ENSG00000249685;;4;39135533;39137228;1695;1
13885;ENSG00000249690;;4;151500241;151502697;2456;0
13886;ENSG00000249700;SRD5A3-AS1;4;56230138;56262014;31876;0
13887;ENSG00000249715;FER1L5;2;97308474;97370624;62150;0
13888;ENSG00000249755;;4;89448311;89449321;1010;0
13889;ENSG00000249846;;3;129831393;129839422;8029;0
13890;ENSG00000249855;EEF1A1P19;5;43495175;43496556;1381;0
13891;ENSG00000249863;;4;37869913;37871599;1686;1
13892;ENSG00000249896;;4;6202460;6240044;37584;0
13893;ENSG00000249908;;5;767512;769046;1534;0
13894;ENSG00000249915;PDCD6;5;271736;353971;82235;0
13895;ENSG00000249923;;22;20186252;20192441;6189;0
13896;ENSG00000249934;;4;89429742;89431554;1812;0
13897;ENSG00000249936;RAC1P2;4;46725793;46726625;832;0
13898;ENSG00000249937;;5;17684693;17955966;271273;0
13899;ENSG00000249992;TMEM158;3;45265958;45267770;1812;0
13900;ENSG00000250012;;3;125803063;125814192;11129;0
13901;ENSG00000250033;SLC7A11-AS1;4;138978618;139099331;120713;0
13902;ENSG00000250056;LINC01018;5;6582249;6588612;6363;0
13903;ENSG00000250075;;4;68283023;68333969;50946;0
13904;ENSG00000250131;;4;178366133;178598280;232147;0
13905;ENSG00000250174;MYLK-AS2;3;123408491;123411254;2763;0
13906;ENSG00000250182;EEF1A1P13;5;14652047;14653438;1391;0
13907;ENSG00000250220;;4;74124926;74183670;58744;0
13908;ENSG00000250241;;4;133996466;134070271;73805;0
13909;ENSG00000250312;ZNF718;4;124386;157779;33393;0
13910;ENSG00000250317;SMIM20;4;25863452;25931435;67983;0
13911;ENSG00000250318;;22;31049864;31050801;937;0
13912;ENSG00000250325;IGBP1P4;4;83322731;83323609;878;0
13913;ENSG00000250326;;4;143854348;144106014;251666;0
13914;ENSG00000250327;;4;187079050;187079997;947;0
13915;ENSG00000250334;LINC00989;4;80413570;80497614;84044;1
13916;ENSG00000250337;LINC01021;5;27472399;27496508;24109;1
13917;ENSG00000250410;;4;186291879;186312082;20203;0
13918;ENSG00000250412;KLHL2P1;4;120255484;120299388;43904;0
13919;ENSG00000250415;;5;16617334;16621385;4051;0
13920;ENSG00000250439;FGD5P1;3;13974553;13978977;4424;0
13921;ENSG00000250461;;5;60670939;60671682;743;0
13922;ENSG00000250479;CHCHD10;22;24108021;24110630;2609;0
13923;ENSG00000250486;FAM218A;4;165878100;165880273;2173;0
13924;ENSG00000250490;;5;6310554;6339997;29443;0
13925;ENSG00000250522;;4;106461347;106473512;12165;0
13926;ENSG00000250538;;4;156127681;156130179;2498;0
13927;ENSG00000250565;ATP6V1E2;2;46717889;46769696;51807;0
13928;ENSG00000250579;;5;5132893;5140167;7274;0
13929;ENSG00000250588;IQCJ-SCHIP1;3;158680024;159615155;935131;1
13930;ENSG00000250608;;3;131043936;131100319;56383;0
13931;ENSG00000250722;SEPP1;5;42799982;42887494;87512;0
13932;ENSG00000250726;;4;184993556;184994192;636;0
13933;ENSG00000250753;;4;49581850;49582206;356;0
13934;ENSG00000250764;;5;32103551;32122047;18496;0
13935;ENSG00000250786;SNHG18;5;9546312;9550721;4409;0
13936;ENSG00000250796;;3;128588467;128588869;402;0
13937;ENSG00000250829;;4;187812123;187813520;1397;0
13938;ENSG00000250846;;4;66535679;66563747;28068;0
13939;ENSG00000250889;;5;74343544;74348668;5124;0
13940;ENSG00000250934;;3;125985639;126010122;24483;0
13941;ENSG00000250938;;4;120988113;121337921;349808;0
13942;ENSG00000250950;;4;120377505;120378432;927;0
13943;ENSG00000251022;THAP9-AS1;4;83814162;83822113;7951;0
13944;ENSG00000251131;;5;43018531;43024349;5818;0
13945;ENSG00000251141;;5;44745002;44808879;63877;0
13946;ENSG00000251155;;4;119561828;119562013;185;0
13947;ENSG00000251165;F11-AS1;4;187207248;187422151;214903;0
13948;ENSG00000251173;UCHL1-AS1;4;41222091;41258744;36653;0
13949;ENSG00000251259;;4;106058437;106061776;3339;0
13950;ENSG00000251279;;5;60457897;60527867;69970;0
13951;ENSG00000251298;;4;148530703;148538396;7693;0
13952;ENSG00000251322;SHANK3;22;51112843;51171726;58883;0
13953;ENSG00000251331;;4;82523951;82965397;441446;0
13954;ENSG00000251333;RTN3P1;4;146296695;146297405;710;0
13955;ENSG00000251369;ZNF550;19;58046625;58071231;24606;0
13956;ENSG00000251432;;4;129213906;129440549;226643;0
13957;ENSG00000251442;LINC01094;4;79567057;79603853;36796;0
13958;ENSG00000251474;RPL32P3;3;129101765;129118498;16733;0
13959;ENSG00000251485;;2;233207826;233208613;787;0
13960;ENSG00000251535;;4;330047;330575;528;0
13961;ENSG00000251577;;4;104469902;104545691;75789;0
13962;ENSG00000251580;;4;6672452;6675557;3105;0
13963;ENSG00000251595;ABCA11P;4;419224;467918;48694;0
13964;ENSG00000251613;;5;71982939;72058554;75615;1
13965;ENSG00000251615;;4;8356817;8360065;3248;0
13966;ENSG00000251634;;5;70398725;70424580;25855;0
13967;ENSG00000251669;FAM86EP;4;3943487;3957146;13659;0
13968;ENSG00000251739;RNU6-1053P;4;184627084;184627184;100;0
13969;ENSG00000251787;RNU7-47P;3;142520049;142520110;61;0
13970;ENSG00000252414;RNU6-100P;2;64806026;64806131;105;0
13971;ENSG00000252473;;2;39510798;39510932;134;0
13972;ENSG00000252620;RNU6ATAC24P;3;195249885;195250019;134;0
13973;ENSG00000252768;RNU6-856P;3;52585862;52585959;97;0
13974;ENSG00000252892;RNU6-548P;2;65221880;65221994;114;1
13975;ENSG00000253092;;3;183170355;183170552;197;0
13976;ENSG00000253203;GUSBP3;5;68790040;69006341;216301;0
13977;ENSG00000253251;;5;64920592;64926718;6126;0
13978;ENSG00000253352;TUG1;22;31366663;31375381;8718;0
13979;ENSG00000253540;FAM86HP;3;129817935;129830315;12380;1
13980;ENSG00000253559;OSGEPL1-AS1;2;190627430;190630282;2852;0
13981;ENSG00000253816;;5;69515745;69580686;64941;0
13982;ENSG00000254353;;5;70328995;70330227;1232;0
13983;ENSG00000254531;;4;102268937;102270040;1103;0
13984;ENSG00000254535;PABPC4L;4;135117488;135122903;5415;0
13985;ENSG00000254701;;5;69435402;69503572;68170;0
13986;ENSG00000254995;STX16-NPEPL1;20;57226490;57290466;63976;0
13987;ENSG00000254999;BRK1;3;10157276;10168874;11598;0
13988;ENSG00000255156;KLHL22-IT1;22;20829490;20829598;108;0
13989;ENSG00000255423;EBLN2;3;73110810;73112488;1678;0
13990;ENSG00000255458;;4;39640760;39668264;27504;0
13991;ENSG00000255735;;2;241390181;241391848;1667;0
13992;ENSG00000255989;;2;74213653;74220867;7214;0
13993;ENSG00000256043;CTSO;4;156845270;156875069;29799;0
13994;ENSG00000256060;TRAPPC2P1;19;57874879;57876721;1842;0
13995;ENSG00000256073;C21orf119;21;33765439;33766254;815;0
13996;ENSG00000256628;ZBTB11-AS1;3;101395274;101398061;2787;0
13997;ENSG00000257135;;2;10588820;10591453;2633;0
13998;ENSG00000257207;;2;111160511;111230652;70141;0
13999;ENSG00000257800;FNBP1P1;2;74347807;74350345;2538;0
14000;ENSG00000258366;RTEL1;20;62289163;62328416;39253;0
14001;ENSG00000258984;UBE2F-SCLY;2;238875656;239008053;132397;0
14002;ENSG00000259456;;20;49547521;49561671;14150;0
14003;ENSG00000259802;;5;10352813;10353713;900;0
14004;ENSG00000259863;SH3RF3-AS1;2;109743783;109745386;1603;0
14005;ENSG00000259959;;4;47842139;47846356;4217;0
14006;ENSG00000259976;;3;114033348;114035026;1678;0
14007;ENSG00000260006;;2;201689396;201692061;2665;0
14008;ENSG00000260025;;2;36581892;36582257;365;0
14009;ENSG00000260032;LINC00657;20;34633544;34638882;5338;0
14010;ENSG00000260065;;22;26917949;26921002;3053;0
14011;ENSG00000260077;;2;10179219;10180790;1571;0
14012;ENSG00000260091;;4;120330488;120331388;900;0
14013;ENSG00000260101;;2;64749321;64751227;1906;1
14014;ENSG00000260142;;2;194763091;194764118;1027;0
14015;ENSG00000260163;;2;127782787;127787262;4475;0
14016;ENSG00000260236;;3;47420579;47422489;1910;0
14017;ENSG00000260244;;4;156655600;156658214;2614;0
14018;ENSG00000260257;;20;31444848;31446557;1709;0
14019;ENSG00000260261;;3;195676059;195679566;3507;0
14020;ENSG00000260296;;4;40168295;40169451;1156;0
14021;ENSG00000260331;;2;18728652;18729470;818;0
14022;ENSG00000260404;;4;119512928;119554884;41956;0
14023;ENSG00000260526;;4;113150717;113152752;2035;0
14024;ENSG00000260572;;3;160471216;160472930;1714;0
14025;ENSG00000260583;LINC00515;21;26955082;26955638;556;0
14026;ENSG00000260633;;3;134066130;134068075;1945;0
14027;ENSG00000260634;;2;127781828;127783299;1471;0
14028;ENSG00000260641;;4;99580055;99585701;5646;0
14029;ENSG00000260655;;22;42318027;42319104;1077;0
14030;ENSG00000260708;;22;47157791;47158460;669;0
14031;ENSG00000260742;;2;182752578;182756390;3812;0
14032;ENSG00000260743;;3;179058110;179059675;1565;0
14033;ENSG00000260774;;5;214013;217394;3381;0
14034;ENSG00000260804;;2;217081768;217084915;3147;0
14035;ENSG00000260837;;2;8861264;8862816;1552;1
14036;ENSG00000260878;;4;46245565;46246232;667;0
14037;ENSG00000260903;XKR7;20;30555805;30591190;35385;0
14038;ENSG00000260918;;4;47433977;47440976;6999;0
14039;ENSG00000260924;;22;19158908;19160352;1444;0
14040;ENSG00000260931;;2;179265561;179267618;2057;0
14041;ENSG00000260942;CAPN10-AS1;2;241522117;241526116;3999;0
14042;ENSG00000260977;;2;47004922;47007384;2462;0
14043;ENSG00000261037;;5;6019142;6022396;3254;0
14044;ENSG00000261051;;3;145777372;145779466;2094;0
14045;ENSG00000261096;;2;232674556;232677062;2506;0
14046;ENSG00000261117;;2;12855541;12856353;812;0
14047;ENSG00000261159;;3;128578559;128579369;810;0
14048;ENSG00000261167;;3;131173970;131177442;3472;0
14049;ENSG00000261186;;2;243029505;243030608;1103;0
14050;ENSG00000261188;;22;26908503;26910534;2031;0
14051;ENSG00000261202;;22;40439072;40440534;1462;0
14052;ENSG00000261221;ZNF865;19;56116771;56128635;11864;0
14053;ENSG00000261251;;22;44208336;44213274;4938;0
14054;ENSG00000261268;;4;140539290;140544386;5096;0
14055;ENSG00000261292;;3;97478367;97480374;2007;0
14056;ENSG00000261338;;2;219120042;219122087;2045;0
14057;ENSG00000261360;;5;14661917;14664713;2796;0
14058;ENSG00000261379;;2;227668752;227669777;1025;0
14059;ENSG00000261428;;2;223431624;223434438;2814;0
14060;ENSG00000261452;;2;25380063;25382006;1943;0
14061;ENSG00000261488;;3;111852270;111854206;1936;0
14062;ENSG00000261490;;4;10069713;10074643;4930;1
14063;ENSG00000261496;;4;86933449;86935027;1578;0
14064;ENSG00000261533;;3;99898411;99900574;2163;1
14065;ENSG00000261600;;2;91768393;91768920;527;0
14066;ENSG00000261643;;4;3505324;3506184;860;0
14067;ENSG00000261675;;22;36956917;36958962;2045;0
14068;ENSG00000261758;;3;136471472;136474622;3150;0
14069;ENSG00000261786;;3;44158791;44163857;5066;0
14070;ENSG00000261829;;2;231916755;231917352;597;0
14071;ENSG00000263327;TAPT1-AS1;4;16228286;16321763;93477;0
14072;ENSG00000263738;;4;158281267;158281378;111;0
14073;ENSG00000263826;;3;186499569;186501968;2399;0
14074;ENSG00000264219;MIR4442;3;25706364;25706430;66;0
14075;ENSG00000264279;MIR4786;2;240882432;240882511;79;0
14076;ENSG00000264281;;5;55240458;55240856;398;0
14077;ENSG00000264324;;2;74438731;74590504;151773;0
14078;ENSG00000264333;;19;58822283;58822368;85;0
14079;ENSG00000264370;MIR3125;2;12877493;12877570;77;0
14080;ENSG00000265106;;22;42948194;42948279;85;0
14081;ENSG00000265280;;2;130941016;130941092;76;0
14082;ENSG00000265451;;2;122287998;122290281;2283;0
14083;ENSG00000265452;MIR3682;2;54076259;54076342;83;0
14084;ENSG00000266118;;2;24347236;24413305;66069;0
14085;ENSG00000266413;;2;179641653;179644690;3037;0
14086;ENSG00000266730;RN7SL773P;3;195647715;195648000;285;0
14087;ENSG00000266907;;19;56831159;56833679;2520;0
14088;ENSG00000267034;;2;223181961;223183372;1411;0
14089;ENSG00000267096;;19;56181998;56183435;1437;0
14090;ENSG00000267183;;19;56207251;56209196;1945;0
14091;ENSG00000267216;;19;58790332;58826563;36231;0
14092;ENSG00000267224;;19;57046668;57047132;464;0
14093;ENSG00000267265;;19;55517561;55559454;41893;1
14094;ENSG00000267454;ZNF582-AS1;19;56905025;56910541;5516;0
14095;ENSG00000267459;;19;56888406;56889161;755;0
14096;ENSG00000267522;;19;56578050;56590167;12117;0
14097;ENSG00000267549;;19;56826072;56852656;26584;1
14098;ENSG00000267649;;19;55728028;55732984;4956;0
14099;ENSG00000267730;;19;56088136;56088780;644;0
14100;ENSG00000267776;;19;56888073;56888653;580;0
14101;ENSG00000267784;;2;179588184;179591773;3589;0
14102;ENSG00000267838;;19;54949847;54950362;515;0
14103;ENSG00000267848;;20;62585007;62585495;488;0
14104;ENSG00000267858;;19;59070496;59086164;15668;0
14105;ENSG00000267871;;19;57778588;57791702;13114;1
14106;ENSG00000267919;;2;220509812;220510353;541;0
14107;ENSG00000268049;;19;58869365;58870969;1604;0
14108;ENSG00000268129;;3;142719749;142720309;560;0
14109;ENSG00000268171;;4;57276682;57277131;449;1
14110;ENSG00000268175;;3;149689066;149690535;1469;0
14111;ENSG00000268182;SMIM17;19;57154513;57167134;12621;0
14112;ENSG00000268201;;19;58778001;58779051;1050;0
14113;ENSG00000268205;;19;57815673;57819930;4257;0
14114;ENSG00000268230;;19;58858220;58874117;15897;0
14115;ENSG00000268266;;19;57989017;57994364;5347;0
14116;ENSG00000268279;;3;14176717;14189548;12831;0
14117;ENSG00000268340;;20;34106682;34107108;426;0
14118;ENSG00000268352;;19;57183636;57196021;12385;0
14119;ENSG00000268379;;19;57686601;57689289;2688;0
14120;ENSG00000268392;;19;58136400;58138318;1918;1
14121;ENSG00000268471;MIR4453;4;153457416;153460415;2999;0
14122;ENSG00000268496;;19;54945363;54945845;482;0
14123;ENSG00000268516;;19;58768639;58790174;21535;0
14124;ENSG00000268533;;19;57905551;57949825;44274;0
14125;ENSG00000268543;;19;58929927;58930677;750;0
14126;ENSG00000268593;;19;56218707;56219330;623;0
14127;ENSG00000268688;;2;37068327;37068530;203;0
14128;ENSG00000268713;;19;57772722;57774106;1384;0
14129;ENSG00000268816;;19;54697731;54698394;663;0
14130;ENSG00000268858;;20;62492879;62493217;338;0
14131;ENSG00000268885;;5;667759;668839;1080;0
14132;ENSG00000268895;A1BG-AS1;19;58859117;58866549;7432;0
14133;ENSG00000268912;;19;58939999;58942515;2516;0
14134;ENSG00000268941;;20;57209828;57210772;944;0
14135;ENSG00000269028;MTRNR2L12;3;96335981;96337000;1019;0
14136;ENSG00000269054;;19;58873951;58877958;4007;0
14137;ENSG00000269068;;2;220423805;220424348;543;0
14138;ENSG00000269103;;22;21358030;21360736;2706;0
14139;ENSG00000269106;;19;58986722;58987130;408;1
14140;ENSG00000269202;;20;33789550;33791091;1541;0
14141;ENSG00000269302;;4;187111913;187112626;713;0
14142;ENSG00000269343;ZNF587B;19;58331099;58370018;38919;0
14143;ENSG00000269430;LRRC3DN;21;45879814;45882078;2264;0
14144;ENSG00000269473;;19;58951815;58957216;5401;0
14145;ENSG00000269533;;19;57901252;57931362;30110;0
14146;ENSG00000269549;;20;44074071;44077220;3149;0
14147;ENSG00000269563;;2;47799601;47801998;2397;0
14148;ENSG00000269696;;19;57056935;57078780;21845;0
14149;ENSG00000269707;;2;105469743;105542510;72767;0
14150;ENSG00000269728;;3;179113877;179115965;2088;0
14151;ENSG00000269793;;19;57202054;57311014;108960;1
14152;ENSG00000269808;;19;55738587;55741647;3060;0
14153;ENSG00000269873;;19;54949192;54949528;336;0
14154;ENSG00000269886;;3;9854446;9854781;335;1
14155;ENSG00000269893;SNHG8;4;119199864;119200978;1114;0
14156;ENSG00000269894;;3;9977390;9977942;552;0
14157;ENSG00000269921;;4;57253791;57254319;528;0
14158;ENSG00000269949;;4;57827093;57827539;446;0
14159;ENSG00000269961;;5;65220457;65220963;506;0
14160;ENSG00000269973;;2;10076489;10079719;3230;0
14161;ENSG00000269975;;3;9540045;9541253;1208;0
14162;ENSG00000269976;;2;20786008;20786446;438;0
14163;ENSG00000269982;;3;10000401;10004223;3822;0
14164;ENSG00000269984;;3;169494980;169498122;3142;0
14165;ENSG00000270019;;2;114645780;114647327;1547;0
14166;ENSG00000270041;;22;24080865;24081476;611;0
14167;ENSG00000270059;;3;65344943;65345392;449;0
14168;ENSG00000270071;;21;17664112;17680454;16342;0
14169;ENSG00000270081;;2;128601127;128603261;2134;0
14170;ENSG00000270083;;22;42485634;42486032;398;0
14171;ENSG00000270093;;21;18015848;18017384;1536;0
14172;ENSG00000270096;;3;169512750;169514001;1251;0
14173;ENSG00000270100;;2;20878014;20878692;678;0
14174;ENSG00000270109;;4;57330324;57330745;421;0
14175;ENSG00000270116;;21;38473114;38473643;529;0
14176;ENSG00000270135;;3;169511283;169511754;471;0
14177;ENSG00000270147;;4;57262478;57263037;559;0
14178;ENSG00000270170;NCBP2-AS2;3;196669494;196670411;917;0
14179;ENSG00000270178;;3;179521851;179522154;303;0
14180;ENSG00000270195;;4;1714548;1715349;801;0
14181;ENSG00000270277;;2;179413611;179415408;1797;1
14182;ENSG00000270393;;22;19005556;19006429;873;0
14183;ENSG00000270408;;20;10625847;10627014;1167;0
14184;ENSG00000270441;;3;49177519;49198284;20765;0
14185;ENSG00000270492;;3;129053429;129053917;488;0
14186;ENSG00000270540;;2;237276203;237277745;1542;0
14187;ENSG00000270557;;2;158734195;158735077;882;0
14188;ENSG00000270558;;5;37286551;37287079;528;0
14189;ENSG00000270562;;3;71634094;71636560;2466;0
14190;ENSG00000270571;;2;75381492;75417075;35583;0
14191;ENSG00000270574;;2;179443517;179445633;2116;0
14192;ENSG00000270659;;2;214017694;214018383;689;0
14193;ENSG00000270681;;4;152061143;152062255;1112;0
14194;ENSG00000270696;;2;75887588;75889334;1746;0
14195;ENSG00000270720;;4;90040435;90041022;587;0
14196;ENSG00000270804;;19;58379253;58380202;949;0
14197;ENSG00000270820;;2;61698323;61711265;12942;0
14198;ENSG00000270959;LPP-AS2;3;187868994;187871845;2851;1
14199;ENSG00000270996;;2;75946246;75947144;898;0
14200;ENSG00000271011;;2;179441830;179442349;519;1
14201;ENSG00000271020;;3;33838641;33839173;532;0
14202;ENSG00000271138;IGLVIVOR22-1;22;25833273;25833790;517;0
14203;ENSG00000271141;;2;179481308;179481850;542;0
14204;ENSG00000271151;;2;174833079;174834146;1067;0
14205;ENSG00000271228;;2;32238130;32238437;307;0
14206;ENSG00000271270;TMCC1-AS1;3;129612714;129637418;24704;1
14207;ENSG00000271320;;2;158774224;158774883;659;0
14208;ENSG00000271324;;3;33835136;33835637;501;0
14209;ENSG00000271359;;4;90032651;90033519;868;0
14210;ENSG00000271401;;2;179509444;179509906;462;0
14211;ENSG00000271452;;2;75897115;75897580;465;0
14212;ENSG00000271474;;4;96470280;96473608;3328;1
14213;ENSG00000271538;;4;185427614;185458708;31094;0
14214;ENSG00000271643;;3;33837180;33838442;1262;0
14215;ENSG00000271646;;4;185395956;185398458;2502;0
14216;ENSG00000271653;;3;37258270;37259479;1209;0
14217;ENSG00000271662;;3;195377017;195378343;1326;0
14218;ENSG00000271714;;5;74161718;74163679;1961;0
14219;ENSG00000271778;;3;158500336;158500913;577;0
14220;ENSG00000271781;;5;675941;676731;790;0
14221;ENSG00000271784;;20;45318298;45318928;630;0
14222;ENSG00000271788;;5;43006835;43007645;810;0
14223;ENSG00000271817;;4;159621843;159622060;217;0
14224;ENSG00000271835;;3;37026534;37026975;441;0
14225;ENSG00000271843;;3;63993758;63994368;610;0
14226;ENSG00000271855;;2;9696028;9696904;876;0
14227;ENSG00000271858;;3;50402765;50405628;2863;0
14228;ENSG00000271868;;2;3500727;3501199;472;0
14229;ENSG00000271870;;3;3194626;3195119;493;0
14230;ENSG00000271892;;5;17107469;17107898;429;0
14231;ENSG00000271936;;2;25048479;25049586;1107;0
14232;ENSG00000271941;;3;43388415;43389135;720;0
14233;ENSG00000271947;;2;7045855;7046432;577;0
14234;ENSG00000271964;;3;16355946;16356494;548;0
14235;ENSG00000271976;;3;53893021;53895603;2582;0
14236;ENSG00000271984;;20;44521333;44522058;725;0
14237;ENSG00000271991;;2;20101786;20102330;544;0
14238;ENSG00000271993;;3;37223598;37224225;627;0
14239;ENSG00000272002;;2;7401002;7401635;633;0
14240;ENSG00000272016;;5;10654332;10657928;3596;0
14241;ENSG00000272019;;22;23474919;23475192;273;0
14242;ENSG00000272048;;2;25450724;25451090;366;0
14243;ENSG00000272054;;2;37436018;37439820;3802;0
14244;ENSG00000272056;;2;27276486;27277144;658;0
14245;ENSG00000272077;;3;44708904;44710856;1952;0
14246;ENSG00000272081;;5;72251033;72251526;493;1
14247;ENSG00000272086;;5;32174577;32175378;801;0
14248;ENSG00000272093;;5;71656517;71658805;2288;0
14249;ENSG00000272103;;5;36861838;36862319;481;0
14250;ENSG00000272123;;5;52384846;52385298;452;0
14251;ENSG00000272144;;5;43061497;43062543;1046;0
14252;ENSG00000272146;;3;57583442;57586654;3212;0
14253;ENSG00000272148;;2;27285296;27285775;479;0
14254;ENSG00000272156;;2;54309691;54312203;2512;0
14255;ENSG00000272181;;3;64005184;64005601;417;1
14256;ENSG00000272182;;3;58413982;58414542;560;0
14257;ENSG00000272216;;22;22638312;22641586;3274;0
14258;ENSG00000272218;;4;187813706;187814137;431;0
14259;ENSG00000272263;;3;12873718;12874227;509;0
14260;ENSG00000272275;;2;10908001;10910184;2183;0
14261;ENSG00000272283;;21;47955709;47956003;294;0
14262;ENSG00000272305;;3;53003135;53133469;130334;0
14263;ENSG00000272308;;5;60162284;60162762;478;0
14264;ENSG00000272323;;5;34837654;34839383;1729;0
14265;ENSG00000272335;;5;44826178;44828694;2516;0
14266;ENSG00000272342;;2;739588;740164;576;0
14267;ENSG00000272354;;5;64316441;64316816;375;0
14268;ENSG00000272365;;5;71663446;71664222;776;1
14269;ENSG00000272370;;5;64315865;64316378;513;0
14270;ENSG00000272382;;5;43033818;43034737;919;0
14271;ENSG00000272416;;5;53176123;53176881;758;1
14272;ENSG00000272417;;5;10203712;10204152;440;0
14273;ENSG00000272434;;3;49066749;49067139;390;0
14274;ENSG00000272452;;3;40507957;40510078;2121;0
14275;ENSG00000272498;;3;16380815;16381378;563;0
14276;ENSG00000272511;;3;21453714;21455436;1722;1
14277;ENSG00000272520;;5;6671219;6674499;3280;0
14278;ENSG00000272525;;5;72793375;72794118;743;0
14279;ENSG00000272529;;3;16386633;16387947;1314;0
14280;ENSG00000272565;;3;141876369;141880820;4451;0
14281;ENSG00000272576;;4;52784938;52785547;609;0
14282;ENSG00000272578;;22;24000281;24059543;59262;0
14283;ENSG00000272582;;22;38346972;38347785;813;0
14284;ENSG00000272597;;3;107048277;107048809;532;0
14285;ENSG00000272606;;2;55845044;55845508;464;0
14286;ENSG00000272622;;2;227664862;227675745;10883;0
14287;ENSG00000272644;;2;219934076;219934531;455;0
14288;ENSG00000272650;;4;54863582;54863879;297;0
14289;ENSG00000272656;;3;139067866;139068213;347;0
14290;ENSG00000272660;;3;179302059;179302198;139;0
14291;ENSG00000272663;;2;48667182;48667736;554;0
14292;ENSG00000272667;;2;128644130;128644759;629;0
14293;ENSG00000272669;;22;39138630;39139120;490;0
14294;ENSG00000272677;;4;83295454;83305180;9726;0
14295;ENSG00000272689;;22;30817195;30817525;330;0
14296;ENSG00000272690;;3;75484499;75506637;22138;0
14297;ENSG00000272700;;3;178954479;178955163;684;0
14298;ENSG00000272702;;2;73340146;73343035;2889;0
14299;ENSG00000272711;;2;75059782;75061114;1332;0
14300;ENSG00000272717;;4;140477953;140478797;844;0
14301;ENSG00000272720;;22;38486134;38487566;1432;0
14302;ENSG00000272721;;3;183851807;183853026;1219;1
14303;ENSG00000272733;;22;23923067;23926046;2979;1
14304;ENSG00000272744;;4;184438047;184438680;633;0
14305;ENSG00000272758;;3;122135054;122162027;26973;0
14306;ENSG00000272761;;3;112315641;112320749;5108;0
14307;ENSG00000272769;;2;133103189;133104870;1681;0
14308;ENSG00000272777;;4;99988407;99989276;869;0
14309;ENSG00000272779;;22;22657589;22664766;7177;0
14310;ENSG00000272792;;3;195366861;195367331;470;0
14311;ENSG00000272795;;4;110736203;110736566;363;0
14312;ENSG00000272797;;3;168645263;168645707;444;0
14313;ENSG00000272800;;2;184079047;184080128;1081;0
14314;ENSG00000272807;;2;210893141;210893880;739;0
14315;ENSG00000272821;;22;50962355;50963209;854;0
14316;ENSG00000272829;;22;21335650;21336044;394;0
14317;ENSG00000272836;;22;50644014;50644491;477;0
14318;ENSG00000272844;;3;112709294;112710000;706;0
14319;ENSG00000272859;;4;73918079;73918634;555;0
14320;ENSG00000272862;;4;41990758;41991254;496;0
14321;ENSG00000272870;;4;174284931;174291597;6666;0
14322;ENSG00000272885;;4;409907;410326;419;0
14323;ENSG00000272902;;2;101768122;101771872;3750;0
14324;ENSG00000272910;;3;179301050;179301550;500;0
14325;ENSG00000272922;;3;184460606;184461072;466;0
14326;ENSG00000272936;;4;44706422;44706982;560;0
14327;ENSG00000272940;;22;51035581;51036028;447;0
14328;ENSG00000272942;;22;25830291;25831037;746;0
14329;ENSG00000272944;;2;222437226;222439174;1948;0
14330;ENSG00000272947;;3;124467422;124468120;698;0
14331;ENSG00000272955;;22;24375562;24376211;649;0
14332;ENSG00000272958;;21;35797806;35798315;509;1
14333;ENSG00000272969;;4;56413279;56414056;777;0
14334;ENSG00000272970;;3;184451863;184456737;4874;0
14335;ENSG00000272973;;22;24198614;24199226;612;0
14336;ENSG00000272977;;22;25872185;25875938;3753;0
14337;ENSG00000272986;;4;71569464;71570208;744;0
14338;ENSG00000272990;;3;156241529;156242036;507;0
14339;ENSG00000272994;;2;105950484;105953932;3448;0
14340;ENSG00000272995;;4;20768431;20768995;564;0
14341;ENSG00000273007;;4;123803033;123805867;2834;0
14342;ENSG00000273009;;3;195639949;195640554;605;0
14343;ENSG00000273017;;21;30731323;30731774;451;0
14344;ENSG00000273027;;21;46349568;46350027;459;0
14345;ENSG00000273032;DGCR9;22;19005347;19007761;2414;0
14346;ENSG00000273033;;3;122605788;122611243;5455;1
14347;ENSG00000273045;;2;99757948;99767950;10002;0
14348;ENSG00000273064;;2;68480002;68480980;978;0
14349;ENSG00000273073;;2;132219394;132221188;1794;0
14350;ENSG00000273080;;2;86422713;86423172;459;0
14351;ENSG00000273091;;21;33108045;33108720;675;0
14352;ENSG00000273104;;21;35784498;35784885;387;0
14353;ENSG00000273113;;2;242521337;242522141;804;0
14354;ENSG00000273133;;4;15565321;15565876;555;0
14355;ENSG00000273137;;22;50646890;50647971;1081;0
14356;ENSG00000273139;;22;20308262;20308726;464;0
14357;ENSG00000273148;;20;18775173;18776711;1538;0
14358;ENSG00000273156;;4;83266029;83266693;664;0
14359;ENSG00000273164;DGCR10;22;19010569;19011063;494;0
14360;ENSG00000273165;;2;32078045;32078492;447;0
14361;ENSG00000273177;;3;168645957;168646386;429;0
14362;ENSG00000273181;;3;183850730;183851349;619;0
14363;ENSG00000273188;;22;50630153;50630831;678;0
14364;ENSG00000273190;;3;179055910;179056371;461;0
14365;ENSG00000273192;;22;50295876;50298224;2348;0
14366;ENSG00000273210;;21;38737779;38738234;455;0
14367;ENSG00000273212;;22;19444026;19444485;459;0
14368;ENSG00000273238;;4;567669;568201;532;0
14369;ENSG00000273240;;2;190628585;190629182;597;0
14370;ENSG00000273243;;22;45551420;45551892;472;0
14371;ENSG00000273245;;2;73977383;73977913;530;0
14372;ENSG00000273247;;4;140333081;140375188;42107;0
14373;ENSG00000273253;;22;50637519;50638976;1457;0
14374;ENSG00000273257;;4;56254116;56254438;322;0
14375;ENSG00000273265;;2;97477976;97479394;1418;0
14376;ENSG00000273271;;21;33039041;33039560;519;0
14377;ENSG00000273275;;2;68406965;68407664;699;0
14378;ENSG00000273287;;22;45658166;45659466;1300;0
14379;ENSG00000273294;;5;33987279;34124633;137354;0
14380;ENSG00000273295;;22;24243619;24249255;5636;1
14381;ENSG00000273300;;22;19441702;19442128;426;0
14382;ENSG00000273301;;2;226563230;226568370;5140;0
14383;ENSG00000273306;;2;100021680;100022305;625;0
14384;ENSG00000273308;;3;197372540;197372888;348;0
14385;ENSG00000273311;DGCR11;22;19033675;19035888;2213;0
14386;ENSG00000273325;;22;32680670;32681118;448;0
14387;ENSG00000273342;;22;21995133;21995573;440;0
14388;ENSG00000273343;;22;20305642;20306272;630;0
14389;ENSG00000273356;;3;50707420;50709479;2059;0
14390;ENSG00000273369;;4;44695963;44696403;440;0
14391;ENSG00000273374;;3;99521543;99524902;3359;0
14392;ENSG00000273375;;3;197516571;197517240;669;0
14393;ENSG00000273389;;4;86921480;86921919;439;0
14394;ENSG00000273403;;3;184459725;184460250;525;0
14395;ENSG00000273437;;3;128882449;128882783;334;0
14396;ENSG00000273449;;4;164450923;164451849;926;0
14397;ENSG00000273451;;20;45976881;45977886;1005;0
14398;ENSG00000273454;;3;122996200;122996751;551;0
14399;ENSG00000273456;;2;203239655;203240327;672;0
14400;ENSG00000273466;;2;219497979;219498737;758;0
14401;ENSG00000273472;;4;141677682;141679075;1393;0
14402;ENSG00000273486;;3;136556180;136557863;1683;0
14403;ENSG00000273488;;3;100080031;100080481;450;0
14404;ENSG00000273492;;21;27543189;27589700;46511;0
14405;ENSG00000273493;;3;58315692;58315845;153;0
14406;ENSG00000000003;TSPAN6;X;99883667;99894988;11321;0
14407;ENSG00000000005;TNMD;X;99839799;99854882;15083;1
14408;ENSG00000001036;FUCA2;6;143815948;143832827;16879;0
14409;ENSG00000001084;GCLC;6;53362139;53481768;119629;0
14410;ENSG00000001167;NFYA;6;41040684;41067715;27031;0
14411;ENSG00000001497;LAS1L;X;64732462;64754655;22193;0
14412;ENSG00000001561;ENPP4;6;46097730;46114436;16706;0
14413;ENSG00000001629;ANKIB1;7;91875548;92030698;155150;0
14414;ENSG00000001630;CYP51A1;7;91741465;91772266;30801;0
14415;ENSG00000001631;KRIT1;7;91828283;91875480;47197;0
14416;ENSG00000002586;CD99;X;2609220;2659350;50130;0
14417;ENSG00000002746;HECW1;7;43152198;43605600;453402;0
14418;ENSG00000002822;MAD1L1;7;1855429;2272878;417449;0
14419;ENSG00000003096;KLHL13;X;117031776;117251303;219527;0
14420;ENSG00000003147;ICA1;7;8152814;8302317;149503;0
14421;ENSG00000003987;MTMR7;8;17155539;17271037;115498;0
14422;ENSG00000003989;SLC7A2;8;17354597;17428082;73485;0
14423;ENSG00000004059;ARF5;7;127228399;127231759;3360;0
14424;ENSG00000004766;CCDC132;7;92861653;92988338;126685;0
14425;ENSG00000004799;PDK4;7;95212811;95225803;12992;0
14426;ENSG00000004864;SLC25A13;7;95749532;95951459;201927;0
14427;ENSG00000004866;ST7;7;116593292;116870157;276865;0
14428;ENSG00000004948;CALCR;7;93053799;93204042;150243;0
14429;ENSG00000004961;HCCS;X;11129421;11141198;11777;0
14430;ENSG00000005020;SKAP2;7;26706681;27034858;328177;0
14431;ENSG00000005022;SLC25A5;X;118602363;118605282;2919;0
14432;ENSG00000005075;POLR2J;7;102113565;102119354;5789;0
14433;ENSG00000005108;THSD7A;7;11409984;11871824;461840;0
14434;ENSG00000005238;FAM214B;9;35104109;35116338;12229;0
14435;ENSG00000005249;PRKAR2B;7;106685094;106802256;117162;0
14436;ENSG00000005302;MSL3;X;11776278;11793870;17592;0
14437;ENSG00000005469;CROT;7;86974997;87029111;54114;0
14438;ENSG00000005471;ABCB4;7;87031013;87109751;78738;1
14439;ENSG00000005483;KMT2E;7;104654626;104754808;100182;0
14440;ENSG00000005486;RHBDD2;7;75471920;75518244;46324;0
14441;ENSG00000005700;IBTK;6;82879700;82957471;77771;0
14442;ENSG00000005889;ZFX;X;24167290;24234372;67082;0
14443;ENSG00000005893;LAMP2;X;119561682;119603220;41538;0
14444;ENSG00000006128;TAC1;7;97361220;97369784;8564;0
14445;ENSG00000006451;RALA;7;39663082;39747723;84641;0
14446;ENSG00000006453;BAIAP2L1;7;97920963;98030380;109417;0
14447;ENSG00000006459;KDM7A;7;139784546;139876835;92289;0
14448;ENSG00000006468;ETV1;7;13930853;14031050;100197;0
14449;ENSG00000006530;AGK;7;141250989;141355044;104055;0
14450;ENSG00000006576;PHTF2;7;77428122;77586818;158696;0
14451;ENSG00000006625;GGCT;7;30536237;30591095;54858;0
14452;ENSG00000006634;DBF4;7;87505531;87538856;33325;0
14453;ENSG00000006652;IFRD1;7;112063023;112121072;58049;0
14454;ENSG00000006704;GTF2IRD1;7;73868120;74016931;148811;0
14455;ENSG00000006715;VPS41;7;38762563;38971994;209431;0
14456;ENSG00000006747;SCIN;7;12610203;12693228;83025;0
14457;ENSG00000006756;ARSD;X;2822011;2847392;25381;0
14458;ENSG00000006757;PNPLA4;X;7866288;7895780;29492;1
14459;ENSG00000006837;CDKL3;5;133541305;133706738;165433;0
14460;ENSG00000007350;TKTL1;X;153524024;153558700;34676;0
14461;ENSG00000007866;TEAD3;6;35441374;35464853;23479;0
14462;ENSG00000007944;MYLIP;6;16129356;16148479;19123;0
14463;ENSG00000008018;PSMB1;6;170844205;170862429;18224;0
14464;ENSG00000008056;SYN1;X;47431303;47479252;47949;0
14465;ENSG00000008083;JARID2;6;15246527;15522252;275725;0
14466;ENSG00000008086;CDKL5;X;18443703;18671749;228046;0
14467;ENSG00000008196;TFAP2B;6;50786436;50815326;28890;0
14468;ENSG00000008256;CYTH3;7;6201407;6312275;110868;0
14469;ENSG00000008277;ADAM22;7;87563458;87832204;268746;0
14470;ENSG00000008282;SYPL1;7;105730949;105753022;22073;0
14471;ENSG00000008311;AASS;7;121715701;121784334;68633;0
14472;ENSG00000008513;ST3GAL1;8;134467091;134584183;117092;0
14473;ENSG00000008853;RHOBTB2;8;22844930;22877712;32782;0
14474;ENSG00000008988;RPS20;8;56979854;56987069;7215;0
14475;ENSG00000009335;UBE3C;7;156931607;157062066;130459;0
14476;ENSG00000009413;REV3L;6;111620234;111804918;184684;0
14477;ENSG00000009694;TENM1;X;123509753;124097666;587913;0
14478;ENSG00000009844;VTA1;6;142468367;142545826;77459;0
14479;ENSG00000009950;MLXIPL;7;73007524;73038873;31349;0
14480;ENSG00000009954;BAZ1B;7;72854728;72936608;81880;0
14481;ENSG00000010017;RANBP9;6;13621730;13711796;90066;0
14482;ENSG00000010270;STARD3NL;7;38217824;38270272;52448;0
14483;ENSG00000010404;IDS;X;148558521;148615470;56949;0
14484;ENSG00000010438;PRSS3;9;33750515;33799230;48715;0
14485;ENSG00000010671;BTK;X;100604435;100641183;36748;0
14486;ENSG00000010810;FYN;6;111981535;112194655;213120;0
14487;ENSG00000010818;HIVEP2;6;143072604;143266338;193734;0
14488;ENSG00000011083;SLC6A7;5;149569520;149602351;32831;0
14489;ENSG00000011201;KAL1;X;8496915;8700227;203312;0
14490;ENSG00000011275;RNF216;7;5659678;5821370;161692;0
14491;ENSG00000011426;ANLN;7;36429415;36493400;63985;1
14492;ENSG00000011454;RABGAP1;9;125703112;125867145;164033;0
14493;ENSG00000011677;GABRA3;X;151334706;151619830;285124;0
14494;ENSG00000012174;MBTPS2;X;21857754;21903542;45788;1
14495;ENSG00000012232;EXTL3;8;28457986;28613116;155130;0
14496;ENSG00000012660;ELOVL5;6;53132196;53213947;81751;0
14497;ENSG00000012817;KDM5D;Y;21865751;21906825;41074;0
14498;ENSG00000013374;NUB1;7;151038785;151075535;36750;0
14499;ENSG00000013375;PGM3;6;83870869;83903655;32786;0
14500;ENSG00000013392;RWDD2A;6;83903098;83908651;5553;0
14501;ENSG00000013561;RNF14;5;141337893;141369856;31963;0
14502;ENSG00000013563;DNASE1L1;X;153629579;153640449;10870;0
14503;ENSG00000013619;MAMLD1;X;149529689;149682448;152759;0
14504;ENSG00000014123;UFL1;6;96969471;97003152;33681;0
14505;ENSG00000014164;ZC3H3;8;144519825;144623623;103798;0
14506;ENSG00000015285;WAS;X;48534985;48549818;14833;0
14507;ENSG00000015479;MATR3;5;138609441;138667360;57919;0
14508;ENSG00000015592;STMN4;8;27092840;27115937;23097;1
14509;ENSG00000015676;NUDCD3;7;44418720;44530479;111759;0
14510;ENSG00000017483;SLC38A5;X;48316920;48328644;11724;0
14511;ENSG00000017621;MAGIX;X;49019061;49024822;5761;0
14512;ENSG00000018610;CXorf56;X;118672112;118699397;27285;0
14513;ENSG00000019549;SNAI2;8;49830249;49834299;4050;0
14514;ENSG00000020181;GPR124;8;37641709;37702414;60705;0
14515;ENSG00000021355;SERPINB1;6;2832566;2842240;9674;0
14516;ENSG00000022267;FHL1;X;135229559;135293518;63959;0
14517;ENSG00000022355;GABRA1;5;161274197;161326975;52778;0
14518;ENSG00000022567;SLC45A4;8;142217265;142318404;101139;0
14519;ENSG00000023287;RB1CC1;8;53535016;53658403;123387;0
14520;ENSG00000023318;ERP44;9;102741461;102861322;119861;0
14521;ENSG00000023892;DEF6;6;35265595;35289548;23953;0
14522;ENSG00000024048;UBR2;6;42531800;42661242;129442;0
14523;ENSG00000024862;CCDC28A;6;139094657;139114456;19799;0
14524;ENSG00000025039;RRAGD;6;90074355;90121989;47634;0
14525;ENSG00000025156;HSF2;6;122720691;122754264;33573;0
14526;ENSG00000025796;SEC63;6;108188960;108279393;90433;0
14527;ENSG00000026297;RNASET2;6;167342992;167370679;27687;1
14528;ENSG00000026652;AGPAT4;6;161551011;161695093;144082;0
14529;ENSG00000026950;BTN3A1;6;26402465;26415444;12979;0
14530;ENSG00000027697;IFNGR1;6;137518621;137540586;21965;0
14531;ENSG00000027847;B4GALT7;5;177027101;177037348;10247;0
14532;ENSG00000028839;TBPL1;6;134273308;134311570;38262;0
14533;ENSG00000029363;BCLAF1;6;136578001;136610989;32988;0
14534;ENSG00000029534;ANK1;8;41510739;41754280;243541;0
14535;ENSG00000029639;TFB1M;6;155578643;155635627;56984;0
14536;ENSG00000029993;HMGB3;X;150148982;150159248;10266;0
14537;ENSG00000030110;BAK1;6;33540329;33548019;7690;0
14538;ENSG00000031003;FAM13B;5;137273649;137387650;114001;0
14539;ENSG00000031691;CENPQ;6;49431091;49460820;29729;0
14540;ENSG00000033050;ABCF2;7;150904923;150924316;19393;0
14541;ENSG00000033100;CHPF2;7;150929575;150935908;6333;0
14542;ENSG00000034239;EFCAB1;8;49623348;49647870;24522;0
14543;ENSG00000034677;RNF19A;8;101269288;101348446;79158;0
14544;ENSG00000034693;PEX3;6;143771944;143811147;39203;0
14545;ENSG00000035681;NSMAF;8;59496063;59572403;76340;0
14546;ENSG00000036448;MYOM2;8;1993155;2113475;120320;0
14547;ENSG00000036565;SLC18A1;8;20002366;20040717;38351;0
14548;ENSG00000037241;RPL26L1;5;172385732;172396774;11042;0
14549;ENSG00000037280;FLT4;5;180028506;180076624;48118;0
14550;ENSG00000037749;MFAP3;5;153418466;153600038;181572;0
14551;ENSG00000038274;MAT2B;5;162930120;162946342;16222;0
14552;ENSG00000038427;VCAN;5;82767284;82878122;110838;0
14553;ENSG00000039319;ZFYVE16;5;79703832;79775169;71337;0
14554;ENSG00000040275;SPDL1;5;169010638;169031782;21144;0
14555;ENSG00000040341;STAU2;8;74332604;74659943;327339;0
14556;ENSG00000041982;TNC;9;117782806;117880536;97730;0
14557;ENSG00000042832;TG;8;133879203;134147147;267944;0
14558;ENSG00000042980;ADAM28;8;24151553;24216531;64978;0
14559;ENSG00000043143;JADE2;5;133860003;133918918;58915;0
14560;ENSG00000044090;CUL7;6;43005355;43021683;16328;0
14561;ENSG00000044115;CTNNA1;5;137946656;138270723;324067;0
14562;ENSG00000044446;PHKA2;X;18910418;19002716;92298;0
14563;ENSG00000044459;CNTLN;9;17134980;17503921;368941;0
14564;ENSG00000044574;HSPA5;9;127997132;128003609;6477;0
14565;ENSG00000046647;GEMIN8;X;14026398;14048012;21614;0
14566;ENSG00000046651;OFD1;X;13752832;13787480;34648;0
14567;ENSG00000046653;GPM6B;X;13789150;13956757;167607;0
14568;ENSG00000046889;PREX2;8;68864353;69149265;284912;0
14569;ENSG00000047188;YTHDC2;5;112849380;112930982;81602;0
14570;ENSG00000047230;CTPS2;X;16606126;16731059;124933;0
14571;ENSG00000047249;ATP6V1H;8;54628117;54756118;128001;0
14572;ENSG00000047579;DTNBP1;6;15523032;15663289;140257;0
14573;ENSG00000047597;XK;X;37545012;37591383;46371;0
14574;ENSG00000047634;SCML1;X;17755588;17773105;17517;0
14575;ENSG00000047644;WWC3;X;9983602;10112518;128916;0
14576;ENSG00000047648;ARHGAP6;X;11136239;11683821;547582;0
14577;ENSG00000047932;GOPC;6;117639374;117923691;284317;0
14578;ENSG00000048052;HDAC9;7;18126572;19042039;915467;0
14579;ENSG00000048140;TSPAN17;5;176074388;176086058;11670;0
14580;ENSG00000048162;NOP16;5;175810949;175815976;5027;0
14581;ENSG00000048392;RRM2B;8;103216730;103251346;34616;0
14582;ENSG00000048405;ZNF800;7;126986844;127071978;85134;0
14583;ENSG00000048544;MRPS10;6;42174539;42185603;11064;0
14584;ENSG00000048828;FAM120A;9;96214004;96328397;114393;0
14585;ENSG00000049540;ELN;7;73442119;73484237;42118;0
14586;ENSG00000049541;RFC2;7;73645829;73668774;22945;0
14587;ENSG00000049618;ARID1B;6;157099063;157531913;432850;0
14588;ENSG00000049768;FOXP3;X;49106897;49121288;14391;0
14589;ENSG00000049769;PPP1R3F;X;49126306;49157929;31623;0
14590;ENSG00000050030;KIAA2022;X;73952684;74145282;192598;0
14591;ENSG00000050344;NFE2L3;7;26191860;26226745;34885;0
14592;ENSG00000050393;MCUR1;6;13786789;13814800;28011;0
14593;ENSG00000050555;LAMC3;9;133884469;133969860;85391;0
14594;ENSG00000050748;MAPK9;5;179660143;179719099;58956;0
14595;ENSG00000050767;COL23A1;5;177664619;178017556;352937;0
14596;ENSG00000051596;THOC3;5;175344876;175461683;116807;0
14597;ENSG00000051620;HEBP2;6;138724668;138743334;18666;0
14598;ENSG00000053108;FSTL4;5;132532147;132948255;416108;0
14599;ENSG00000054148;PHPT1;9;139743176;139745488;2312;0
14600;ENSG00000054179;ENTPD2;9;139942550;139948497;5947;0
14601;ENSG00000055118;KCNH2;7;150642049;150675403;33354;0
14602;ENSG00000055130;CUL1;7;148395006;148498128;103122;0
14603;ENSG00000055147;FAM114A2;5;153369688;153418496;48808;0
14604;ENSG00000055163;CYFIP2;5;156693089;156822606;129517;0
14605;ENSG00000055208;TAB2;6;149539777;149732749;192972;0
14606;ENSG00000055211;GINM1;6;149887430;149912884;25454;0
14607;ENSG00000055609;KMT2C;7;151832010;152133090;301080;0
14608;ENSG00000056277;ZNF280C;X;129336685;129402873;66188;0
14609;ENSG00000056558;TRAF1;9;123664671;123691451;26780;0
14610;ENSG00000056586;RC3H2;9;125606835;125667620;60785;0
14611;ENSG00000056972;TRAF3IP2;6;111877657;111927481;49824;0
14612;ENSG00000056998;GYG2;X;2746829;2800859;54030;0
14613;ENSG00000057663;ATG5;6;106632351;106773666;141315;0
14614;ENSG00000058091;CDK14;7;90095738;90839905;744167;0
14615;ENSG00000058404;CAMK2B;7;44256749;44374176;117427;0
14616;ENSG00000058729;RIOK2;5;96496571;96518964;22393;0
14617;ENSG00000059377;TBXAS1;7;139476850;139720125;243275;0
14618;ENSG00000059378;PARP12;7;139723544;139763521;39977;0
14619;ENSG00000059769;DNAJC25;9;114393632;114432508;38876;0
14620;ENSG00000060762;MPC1;6;166778407;166796486;18079;0
14621;ENSG00000061337;LZTS1;8;20103676;20161474;57798;0
14622;ENSG00000061455;PRDM6;5;122424816;122529960;105144;1
14623;ENSG00000061492;WNT8A;5;137419581;137428054;8473;0
14624;ENSG00000062582;MRPS24;7;43906157;43909492;3335;0
14625;ENSG00000063587;ZNF275;X;152599613;152625568;25955;0
14626;ENSG00000063601;MTMR1;X;149861435;149933576;72141;0
14627;ENSG00000064313;TAF2;8;120743015;120845103;102088;0
14628;ENSG00000064393;HIPK2;7;139246316;139477577;231261;0
14629;ENSG00000064419;TNPO3;7;128594948;128695198;100250;0
14630;ENSG00000064651;SLC12A2;5;127419458;127525380;105922;0
14631;ENSG00000064652;SNX24;5;122179134;122365049;185915;0
14632;ENSG00000064692;SNCAIP;5;121647049;121799914;152865;0
14633;ENSG00000064995;TAF11;6;34845555;34855866;10311;0
14634;ENSG00000064999;ANKS1A;6;34857042;35059179;202137;0
14635;ENSG00000065029;ZNF76;6;35226686;35263762;37076;0
14636;ENSG00000065060;UHRF1BP1;6;34759857;34850915;91058;0
14637;ENSG00000065308;TRAM2;6;52362200;52441713;79513;0
14638;ENSG00000065491;TBC1D22B;6;37225548;37300746;75198;0
14639;ENSG00000065609;SNAP91;6;84262599;84419410;156811;0
14640;ENSG00000065615;CYB5R4;6;84569362;84677143;107781;0
14641;ENSG00000065833;ME1;6;83920108;84140797;220689;0
14642;ENSG00000065883;CDK13;7;39989636;40136733;147097;0
14643;ENSG00000065923;SLC9A7;X;46464753;46618490;153737;0
14644;ENSG00000066379;ZNRD1;6;30026676;30032686;6010;0
14645;ENSG00000066583;ISOC1;5;128430444;128449721;19277;0
14646;ENSG00000066651;TRMT11;6;126307576;126360422;52846;0
14647;ENSG00000066697;MSANTD3;9;103189438;103213511;24073;0
14648;ENSG00000066777;ARFGEF1;8;68085747;68255912;170165;0
14649;ENSG00000066827;ZFAT;8;135490031;135725292;235261;0
14650;ENSG00000066855;MTFR1;8;66556969;66683496;126527;0
14651;ENSG00000066923;STAG3;7;99775186;99819111;43925;0
14652;ENSG00000067048;DDX3Y;Y;15016019;15032390;16371;0
14653;ENSG00000067167;TRAM1;8;71485677;71520622;34945;0
14654;ENSG00000067177;PHKA1;X;71798664;71934167;135503;0
14655;ENSG00000067445;TRO;X;54946895;54957864;10969;0
14656;ENSG00000067601;PMS2P4;7;66752528;66767894;15366;0
14657;ENSG00000067646;ZFY;Y;2803112;2850547;47435;0
14658;ENSG00000067829;IDH3G;X;153051221;153059978;8757;0
14659;ENSG00000067840;PDZD4;X;153067621;153096020;28399;0
14660;ENSG00000067842;ATP2B3;X;152783134;152848397;65263;0
14661;ENSG00000067992;PDK3;X;24483338;24557954;74616;0
14662;ENSG00000068308;OTUD5;X;48779305;48815648;36343;0
14663;ENSG00000068323;TFE3;X;48886242;48901012;14770;0
14664;ENSG00000068354;TBC1D25;X;48397845;48420997;23152;0
14665;ENSG00000068366;ACSL4;X;108867473;108976632;109159;0
14666;ENSG00000068394;GPKOW;X;48970334;48980151;9817;0
14667;ENSG00000068400;GRIPAP1;X;48830134;48858675;28541;0
14668;ENSG00000068438;FTSJ1;X;48334541;48344752;10211;0
14669;ENSG00000069018;TRPC7;5;135548999;135732730;183731;0
14670;ENSG00000069509;FUNDC1;X;44382885;44402247;19362;0
14671;ENSG00000069535;MAOB;X;43625858;43741693;115835;1
14672;ENSG00000070061;IKBKAP;9;111629797;111696396;66599;0
14673;ENSG00000070159;PTPN3;9;112137746;112260590;122844;0
14674;ENSG00000070214;SLC44A1;9;108006903;108201452;194549;0
14675;ENSG00000070501;POLB;8;42195972;42229326;33354;0
14676;ENSG00000070601;FRMPD1;9;37650997;37746901;95904;0
14677;ENSG00000070610;GBA2;9;35736863;35749983;13120;0
14678;ENSG00000070614;NDST1;5;149865381;149937773;72392;0
14679;ENSG00000070669;ASNS;7;97481430;97501854;20424;0
14680;ENSG00000070718;AP3M2;8;42010464;42029191;18727;0
14681;ENSG00000070756;PABPC1;8;101698044;101735037;36993;0
14682;ENSG00000070808;CAMK2A;5;149599054;149669854;70800;0
14683;ENSG00000070814;TCOF1;5;149737202;149779871;42669;0
14684;ENSG00000070882;OSBPL3;7;24836158;25021253;185095;0
14685;ENSG00000071189;SNX13;7;17830385;17980124;149739;0
14686;ENSG00000071242;RPS6KA2;6;166822852;167319939;497087;0
14687;ENSG00000071243;ING3;7;120590803;120617270;26467;0
14688;ENSG00000071462;WBSCR22;7;73097355;73119491;22136;0
14689;ENSG00000071553;ATP6AP1;X;153656978;153664862;7884;0
14690;ENSG00000071859;FAM50A;X;153672473;153679002;6529;0
14691;ENSG00000071889;FAM3A;X;153733350;153744566;11216;0
14692;ENSG00000071894;CPSF1;8;145618444;145634753;16309;0
14693;ENSG00000071994;PDCD2;6;170884383;170893780;9397;0
14694;ENSG00000072133;RPS6KA6;X;83318984;83442933;123949;0
14695;ENSG00000072315;TRPC5;X;111017543;111326004;308461;0
14696;ENSG00000072364;AFF4;5;132211071;132299326;88255;0
14697;ENSG00000072501;SMC1A;X;53401070;53449677;48607;0
14698;ENSG00000072506;HSD17B10;X;53458206;53461320;3114;0
14699;ENSG00000072571;HMMR;5;162887209;162918947;31738;0
14700;ENSG00000072682;P4HA2;5;131527531;131631008;103477;0
14701;ENSG00000072786;STK10;5;171469077;171615390;146313;0
14702;ENSG00000072803;FBXW11;5;171288553;171433877;145324;0
14703;ENSG00000073009;IKBKG;X;153769414;153796782;27368;0
14704;ENSG00000073464;CLCN4;X;10125024;10205700;80676;0
14705;ENSG00000074276;CDHR2;5;175969512;176022975;53463;0
14706;ENSG00000074317;SNCB;5;176047085;176057530;10445;0
14707;ENSG00000074706;IPCEF1;6;154475631;154677926;202295;0
14708;ENSG00000074935;TUBE1;6;112391980;112408732;16752;0
14709;ENSG00000075142;SRI;7;87834433;87856308;21875;0
14710;ENSG00000075213;SEMA3A;7;83585093;84122040;536947;0
14711;ENSG00000075223;SEMA3C;7;80371854;80551675;179821;1
14712;ENSG00000075303;SLC25A40;7;87462883;87505672;42789;0
14713;ENSG00000075618;FSCN1;7;5632439;5646286;13847;0
14714;ENSG00000075624;ACTB;7;5566782;5603415;36633;0
14715;ENSG00000075790;BCAP29;7;107220422;107269615;49193;0
14716;ENSG00000076554;TPD52;8;80870571;81143467;272896;0
14717;ENSG00000076641;PAG1;8;81880045;82024303;144258;0
14718;ENSG00000076716;GPC4;X;132434131;132549518;115387;0
14719;ENSG00000076770;MBNL3;X;131503345;131623996;120651;0
14720;ENSG00000077063;CTTNBP2;7;117350705;117514193;163488;0
14721;ENSG00000077080;ACTL6B;7;100240720;100254084;13364;0
14722;ENSG00000077264;PAK3;X;110187513;110470589;283076;0
14723;ENSG00000077274;CAPN6;X;110488331;110513751;25420;0
14724;ENSG00000077279;DCX;X;110537007;110655603;118596;0
14725;ENSG00000077454;LRCH4;7;100169855;100183776;13921;0
14726;ENSG00000077713;SLC25A43;X;118533023;118588441;55418;0
14727;ENSG00000077721;UBE2A;X;118708501;118718381;9880;0
14728;ENSG00000077782;FGFR1;8;38268656;38326352;57696;0
14729;ENSG00000077809;GTF2I;7;74071994;74175026;103032;0
14730;ENSG00000078053;AMPH;7;38423305;38671167;247862;0
14731;ENSG00000078061;ARAF;X;47420516;47431307;10791;0
14732;ENSG00000078269;SYNJ2;6;158402888;158520208;117320;0
14733;ENSG00000078319;PMS2P1;7;99918615;99939531;20916;0
14734;ENSG00000078401;EDN1;6;12290596;12297427;6831;0
14735;ENSG00000078487;ZCWPW1;7;99998449;100026615;28166;0
14736;ENSG00000078549;ADCYAP1R1;7;31092076;31151089;59013;1
14737;ENSG00000078668;VDAC3;8;42249142;42263415;14273;0
14738;ENSG00000078674;PCM1;8;17780349;17885478;105129;0
14739;ENSG00000078725;BRINP1;9;121915736;122131745;216009;0
14740;ENSG00000078967;UBE2D4;7;43966037;43995735;29698;0
14741;ENSG00000079102;RUNX1T1;8;92967203;93115514;148311;0
14742;ENSG00000079459;FDFT1;8;11653082;11696818;43736;0
14743;ENSG00000079482;OPHN1;X;67262186;67653755;391569;0
14744;ENSG00000079689;SCGN;6;25652464;25702011;49547;0
14745;ENSG00000079691;LRRC16A;6;25279306;25620758;341452;0
14746;ENSG00000079819;EPB41L2;6;131160487;131384462;223975;0
14747;ENSG00000079841;RIMS1;6;72596406;73112845;516439;0
14748;ENSG00000079931;MOXD1;6;132617194;132722684;105490;0
14749;ENSG00000079950;STX7;6;132767006;132834337;67331;0
14750;ENSG00000080298;RFX3;9;3218297;3526004;307707;0
14751;ENSG00000080503;SMARCA2;9;2015342;2193624;178282;0
14752;ENSG00000080546;SESN1;6;109307640;109416022;108382;0
14753;ENSG00000080561;MID2;X;107068985;107170423;101438;0
14754;ENSG00000080608;KIAA0020;9;2720469;2844241;123772;0
14755;ENSG00000080709;KCNN2;5;113696642;113832337;135695;0
14756;ENSG00000080802;CNOT4;7;135046547;135194875;148328;0
14757;ENSG00000081059;TCF7;5;133450402;133487556;37154;0
14758;ENSG00000081087;OSTM1;6;108362613;108487058;124445;0
14759;ENSG00000081189;MEF2C;5;88013975;88199922;185947;0
14760;ENSG00000081377;CDC14B;9;99252523;99382112;129589;0
14761;ENSG00000081386;ZNF510;9;99518147;99540411;22264;0
14762;ENSG00000081791;KIAA0141;5;141303373;141321612;18239;0
14763;ENSG00000081803;CADPS2;7;121958481;122526813;568332;1
14764;ENSG00000081818;PCDHB4;5;140501581;140505201;3620;0
14765;ENSG00000081842;PCDHA6;5;140207563;140391929;184366;0
14766;ENSG00000081853;PCDHGA2;5;140718539;140892546;174007;0
14767;ENSG00000082014;SMARCD3;7;150935850;150974982;39132;0
14768;ENSG00000082269;FAM135A;6;71122644;71270877;148233;0
14769;ENSG00000082293;COL19A1;6;70576463;70919679;343216;0
14770;ENSG00000082458;DLG3;X;69664711;69725337;60626;0
14771;ENSG00000082515;MRPL22;5;154320630;154348971;28341;0
14772;ENSG00000082516;GEMIN5;5;154266976;154317769;50793;0
14773;ENSG00000082556;OPRK1;8;54138284;54164257;25973;1
14774;ENSG00000083067;TRPM3;9;73143979;74061820;917841;0
14775;ENSG00000083097;DOPEY1;6;83777385;83881069;103684;0
14776;ENSG00000083099;LYRM2;6;90277863;90348472;70609;0
14777;ENSG00000083123;BCKDHB;6;80816364;81055987;239623;0
14778;ENSG00000083168;KAT6A;8;41786997;41909508;122511;0
14779;ENSG00000083223;ZCCHC6;9;88902648;88969369;66721;0
14780;ENSG00000083750;RRAGB;X;55744172;55785207;41035;0
14781;ENSG00000085185;BCORL1;X;129115083;129192058;76975;0
14782;ENSG00000085224;ATRX;X;76760356;77041702;281346;0
14783;ENSG00000085365;SCAMP1;5;77656339;77776562;120223;1
14784;ENSG00000085377;PREP;6;105725440;105850959;125519;0
14785;ENSG00000085382;HACE1;6;105175968;105307794;131826;0
14786;ENSG00000085511;MAP3K4;6;161412759;161538417;125658;0
14787;ENSG00000085514;PILRA;7;99965153;99997719;32566;0
14788;ENSG00000085563;ABCB1;7;87133175;87342611;209436;0
14789;ENSG00000085662;AKR1B1;7;134127102;134144036;16934;0
14790;ENSG00000085719;CPNE3;8;87497059;87573726;76667;0
14791;ENSG00000085788;DDHD2;8;38082736;38133076;50340;0
14792;ENSG00000086061;DNAJA1;9;33025209;33039905;14696;0
14793;ENSG00000086062;B4GALT1;9;33104080;33167354;63274;0
14794;ENSG00000086065;CHMP5;9;33264940;33281977;17037;0
14795;ENSG00000086102;NFX1;9;33290509;33371155;80646;0
14796;ENSG00000086232;EIF2AK1;7;6061881;6098861;36980;0
14797;ENSG00000086289;EPDR1;7;37723446;37991543;268097;0
14798;ENSG00000086300;SNX10;7;26331541;26413949;82408;0
14799;ENSG00000086570;FAT2;5;150883654;150948505;64851;0
14800;ENSG00000086589;RBM22;5;150070356;150080669;10313;0
14801;ENSG00000086712;TXLNG;X;16804550;16862642;58092;0
14802;ENSG00000086717;PPEF1;X;18694029;18846039;152010;0
14803;ENSG00000086730;LAT2;7;73613982;73644161;30179;0
14804;ENSG00000086758;HUWE1;X;53559057;53713673;154616;0
14805;ENSG00000087077;TRIP6;7;100464760;100471076;6316;0
14806;ENSG00000087085;ACHE;7;100487615;100494594;6979;0
14807;ENSG00000087087;SRRT;7;100472733;100486285;13552;0
14808;ENSG00000087206;UIMC1;5;176332006;176449634;117628;0
14809;ENSG00000087842;PIR;X;15402921;15511687;108766;0
14810;ENSG00000089289;IGBP1;X;69353299;69386174;32875;0
14811;ENSG00000089472;HEPH;X;65382391;65488709;106318;0
14812;ENSG00000089682;RBM41;X;106307650;106362057;54407;0
14813;ENSG00000089820;ARHGAP4;X;153172821;153200452;27631;0
14814;ENSG00000090054;SPTLC1;9;94794281;94877666;83385;0
14815;ENSG00000090263;MRPS33;7;140705854;140715028;9174;0
14816;ENSG00000090266;NDUFB2;7;140390577;140422590;32013;0
14817;ENSG00000090776;EFNB1;X;68048840;68061990;13150;0
14818;ENSG00000090889;KIF4A;X;69509879;69640682;130803;1
14819;ENSG00000091009;RBM27;5;145583113;145718814;135701;0
14820;ENSG00000091010;POU4F3;5;145718587;145720083;1496;0
14821;ENSG00000091073;DTX2;7;76090993;76135312;44319;0
14822;ENSG00000091127;PUS7;7;105080108;105162714;82606;0
14823;ENSG00000091128;LAMB4;7;107663993;107770801;106808;0
14824;ENSG00000091129;NRCAM;7;107788068;108097161;309093;0
14825;ENSG00000091136;LAMB1;7;107564244;107643700;79456;0
14826;ENSG00000091140;DLD;7;107531415;107572175;40760;0
14827;ENSG00000091656;ZFHX4;8;77593454;77779521;186067;0
14828;ENSG00000091732;ZC3HC1;7;129658126;129691291;33165;0
14829;ENSG00000091844;RGS17;6;153325594;153452384;126790;0
14830;ENSG00000091879;ANGPT2;8;6357172;6420930;63758;0
14831;ENSG00000092421;SEMA6A;5;115779312;115910630;131318;0
14832;ENSG00000092820;EZR;6;159186773;159240444;53671;0
14833;ENSG00000092964;DPYSL2;8;26371791;26515694;143903;0
14834;ENSG00000093144;ECHDC1;6;127609855;127664754;54899;0
14835;ENSG00000094631;HDAC6;X;48659784;48683392;23608;0
14836;ENSG00000094841;UPRT;X;74493920;74524435;30515;0
14837;ENSG00000094880;CDC23;5;137523339;137549032;25693;0
14838;ENSG00000095203;EPB41L4B;9;111934255;112083244;148989;0
14839;ENSG00000095209;TMEM38B;9;108456825;108538893;82068;0
14840;ENSG00000095261;PSMD5;9;123577774;123605262;27488;0
14841;ENSG00000095303;PTGS1;9;125132824;125157982;25158;0
14842;ENSG00000095319;NUP188;9;131709978;131769375;59397;0
14843;ENSG00000095321;CRAT;9;131857089;131873468;16379;0
14844;ENSG00000095370;SH2D3C;9;130500596;130541020;40424;0
14845;ENSG00000095380;NANS;9;100819021;100845357;26336;0
14846;ENSG00000095383;TBC1D2;9;100961311;101017915;56604;0
14847;ENSG00000095397;DFNB31;9;117164360;117267730;103370;0
14848;ENSG00000095951;HIVEP1;6;12008995;12165232;156237;0
14849;ENSG00000096060;FKBP5;6;35541362;35696360;154998;0
14850;ENSG00000096063;SRPK1;6;35800743;35889119;88376;0
14851;ENSG00000096070;BRPF3;6;36164521;36200567;36046;0
14852;ENSG00000096080;MRPS18A;6;43639040;43655528;16488;0
14853;ENSG00000096092;TMEM14A;6;52535907;52551386;15479;0
14854;ENSG00000096093;EFHC1;6;52285106;52387892;102786;0
14855;ENSG00000096384;HSP90AB1;6;44214824;44221620;6796;0
14856;ENSG00000096401;CDC5L;6;44355262;44418163;62901;0
14857;ENSG00000096433;ITPR3;6;33588142;33664351;76209;0
14858;ENSG00000096654;ZNF184;6;27418522;27440897;22375;0
14859;ENSG00000096872;IFT74;9;26947037;27062928;115891;0
14860;ENSG00000096968;JAK2;9;4985033;5128183;143150;0
14861;ENSG00000097007;ABL1;9;133589333;133763062;173729;0
14862;ENSG00000099139;PCSK5;9;78505560;78977255;471695;0
14863;ENSG00000099219;ERMP1;9;5765076;5833117;68041;1
14864;ENSG00000099715;PCDH11Y;Y;4868267;5610265;741998;0
14865;ENSG00000099725;PRKY;Y;7142013;7249589;107576;1
14866;ENSG00000099810;MTAP;9;21802542;21931646;129104;0
14867;ENSG00000101811;CSTF2;X;100075384;100095921;20537;0
14868;ENSG00000101825;MXRA5;X;3226606;3264682;38076;0
14869;ENSG00000101843;PSMD10;X;107327437;107334848;7411;0
14870;ENSG00000101844;ATG4A;X;107334898;107397901;63003;0
14871;ENSG00000101846;STS;X;7137497;7272851;135354;0
14872;ENSG00000101849;TBL1X;X;9431335;9687780;256445;0
14873;ENSG00000101850;GPR143;X;9693386;9754337;60951;0
14874;ENSG00000101856;PGRMC1;X;118370216;118378429;8213;0
14875;ENSG00000101868;POLA1;X;24712036;25015103;303067;0
14876;ENSG00000101871;MID1;X;10413350;10851773;438423;0
14877;ENSG00000101882;NKAP;X;119059014;119077735;18721;0
14878;ENSG00000101888;NXT2;X;108779010;108787919;8909;0
14879;ENSG00000101890;GUCY2F;X;108616135;108725301;109166;0
14880;ENSG00000101901;ALG13;X;110909043;111003877;94834;0
14881;ENSG00000101911;PRPS2;X;12809474;12842341;32867;0
14882;ENSG00000101928;MOSPD1;X;134021656;134049297;27641;0
14883;ENSG00000101935;AMMECR1;X;109437414;109683461;246047;0
14884;ENSG00000101938;CHRDL1;X;109917084;110039286;122202;0
14885;ENSG00000101940;WDR13;X;48448430;48463581;15151;0
14886;ENSG00000101945;SUV39H1;X;48553945;48567403;13458;0
14887;ENSG00000101955;SRPX;X;38008589;38080696;72107;0
14888;ENSG00000101958;GLRA2;X;14547420;14749934;202514;0
14889;ENSG00000101966;XIAP;X;122993574;123047829;54255;0
14890;ENSG00000101972;STAG2;X;123094062;123556514;462452;0
14891;ENSG00000101974;ATP11C;X;138808505;139027435;218930;0
14892;ENSG00000101977;MCF2;X;138663929;138790386;126457;0
14893;ENSG00000101986;ABCD1;X;152990323;153010216;19893;0
14894;ENSG00000101997;CCDC22;X;49091927;49106987;15060;0
14895;ENSG00000102003;SYP;X;49044269;49056718;12449;0
14896;ENSG00000102007;PLP2;X;49028273;49031588;3315;1
14897;ENSG00000102024;PLS3;X;114795501;114885181;89680;0
14898;ENSG00000102030;NAA10;X;153194695;153200676;5981;0
14899;ENSG00000102032;RENBP;X;153200716;153210232;9516;0
14900;ENSG00000102034;ELF4;X;129198849;129244691;45842;0
14901;ENSG00000102038;SMARCA1;X;128580480;128657477;76997;0
14902;ENSG00000102043;MTMR8;X;63444187;63615333;171146;0
14903;ENSG00000102053;ZC3H12B;X;64708615;64727767;19152;0
14904;ENSG00000102054;RBBP7;X;16857406;16888537;31131;0
14905;ENSG00000102057;KCND1;X;48818639;48827976;9337;0
14906;ENSG00000102078;SLC25A14;X;129473874;129507335;33461;0
14907;ENSG00000102081;FMR1;X;146993469;147032645;39176;0
14908;ENSG00000102096;PIM2;X;48770459;48776301;5842;0
14909;ENSG00000102098;SCML2;X;18257434;18372847;115413;0
14910;ENSG00000102100;SLC35A2;X;48760459;48769235;8776;0
14911;ENSG00000102103;PQBP1;X;48755195;48760420;5225;0
14912;ENSG00000102109;PCSK1N;X;48689504;48694035;4531;0
14913;ENSG00000102119;EMD;X;153607557;153609883;2326;0
14914;ENSG00000102125;TAZ;X;153639854;153650065;10211;0
14915;ENSG00000102128;RAB40AL;X;102192200;102193228;1028;0
14916;ENSG00000102144;PGK1;X;77320685;77384793;64108;0
14917;ENSG00000102158;MAGT1;X;77081861;77151090;69229;0
14918;ENSG00000102172;SMS;X;21958691;22025798;67107;0
14919;ENSG00000102174;PHEX;X;22050559;22269427;218868;0
14920;ENSG00000102178;UBL4A;X;153712056;153715009;2953;0
14921;ENSG00000102181;CD99L2;X;149934810;150067289;132479;0
14922;ENSG00000102218;RP2;X;46696375;46741793;45418;0
14923;ENSG00000102221;JADE3;X;46771711;46920641;148930;0
14924;ENSG00000102225;CDK16;X;47077259;47089396;12137;0
14925;ENSG00000102226;USP11;X;47092089;47107727;15638;0
14926;ENSG00000102230;PCYT1B;X;24576204;24690794;114590;0
14927;ENSG00000102241;HTATSF1;X;135579238;135594505;15267;0
14928;ENSG00000102265;TIMP1;X;47441712;47446188;4476;0
14929;ENSG00000102271;KLHL4;X;86772752;86925050;152298;0
14930;ENSG00000102287;GABRE;X;151121596;151143152;21556;0
14931;ENSG00000102290;PCDH11X;X;91034260;91878229;843969;1
14932;ENSG00000102302;FGD1;X;54471887;54522599;50712;0
14933;ENSG00000102309;PIN4;X;71401203;71522776;121573;0
14934;ENSG00000102312;PORCN;X;48367350;48379202;11852;0
14935;ENSG00000102316;MAGED2;X;54834032;54842445;8413;0
14936;ENSG00000102317;RBM3;X;48432837;48437454;4617;0
14937;ENSG00000102349;KLF8;X;56258854;56314322;55468;1
14938;ENSG00000102359;SRPX2;X;99899215;99926296;27081;0
14939;ENSG00000102362;SYTL4;X;99929488;99987110;57622;0
14940;ENSG00000102383;ZDHHC15;X;74588262;74743337;155075;0
14941;ENSG00000102384;CENPI;X;100353178;100418670;65492;0
14942;ENSG00000102385;DRP2;X;100474758;100519486;44728;0
14943;ENSG00000102390;PBDC1;X;75392771;75398039;5268;0
14944;ENSG00000102393;GLA;X;100652791;100662913;10122;0
14945;ENSG00000102401;ARMCX3;X;100877787;100882833;5046;0
14946;ENSG00000102409;BEX4;X;102470020;102472174;2154;0
14947;ENSG00000104205;SGK3;8;67624653;67774257;149604;0
14948;ENSG00000104213;PDGFRL;8;17433942;17501580;67638;0
14949;ENSG00000104218;CSPP1;8;67974661;68108498;133837;0
14950;ENSG00000104219;ZDHHC2;8;17013538;17082308;68770;0
14951;ENSG00000104221;BRF2;8;37700786;37707422;6636;0
14952;ENSG00000104228;TRIM35;8;27142404;27168836;26432;0
14953;ENSG00000104231;ZFAND1;8;82613569;82645138;31569;0
14954;ENSG00000104267;CA2;8;86376081;86393722;17641;0
14955;ENSG00000104290;FZD3;8;28351729;28431775;80046;0
14956;ENSG00000104299;INTS9;8;28625178;28747759;122581;0
14957;ENSG00000104312;RIPK2;8;90769975;90803291;33316;0
14958;ENSG00000104313;EYA1;8;72109668;72274467;164799;0
14959;ENSG00000104320;NBN;8;90945564;91015456;69892;0
14960;ENSG00000104324;CPQ;8;97657455;98161882;504427;1
14961;ENSG00000104325;DECR1;8;91013633;91064320;50687;0
14962;ENSG00000104327;CALB1;8;91070836;91107703;36867;0
14963;ENSG00000104331;IMPAD1;8;57870492;57906403;35911;0
14964;ENSG00000104332;SFRP1;8;41119481;41167016;47535;0
14965;ENSG00000104341;LAPTM4B;8;98787285;98865241;77956;0
14966;ENSG00000104343;UBE2W;8;74692332;74791145;98813;0
14967;ENSG00000104356;POP1;8;99129525;99172062;42537;0
14968;ENSG00000104361;NIPAL2;8;99202061;99306621;104560;0
14969;ENSG00000104365;IKBKB;8;42128820;42189973;61153;0
14970;ENSG00000104368;PLAT;8;42032236;42065242;33006;1
14971;ENSG00000104369;JPH1;8;75146935;75233563;86628;0
14972;ENSG00000104375;STK3;8;99413631;99955055;541424;0
14973;ENSG00000104381;GDAP1;8;75233365;75401107;167742;0
14974;ENSG00000104388;RAB2A;8;61429416;61536186;106770;0
14975;ENSG00000104408;EIF3E;8;109213445;109447562;234117;0
14976;ENSG00000104412;EMC2;8;109455830;109499145;43315;0
14977;ENSG00000104413;ESRP1;8;95653302;95719694;66392;0
14978;ENSG00000104419;NDRG1;8;134249414;134314265;64851;0
14979;ENSG00000104427;ZC2HC1A;8;79578282;79632000;53718;0
14980;ENSG00000104432;IL7;8;79587978;79717758;129780;0
14981;ENSG00000104435;STMN2;8;80523049;80578410;55361;0
14982;ENSG00000104442;ARMC1;8;66514694;66546442;31748;0
14983;ENSG00000104447;TRPS1;8;116420724;116821899;401175;0
14984;ENSG00000104450;SPAG1;8;101170134;101271506;101372;0
14985;ENSG00000104472;CHRAC1;8;141521397;141527236;5839;0
14986;ENSG00000104490;NCALD;8;102698771;103137135;438364;0
14987;ENSG00000104497;SNX16;8;82711816;82755101;43285;0
14988;ENSG00000104517;UBR5;8;103265240;103425069;159829;0
14989;ENSG00000104522;TSTA3;8;144694788;144700218;5430;0
14990;ENSG00000104524;PYCRL;8;144686083;144691943;5860;0
14991;ENSG00000104529;EEF1D;8;144661867;144681711;19844;0
14992;ENSG00000104549;SQLE;8;126010739;126034525;23786;0
14993;ENSG00000104613;INTS10;8;19674651;19709594;34943;0
14994;ENSG00000104626;ERI1;8;8859657;8974256;114599;0
14995;ENSG00000104635;SLC39A14;8;22224762;22291642;66880;0
14996;ENSG00000104643;MTMR9;8;11141925;11185646;43721;0
14997;ENSG00000104660;LEPROTL1;8;29952914;30034724;81810;0
14998;ENSG00000104671;DCTN6;8;30013813;30041156;27343;0
14999;ENSG00000104679;R3HCC1;8;23127633;23153792;26159;0
15000;ENSG00000104687;GSR;8;30535583;30585443;49860;0
15001;ENSG00000104691;UBXN8;8;30589764;30624522;34758;0
15002;ENSG00000104695;PPP2CB;8;30631973;30671830;39857;0
15003;ENSG00000104714;ERICH1;8;564746;688106;123360;0
15004;ENSG00000104722;NEFM;8;24770525;24776607;6082;0
15005;ENSG00000104723;TUSC3;8;15274724;15624158;349434;0
15006;ENSG00000104725;NEFL;8;24808468;24814624;6156;0
15007;ENSG00000104728;ARHGEF10;8;1772142;1906807;134665;0
15008;ENSG00000104738;MCM4;8;48872745;48890720;17975;0
15009;ENSG00000104756;KCTD9;8;25285366;25315992;30626;0
15010;ENSG00000104763;ASAH1;8;17913934;17942494;28560;0
15011;ENSG00000104765;BNIP3L;8;26240414;26363152;122738;0
15012;ENSG00000105339;DENND3;8;142127377;142205907;78530;0
15013;ENSG00000105778;AVL9;7;32535038;33078516;543478;0
15014;ENSG00000105784;RUNDC3B;7;87256864;87461611;204747;0
15015;ENSG00000105792;C7orf63;7;89874488;89940377;65889;0
15016;ENSG00000105793;GTPBP10;7;89964537;90020769;56232;0
15017;ENSG00000105808;RASA4;7;102220093;102257204;37111;0
15018;ENSG00000105810;CDK6;7;92234235;92465908;231673;0
15019;ENSG00000105819;PMPCB;7;102937869;102969958;32089;0
15020;ENSG00000105821;DNAJC2;7;102952921;102985320;32399;0
15021;ENSG00000105825;TFPI2;7;93514709;93520303;5594;1
15022;ENSG00000105829;BET1;7;93592074;93633694;41620;0
15023;ENSG00000105835;NAMPT;7;105888731;105926772;38041;0
15024;ENSG00000105849;TWISTNB;7;19735085;19748710;13625;0
15025;ENSG00000105852;PON3;7;94989256;95025680;36424;0
15026;ENSG00000105854;PON2;7;95034175;95064510;30335;0
15027;ENSG00000105855;ITGB8;7;20370325;20455377;85052;0
15028;ENSG00000105856;HBP1;7;106809406;106842974;33568;0
15029;ENSG00000105865;DUS4L;7;107203929;107218906;14977;0
15030;ENSG00000105866;SP4;7;21467652;21554440;86788;0
15031;ENSG00000105875;WDR91;7;134868590;134896316;27726;0
15032;ENSG00000105877;DNAH11;7;21582833;21941457;358624;0
15033;ENSG00000105879;CBLL1;7;107384142;107402112;17970;0
15034;ENSG00000105887;MTPN;7;135611509;135662101;50592;0
15035;ENSG00000105894;PTN;7;136912088;137028611;116523;0
15036;ENSG00000105926;MPP6;7;24612887;24733812;120925;0
15037;ENSG00000105928;DFNA5;7;24737972;24809244;71272;0
15038;ENSG00000105929;ATP6V0A4;7;138391040;138484305;93265;0
15039;ENSG00000105939;ZC3HAV1;7;138728266;138794465;66199;0
15040;ENSG00000105948;TTC26;7;138818490;138876732;58242;0
15041;ENSG00000105953;OGDH;7;44646171;44748665;102494;0
15042;ENSG00000105963;ADAP1;7;937540;995043;57503;0
15043;ENSG00000105967;TFEC;7;115575202;115799950;224748;0
15044;ENSG00000105968;H2AFV;7;44866390;44887682;21292;0
15045;ENSG00000105971;CAV2;7;115927434;116148595;221161;0
15046;ENSG00000105974;CAV1;7;116164839;116201233;36394;0
15047;ENSG00000105976;MET;7;116312444;116438440;125996;0
15048;ENSG00000105982;RNF32;7;156432975;156469824;36849;0
15049;ENSG00000105983;LMBR1;7;156461646;156685924;224278;0
15050;ENSG00000105993;DNAJB6;7;157128075;157210133;82058;0
15051;ENSG00000106003;LFNG;7;2552163;2568811;16648;0
15052;ENSG00000106004;HOXA5;7;27180671;27183287;2616;0
15053;ENSG00000106006;HOXA6;7;27185015;27190222;5207;0
15054;ENSG00000106009;BRAT1;7;2577511;2595361;17850;0
15055;ENSG00000106012;IQCE;7;2598632;2654368;55736;0
15056;ENSG00000106018;VIPR2;7;158820866;158937649;116783;0
15057;ENSG00000106025;TSPAN12;7;120427376;120498456;71080;0
15058;ENSG00000106028;SSBP1;7;141438121;141487722;49601;0
15059;ENSG00000106049;HIBADH;7;27565061;27702614;137553;0
15060;ENSG00000106052;TAX1BP1;7;27778950;27884183;105233;0
15061;ENSG00000106066;CPVL;7;29034847;29235067;200220;0
15062;ENSG00000106069;CHN2;7;29161890;29553944;392054;0
15063;ENSG00000106070;GRB10;7;50657760;50861159;203399;0
15064;ENSG00000106077;ABHD11;7;73150424;73153197;2773;0
15065;ENSG00000106078;COBL;7;51083909;51384515;300606;0
15066;ENSG00000106080;FKBP14;7;30050203;30066300;16097;0
15067;ENSG00000106086;PLEKHA8;7;30067020;30170096;103076;0
15068;ENSG00000106089;STX1A;7;73113536;73134002;20466;0
15069;ENSG00000106100;NOD1;7;30464143;30518400;54257;0
15070;ENSG00000106105;GARS;7;30634297;30673649;39352;0
15071;ENSG00000106123;EPHB6;7;142552792;142568847;16055;0
15072;ENSG00000106125;FAM188B;7;30811033;30932002;120969;0
15073;ENSG00000106128;GHRHR;7;30978284;31032869;54585;0
15074;ENSG00000106133;NSUN5P2;7;72418120;72425329;7209;0
15075;ENSG00000106144;CASP2;7;142985308;143004789;19481;0
15076;ENSG00000106153;CHCHD2;7;56169262;56174269;5007;0
15077;ENSG00000106211;HSPB1;7;75931861;75933612;1751;0
15078;ENSG00000106236;NPTX2;7;98246609;98259180;12571;0
15079;ENSG00000106244;PDAP1;7;98989671;99006452;16781;0
15080;ENSG00000106245;BUD31;7;99006264;99017239;10975;0
15081;ENSG00000106246;PTCD1;7;99014362;99063787;49425;0
15082;ENSG00000106261;ZKSCAN1;7;99613204;99639312;26108;0
15083;ENSG00000106263;EIF3B;7;2393721;2420380;26659;0
15084;ENSG00000106266;SNX8;7;2291405;2393953;102548;0
15085;ENSG00000106268;NUDT1;7;2281857;2290781;8924;0
15086;ENSG00000106278;PTPRZ1;7;121513143;121702090;188947;0
15087;ENSG00000106290;TAF6;7;99704693;99717464;12771;0
15088;ENSG00000106299;WASL;7;123321989;123389121;67132;0
15089;ENSG00000106305;AIMP2;7;6048876;6063465;14589;0
15090;ENSG00000106327;TFR2;7;100218039;100240402;22363;0
15091;ENSG00000106328;FSCN3;7;127231463;127242198;10735;0
15092;ENSG00000106330;MOSPD3;7;100209725;100213007;3282;0
15093;ENSG00000106333;PCOLCE;7;100199800;100205798;5998;0
15094;ENSG00000106336;FBXO24;7;100181605;100198740;17135;0
15095;ENSG00000106341;PPP1R17;7;31726329;31748069;21740;0
15096;ENSG00000106344;RBM28;7;127937738;127983962;46224;0
15097;ENSG00000106346;USP42;7;6144515;6201195;56680;0
15098;ENSG00000106348;IMPDH1;7;128032331;128050306;17975;0
15099;ENSG00000106351;AGFG2;7;100136834;100165842;29008;0
15100;ENSG00000106355;LSM5;7;32524951;32534895;9944;0
15101;ENSG00000106366;SERPINE1;7;100770370;100782547;12177;1
15102;ENSG00000106367;AP1S1;7;100797678;100804877;7199;0
15103;ENSG00000106392;C1GALT1;7;7196565;7288282;91717;0
15104;ENSG00000106397;PLOD3;7;100849258;100861701;12443;0
15105;ENSG00000106399;RPA3;7;7676149;7758238;82089;0
15106;ENSG00000106400;ZNHIT1;7;100860949;100867471;6522;0
15107;ENSG00000106404;CLDN15;7;100875373;100882101;6728;0
15108;ENSG00000106415;GLCCI1;7;8008425;8133902;125477;0
15109;ENSG00000106443;PHF14;7;11013499;11209250;195751;0
15110;ENSG00000106459;NRF1;7;129251555;129396922;145367;0
15111;ENSG00000106460;TMEM106B;7;12250867;12282993;32126;0
15112;ENSG00000106462;EZH2;7;148504475;148581413;76938;0
15113;ENSG00000106477;CEP41;7;130033612;130082274;48662;0
15114;ENSG00000106479;ZNF862;7;149535456;149564568;29112;0
15115;ENSG00000106483;SFRP4;7;37945543;38065297;119754;0
15116;ENSG00000106484;MEST;7;130126012;130146133;20121;1
15117;ENSG00000106524;ANKMY2;7;16639401;16685442;46041;0
15118;ENSG00000106526;ACTR3C;7;149941005;150020814;79809;0
15119;ENSG00000106536;POU6F2;7;39017598;39532694;515096;0
15120;ENSG00000106537;TSPAN13;7;16793160;16824161;31001;0
15121;ENSG00000106538;RARRES2;7;150035408;150038763;3355;0
15122;ENSG00000106546;AHR;7;17338246;17385776;47530;0
15123;ENSG00000106554;CHCHD3;7;132469629;132766848;297219;0
15124;ENSG00000106571;GLI3;7;42000548;42277469;276921;1
15125;ENSG00000106588;PSMA2;7;42956460;42971822;15362;0
15126;ENSG00000106591;MRPL32;7;42971799;42988557;16758;0
15127;ENSG00000106603;COA1;7;43648055;43769316;121261;0
15128;ENSG00000106605;BLVRA;7;43798279;43846939;48660;0
15129;ENSG00000106608;URGCP;7;43915493;43966010;50517;0
15130;ENSG00000106609;TMEM248;7;66386212;66423538;37326;0
15131;ENSG00000106610;STAG3L4;7;66767608;66786513;18905;0
15132;ENSG00000106615;RHEB;7;151163098;151217206;54108;0
15133;ENSG00000106617;PRKAG2;7;151253197;151574210;321013;0
15134;ENSG00000106624;AEBP1;7;44143960;44154161;10201;1
15135;ENSG00000106628;POLD2;7;44154286;44163957;9671;0
15136;ENSG00000106633;GCK;7;44183872;44237769;53897;0
15137;ENSG00000106635;BCL7B;7;72950686;72972332;21646;0
15138;ENSG00000106636;YKT6;7;44240567;44253893;13326;0
15139;ENSG00000106638;TBL2;7;72983262;72993121;9859;0
15140;ENSG00000106665;CLIP2;7;73703805;73820273;116468;0
15141;ENSG00000106682;EIF4H;7;73588575;73611431;22856;0
15142;ENSG00000106683;LIMK1;7;73497263;73536855;39592;0
15143;ENSG00000106686;SPATA6L;9;4553386;4666674;113288;0
15144;ENSG00000106688;SLC1A1;9;4490444;4587469;97025;1
15145;ENSG00000106689;LHX2;9;126763949;126795580;31631;0
15146;ENSG00000106692;FKTN;9;108320411;108403399;82988;0
15147;ENSG00000106701;FSD1L;9;108210077;108314714;104637;0
15148;ENSG00000106714;CNTNAP3;9;39072764;39288312;215548;0
15149;ENSG00000106723;SPIN1;9;91003334;91093609;90275;0
15150;ENSG00000106733;NMRK1;9;77675489;77703133;27644;1
15151;ENSG00000106771;TMEM245;9;111777432;111882225;104793;0
15152;ENSG00000106772;PRUNE2;9;79226292;79521003;294711;0
15153;ENSG00000106780;MEGF9;9;123363091;123476748;113657;0
15154;ENSG00000106785;TRIM14;9;100831557;100881494;49937;0
15155;ENSG00000106789;CORO2A;9;100883257;100954922;71665;0
15156;ENSG00000106799;TGFBR1;9;101866320;101916474;50154;0
15157;ENSG00000106803;SEC61B;9;101984346;101992897;8551;0
15158;ENSG00000106804;C5;9;123714616;123812554;97938;0
15159;ENSG00000106823;ECM2;9;95256365;95298937;42572;0
15160;ENSG00000106829;TLE4;9;82186688;82341658;154970;0
15161;ENSG00000106852;LHX6;9;124964856;124991905;27049;0
15162;ENSG00000106853;PTGR1;9;114312002;114362135;50133;1
15163;ENSG00000106868;SUSD1;9;114803065;114937688;134623;0
15164;ENSG00000106948;AKNA;9;117096436;117156685;60249;0
15165;ENSG00000106976;DNM1;9;130965658;131017527;51869;0
15166;ENSG00000106991;ENG;9;130577291;130617035;39744;0
15167;ENSG00000106992;AK1;9;130628759;130640022;11263;0
15168;ENSG00000106993;CDC37L1;9;4679559;4708398;28839;0
15169;ENSG00000107014;RLN2;9;5299868;5304969;5101;0
15170;ENSG00000107020;PLGRKT;9;5357973;5437878;79905;0
15171;ENSG00000107021;TBC1D13;9;131549483;131572711;23228;0
15172;ENSG00000107036;KIAA1432;9;5629025;5776557;147532;0
15173;ENSG00000107077;KDM4C;9;6720863;7175648;454785;0
15174;ENSG00000107104;KANK1;9;470291;746105;275814;0
15175;ENSG00000107105;ELAVL2;9;23690102;23826335;136233;0
15176;ENSG00000107130;NCS1;9;132934857;132999583;64726;0
15177;ENSG00000107140;TESK1;9;35605367;35610038;4671;0
15178;ENSG00000107147;KCNT1;9;138594031;138684992;90961;0
15179;ENSG00000107164;FUBP3;9;133454352;133513739;59387;0
15180;ENSG00000107175;CREB3;9;35732332;35737001;4669;0
15181;ENSG00000107185;RGP1;9;35749203;35758572;9369;0
15182;ENSG00000107186;MPDZ;9;13105703;13279589;173886;0
15183;ENSG00000107201;DDX58;9;32455300;32526322;71022;0
15184;ENSG00000107223;EDF1;9;139756571;139760738;4167;0
15185;ENSG00000107242;PIP5K1B;9;71320575;71624092;303517;0
15186;ENSG00000107249;GLIS3;9;3824127;4348392;524265;1
15187;ENSG00000107262;BAG1;9;33247818;33264761;16943;0
15188;ENSG00000107263;RAPGEF1;9;134452157;134615461;163304;0
15189;ENSG00000107281;NPDC1;9;139933922;139940655;6733;0
15190;ENSG00000107282;APBA1;9;72042446;72287222;244776;0
15191;ENSG00000107290;SETX;9;135136743;135230372;93629;0
15192;ENSG00000107295;SH3GL2;9;17579080;17797127;218047;1
15193;ENSG00000107317;PTGDS;9;139871956;139879887;7931;0
15194;ENSG00000107331;ABCA2;9;139901686;139923367;21681;0
15195;ENSG00000107338;SHB;9;37919131;38069210;150079;0
15196;ENSG00000107341;UBE2R2;9;33817565;33920402;102837;0
15197;ENSG00000107362;ABHD17B;9;74477368;74525847;48479;0
15198;ENSG00000107371;EXOSC3;9;37766975;37801434;34459;0
15199;ENSG00000107372;ZFAND5;9;74966341;74980163;13822;0
15200;ENSG00000111799;COL12A1;6;75794042;75915767;121725;0
15201;ENSG00000111801;BTN3A3;6;26440700;26453643;12943;0
15202;ENSG00000111802;TDP2;6;24650205;24667261;17056;0
15203;ENSG00000111816;FRK;6;116252312;116381921;129609;0
15204;ENSG00000111817;DSE;6;116575336;116762424;187088;0
15205;ENSG00000111832;RWDD1;6;116892530;116918838;26308;0
15206;ENSG00000111834;RSPH4A;6;116937642;116954148;16506;0
15207;ENSG00000111837;MAK;6;10762956;10838764;75808;0
15208;ENSG00000111843;TMEM14C;6;10723148;10731362;8214;0
15209;ENSG00000111845;PAK1IP1;6;10694928;10710015;15087;0
15210;ENSG00000111846;GCNT2;6;10492456;10629601;137145;0
15211;ENSG00000111850;SMIM8;6;88032301;88052043;19742;0
15212;ENSG00000111859;NEDD9;6;11183531;11382581;199050;0
15213;ENSG00000111860;CEP85L;6;118781935;119031238;249303;0
15214;ENSG00000111875;ASF1A;6;119215384;119230332;14948;0
15215;ENSG00000111877;MCM9;6;119134605;119256327;121722;0
15216;ENSG00000111879;FAM184A;6;119280928;119470552;189624;0
15217;ENSG00000111880;RNGTT;6;89319985;89673348;353363;0
15218;ENSG00000111885;MAN1A1;6;119498374;119670926;172552;1
15219;ENSG00000111886;GABRR2;6;89966927;90025018;58091;0
15220;ENSG00000111897;SERINC1;6;122764499;122792967;28468;0
15221;ENSG00000111906;HDDC2;6;125541108;125623282;82174;0
15222;ENSG00000111907;TPD52L1;6;125440195;125585553;145358;1
15223;ENSG00000111911;HINT3;6;126277927;126301387;23460;0
15224;ENSG00000111912;NCOA7;6;126102307;126252266;149959;0
15225;ENSG00000111913;FAM65B;6;24797601;25042238;244637;0
15226;ENSG00000111961;SASH1;6;148593440;148873186;279746;0
15227;ENSG00000111962;UST;6;149068464;149398126;329662;0
15228;ENSG00000111981;ULBP1;6;150285143;150294846;9703;1
15229;ENSG00000112029;FBXO5;6;153291664;153304714;13050;0
15230;ENSG00000112031;MTRF1L;6;153308497;153323820;15323;0
15231;ENSG00000112033;PPARD;6;35310335;35395968;85633;0
15232;ENSG00000112038;OPRM1;6;154331631;154568001;236370;0
15233;ENSG00000112039;FANCE;6;35420138;35434880;14742;0
15234;ENSG00000112062;MAPK14;6;35995488;36079013;83525;0
15235;ENSG00000112078;KCTD20;6;36410544;36458920;48376;0
15236;ENSG00000112079;STK38;6;36461669;36515247;53578;0
15237;ENSG00000112081;SRSF3;6;36562145;36573377;11232;0
15238;ENSG00000112096;SOD2;6;160090089;160183561;93472;0
15239;ENSG00000112110;MRPL18;6;160210844;160219468;8624;0
15240;ENSG00000112118;MCM3;6;52128807;52149679;20872;1
15241;ENSG00000112130;RNF8;6;37321748;37362514;40766;0
15242;ENSG00000112137;PHACTR1;6;12717893;13288645;570752;0
15243;ENSG00000112139;MDGA1;6;37600284;37667082;66798;0
15244;ENSG00000112144;ICK;6;52866077;52926600;60523;0
15245;ENSG00000112146;FBXO9;6;52916789;52965671;48882;0
15246;ENSG00000112149;CD83;6;14117872;14137149;19277;0
15247;ENSG00000112159;MDN1;6;90352218;90529442;177224;0
15248;ENSG00000112167;SAYSD1;6;39071840;39082965;11125;0
15249;ENSG00000112175;BMP5;6;55618443;55740362;121919;0
15250;ENSG00000112182;BACH2;6;90636248;91006627;370379;0
15251;ENSG00000112183;RBM24;6;17281577;17294106;12529;0
15252;ENSG00000112186;CAP2;6;17393447;17558023;164576;0
15253;ENSG00000112200;ZNF451;6;56951642;57035105;83463;0
15254;ENSG00000112208;BAG2;6;57037124;57054631;17507;0
15255;ENSG00000112210;RAB23;6;57053607;57087078;33471;0
15256;ENSG00000112214;FHL5;6;97010424;97064512;54088;0
15257;ENSG00000112218;GPR63;6;97242002;97285353;43351;0
15258;ENSG00000112232;KHDRBS2;6;62389865;62996132;606267;0
15259;ENSG00000112234;FBXL4;6;99316420;99395849;79429;0
15260;ENSG00000112237;CCNC;6;99990256;100016849;26593;0
15261;ENSG00000112238;PRDM13;6;100054606;100063454;8848;0
15262;ENSG00000112242;E2F3;6;20402398;20493941;91543;0
15263;ENSG00000112245;PTP4A1;6;64231666;64293492;61826;0
15264;ENSG00000112246;SIM1;6;100832891;100912805;79914;0
15265;ENSG00000112249;ASCC3;6;100956070;101329248;373178;0
15266;ENSG00000112276;BVES;6;105544697;105585049;40352;0
15267;ENSG00000112280;COL9A1;6;70924764;71012786;88022;0
15268;ENSG00000112282;MED23;6;131895106;131949369;54263;0
15269;ENSG00000112290;WASF1;6;110421022;110501207;80185;0
15270;ENSG00000112293;GPLD1;6;24424793;24495433;70640;0
15271;ENSG00000112294;ALDH5A1;6;24495080;24537435;42355;0
15272;ENSG00000112297;AIM1;6;106959730;107018326;58596;0
15273;ENSG00000112304;ACOT13;6;24667263;24705293;38030;0
15274;ENSG00000112305;SMAP1;6;71377479;71571718;194239;0
15275;ENSG00000112306;RPS12;6;133135580;133138703;3123;0
15276;ENSG00000112308;C6orf62;6;24705089;24721064;15975;0
15277;ENSG00000112309;B3GAT2;6;71566382;71666741;100359;1
15278;ENSG00000112312;GMNN;6;24775159;24786327;11168;0
15279;ENSG00000112319;EYA4;6;133561736;133853258;291522;1
15280;ENSG00000112320;SOBP;6;107811162;107981357;170195;0
15281;ENSG00000112335;SNX3;6;108532426;108582464;50038;0
15282;ENSG00000112339;HBS1L;6;135281516;135424194;142678;0
15283;ENSG00000112357;PEX7;6;137143717;137235075;91358;0
15284;ENSG00000112365;ZBTB24;6;109783797;109804440;20643;0
15285;ENSG00000112367;FIG4;6;110012499;110146631;134132;0
15286;ENSG00000112378;PERP;6;138409642;138428648;19006;0
15287;ENSG00000112379;KIAA1244;6;138483058;138665800;182742;0
15288;ENSG00000112394;SLC16A10;6;111408781;111552397;143616;0
15289;ENSG00000112406;HECA;6;139456249;139501939;45690;0
15290;ENSG00000112414;GPR126;6;142622991;142767403;144412;0
15291;ENSG00000112419;PHACTR2;6;143857982;144152322;294340;0
15292;ENSG00000112425;EPM2A;6;145822719;146057160;234441;0
15293;ENSG00000112473;SLC39A7;6;33168222;33172216;3994;0
15294;ENSG00000112511;PHF1;6;33378176;33384230;6054;0
15295;ENSG00000112514;CUTA;6;33384219;33386094;1875;0
15296;ENSG00000112530;PACRG;6;163148164;163736524;588360;0
15297;ENSG00000112531;QKI;6;163835032;163999628;164596;0
15298;ENSG00000112539;C6orf118;6;165693153;165723096;29943;0
15299;ENSG00000112541;PDE10A;6;165740776;166400091;659315;0
15300;ENSG00000112559;MDFI;6;41604620;41621984;17364;0
15301;ENSG00000112561;TFEB;6;41651716;41703997;52281;0
15302;ENSG00000112562;SMOC2;6;168841831;169073984;232153;0
15303;ENSG00000112576;CCND3;6;41902671;42018095;115424;0
15304;ENSG00000112578;BYSL;6;41888926;41900784;11858;0
15305;ENSG00000112584;FAM120B;6;170599791;170716153;116362;0
15306;ENSG00000112592;TBP;6;170863390;170881958;18568;0
15307;ENSG00000112599;GUCA1B;6;42152139;42162654;10515;0
15308;ENSG00000112624;GLTSCR1L;6;42749765;42836298;86533;0
15309;ENSG00000112640;PPP2R5D;6;42952237;42980080;27843;0
15310;ENSG00000112651;MRPL2;6;43021767;43027544;5777;0
15311;ENSG00000112655;PTK7;6;43044006;43129457;85451;0
15312;ENSG00000112658;SRF;6;43139037;43149243;10206;0
15313;ENSG00000112659;CUL9;6;43149913;43192325;42412;0
15314;ENSG00000112667;DNPH1;6;43193367;43197222;3855;0
15315;ENSG00000112679;DUSP22;6;291630;351355;59725;0
15316;ENSG00000112685;EXOC2;6;485133;693117;207984;0
15317;ENSG00000112695;COX7A2;6;75947391;75960039;12648;0
15318;ENSG00000112697;TMEM30A;6;75962640;75994684;32044;0
15319;ENSG00000112699;GMDS;6;1624041;2245926;621885;0
15320;ENSG00000112701;SENP6;6;76311225;76427997;116772;0
15321;ENSG00000112706;IMPG1;6;76630832;76782395;151563;0
15322;ENSG00000112715;VEGFA;6;43737921;43754224;16303;0
15323;ENSG00000112739;PRPF4B;6;4021501;4065217;43716;0
15324;ENSG00000112742;TTK;6;80713604;80752244;38640;0
15325;ENSG00000112759;SLC29A1;6;44187242;44201888;14646;0
15326;ENSG00000112763;BTN2A1;6;26458150;26476849;18699;0
15327;ENSG00000112769;LAMA4;6;112429963;112576141;146178;1
15328;ENSG00000112773;FAM46A;6;82201156;82462491;261335;1
15329;ENSG00000112782;CLIC5;6;45868045;46048132;180087;0
15330;ENSG00000112796;ENPP5;6;46126924;46138708;11784;0
15331;ENSG00000112812;PRSS16;6;27215480;27224403;8923;0
15332;ENSG00000112852;PCDHB2;5;140474227;140476962;2735;0
15333;ENSG00000112855;HARS2;5;140071011;140078889;7878;0
15334;ENSG00000112874;NUDT12;5;102884556;102898494;13938;0
15335;ENSG00000112893;MAN2A1;5;109025067;109205326;180259;0
15336;ENSG00000112981;NME5;5;137450866;137475132;24266;0
15337;ENSG00000112983;BRD8;5;137475455;137514675;39220;0
15338;ENSG00000112984;KIF20A;5;137514408;137523404;8996;1
15339;ENSG00000113013;HSPA9;5;137890571;137911133;20562;0
15340;ENSG00000113068;PFDN1;5;139624624;139682706;58082;0
15341;ENSG00000113070;HBEGF;5;139712428;139726216;13788;0
15342;ENSG00000113083;LOX;5;121398890;121413980;15090;1
15343;ENSG00000113108;APBB3;5;139937853;139973337;35484;0
15344;ENSG00000113119;TMCO6;5;140019012;140024993;5981;0
15345;ENSG00000113140;SPARC;5;151040657;151066726;26069;0
15346;ENSG00000113141;IK;5;140026643;140042064;15421;0
15347;ENSG00000113161;HMGCR;5;74632154;74657929;25775;0
15348;ENSG00000113163;COL4A3BP;5;74664311;74807963;143652;0
15349;ENSG00000113194;FAF2;5;175874629;175937075;62446;0
15350;ENSG00000113205;PCDHB3;5;140480234;140483406;3172;0
15351;ENSG00000113209;PCDHB5;5;140514800;140517703;2903;1
15352;ENSG00000113211;PCDHB6;5;140529683;140532868;3185;0
15353;ENSG00000113212;PCDHB7;5;140552243;140555957;3714;0
15354;ENSG00000113231;PDE8B;5;76506274;76725632;219358;0
15355;ENSG00000113240;CLK4;5;178029665;178057616;27951;0
15356;ENSG00000113248;PCDHB15;5;140625147;140627799;2652;0
15357;ENSG00000113263;ITK;5;156569944;156682201;112257;0
15358;ENSG00000113269;RNF130;5;179338651;179499118;160467;0
15359;ENSG00000113272;THG1L;5;157158205;157168456;10251;0
15360;ENSG00000113273;ARSB;5;78073032;78281910;208878;1
15361;ENSG00000113282;CLINT1;5;157212751;157286183;73432;0
15362;ENSG00000113296;THBS4;5;79287134;79379110;91976;0
15363;ENSG00000113300;CNOT6;5;179921412;180005405;83993;0
15364;ENSG00000113312;TTC1;5;159436120;159492550;56430;0
15365;ENSG00000113318;MSH3;5;79950467;80172279;221812;0
15366;ENSG00000113319;RASGRF2;5;80256491;80525975;269484;0
15367;ENSG00000113327;GABRG2;5;161494546;161582542;87996;1
15368;ENSG00000113328;CCNG1;5;162864575;162873157;8582;0
15369;ENSG00000113356;POLR3G;5;89767565;89810370;42805;0
15370;ENSG00000113368;LMNB1;5;126112315;126172712;60397;0
15371;ENSG00000113369;ARRDC3;5;90664541;90679176;14635;0
15372;ENSG00000113391;FAM172A;5;92953775;93447404;493629;0
15373;ENSG00000113396;SLC27A6;5;127873706;128369335;495629;0
15374;ENSG00000113441;LNPEP;5;96271098;96373219;102121;0
15375;ENSG00000113522;RAD50;5;131891711;131980313;88602;0
15376;ENSG00000113532;ST8SIA4;5;100142639;100238970;96331;0
15377;ENSG00000113552;GNPDA1;5;141371314;141392606;21292;0
15378;ENSG00000113558;SKP1;5;133484633;133512729;28096;0
15379;ENSG00000113575;PPP2CA;5;133530025;133561833;31808;0
15380;ENSG00000113578;FGF1;5;141971743;142077617;105874;0
15381;ENSG00000113580;NR3C1;5;142657496;142815077;157581;0
15382;ENSG00000113583;C5orf15;5;133291201;133304478;13277;0
15383;ENSG00000113615;SEC24A;5;133984479;134063513;79034;0
15384;ENSG00000113621;TXNDC15;5;134209493;134237215;27722;0
15385;ENSG00000113643;RARS;5;167913450;167946304;32854;0
15386;ENSG00000113645;WWC1;5;167718656;167899308;180652;0
15387;ENSG00000113648;H2AFY;5;134669590;134735604;66014;0
15388;ENSG00000113649;TCERG1;5;145826874;145891524;64650;0
15389;ENSG00000113657;DPYSL3;5;146770374;146889619;119245;0
15390;ENSG00000113658;SMAD5;5;135468534;135524435;55901;0
15391;ENSG00000113712;CSNK1A1;5;148871760;148931007;59247;0
15392;ENSG00000113716;HMGXB3;5;149379884;149432386;52502;0
15393;ENSG00000113719;ERGIC1;5;172261278;172379688;118410;0
15394;ENSG00000113721;PDGFRB;5;149493400;149535435;42035;0
15395;ENSG00000113732;ATP6V0E1;5;172410760;172462448;51688;0
15396;ENSG00000113734;BNIP1;5;172571445;172591390;19945;0
15397;ENSG00000113739;STC2;5;172741716;172756506;14790;1
15398;ENSG00000113742;CPEB4;5;173315283;173388979;73696;0
15399;ENSG00000113749;HRH2;5;175085033;175113245;28212;0
15400;ENSG00000113758;DBN1;5;176883609;176901402;17793;0
15401;ENSG00000113761;ZNF346;5;176449697;176508190;58493;0
15402;ENSG00000113763;UNC5A;5;176237478;176307897;70419;0
15403;ENSG00000114374;USP9Y;Y;14813160;14972764;159604;0
15404;ENSG00000117868;ESYT2;7;158523686;158622944;99258;0
15405;ENSG00000118322;ATP10B;5;159990127;160279221;289094;0
15406;ENSG00000118402;ELOVL4;6;80624529;80657297;32768;0
15407;ENSG00000118407;FILIP1;6;76001575;76203454;201879;1
15408;ENSG00000118412;CASP8AP2;6;90539613;90584155;44542;0
15409;ENSG00000118418;HMGN3;6;79910962;79944406;33444;0
15410;ENSG00000118420;UBE3D;6;83602117;83775560;173443;0
15411;ENSG00000118432;CNR1;6;88849583;88876078;26495;1
15412;ENSG00000118482;PHF3;6;64345725;64489229;143504;0
15413;ENSG00000118491;ZC2HC1B;6;144185573;144259483;73910;0
15414;ENSG00000118495;PLAGL1;6;144261437;144385735;124298;1
15415;ENSG00000118496;FBXO30;6;146114638;146135889;21251;0
15416;ENSG00000118503;TNFAIP3;6;138188351;138204449;16098;0
15417;ENSG00000118507;AKAP7;6;131456806;131604675;147869;0
15418;ENSG00000118508;RAB32;6;146864829;146876101;11272;0
15419;ENSG00000118513;MYB;6;135502453;135540311;37858;0
15420;ENSG00000118514;ALDH8A1;6;135238528;135271260;32732;1
15421;ENSG00000118515;SGK1;6;134490384;134639250;148866;0
15422;ENSG00000118518;RNF146;6;127587755;127609712;21957;0
15423;ENSG00000118523;CTGF;6;132269316;132272513;3197;0
15424;ENSG00000118689;FOXO3;6;108881038;109005977;124939;0
15425;ENSG00000118690;ARMC2;6;109169619;109295186;125567;0
15426;ENSG00000118985;ELL2;5;95220802;95297775;76973;0
15427;ENSG00000119048;UBE2B;5;133706870;133727683;20813;0
15428;ENSG00000119121;TRPM6;9;77337411;77503010;165599;0
15429;ENSG00000119125;GDA;9;74729511;74872109;142598;1
15430;ENSG00000119138;KLF9;9;72999503;73029540;30037;0
15431;ENSG00000119139;TJP2;9;71736209;71870124;133915;0
15432;ENSG00000119314;PTBP3;9;114980715;115095947;115232;0
15433;ENSG00000119318;RAD23B;9;110045418;110094475;49057;0
15434;ENSG00000119321;FKBP15;9;115923286;115983641;60355;0
15435;ENSG00000119326;CTNNAL1;9;111704851;111775809;70958;0
15436;ENSG00000119328;FAM206A;9;111696461;111713024;16563;0
15437;ENSG00000119333;WDR34;9;131395940;131419066;23126;0
15438;ENSG00000119335;SET;9;131445703;131458679;12976;0
15439;ENSG00000119383;PPP2R4;9;131873229;131911225;37996;0
15440;ENSG00000119392;GLE1;9;131266979;131304567;37588;0
15441;ENSG00000119396;RAB14;9;123940415;123985292;44877;0
15442;ENSG00000119397;CNTRL;9;123837141;123939888;102747;0
15443;ENSG00000119401;TRIM32;9;119449581;119463579;13998;0
15444;ENSG00000119402;FBXW2;9;123514256;123555690;41434;0
15445;ENSG00000119403;PHF19;9;123617977;123639606;21629;1
15446;ENSG00000119408;NEK6;9;127019885;127115586;95701;1
15447;ENSG00000119414;PPP6C;9;127908852;127952218;43366;0
15448;ENSG00000119421;NDUFA8;9;124894745;124922098;27353;0
15449;ENSG00000119431;HDHD3;9;116135699;116139279;3580;0
15450;ENSG00000119446;RBM18;9;124999903;125027118;27215;0
15451;ENSG00000119471;HSDL2;9;115142217;115234690;92473;0
15452;ENSG00000119487;MAPKAP1;9;128199672;128469513;269841;0
15453;ENSG00000119508;NR4A3;9;102584137;102629173;45036;0
15454;ENSG00000119509;INVS;9;102861538;103063282;201744;0
15455;ENSG00000119514;GALNT12;9;101569981;101612363;42382;0
15456;ENSG00000119522;DENND1A;9;126141933;126692431;550498;0
15457;ENSG00000119523;ALG2;9;101978708;101984238;5530;0
15458;ENSG00000119899;SLC17A5;6;74303102;74363878;60776;0
15459;ENSG00000119900;OGFRL1;6;71998506;72018653;20147;0
15460;ENSG00000120129;DUSP1;5;172195093;172198198;3105;0
15461;ENSG00000120137;PANK3;5;167975500;168006605;31105;0
15462;ENSG00000120149;MSX2;5;174151536;174157896;6360;0
15463;ENSG00000120156;TEK;9;27109139;27230173;121034;0
15464;ENSG00000120158;RCL1;9;4792869;4885917;93048;0
15465;ENSG00000120159;CAAP1;9;26840683;26892802;52119;0
15466;ENSG00000120162;MOB3B;9;27325207;27529779;204572;0
15467;ENSG00000120253;NUP43;6;150045451;150070801;25350;0
15468;ENSG00000120254;MTHFD1L;6;151186685;151423023;236338;0
15469;ENSG00000120256;LRP11;6;150139934;150186199;46265;0
15470;ENSG00000120262;CCDC170;6;151815165;151942328;127163;0
15471;ENSG00000120265;PCMT1;6;150070579;150132556;61977;0
15472;ENSG00000120278;PLEKHG1;6;150920999;151164799;243800;0
15473;ENSG00000120306;CYSTM1;5;139554227;139661637;107410;0
15474;ENSG00000120314;WDR55;5;140044261;140053709;9448;0
15475;ENSG00000120318;ARAP3;5;141032968;141061788;28820;0
15476;ENSG00000120322;PCDHB8;5;140557371;140560081;2710;0
15477;ENSG00000120324;PCDHB10;5;140571942;140575215;3273;0
15478;ENSG00000120327;PCDHB14;5;140602931;140605858;2927;0
15479;ENSG00000120328;PCDHB12;5;140588269;140591696;3427;0
15480;ENSG00000120437;ACAT2;6;160181360;160200144;18784;0
15481;ENSG00000120438;TCP1;6;160199530;160210781;11251;0
15482;ENSG00000120509;PDZD11;X;69506445;69510364;3919;0
15483;ENSG00000120526;NUDCD1;8;110253148;110346614;93466;0
15484;ENSG00000120533;ENY2;8;110346553;110358182;11629;0
15485;ENSG00000120705;ETF1;5;137841784;137878989;37205;0
15486;ENSG00000120709;FAM53C;5;137667624;137685416;17792;0
15487;ENSG00000120725;SIL1;5;138282409;138629246;346837;0
15488;ENSG00000120727;PAIP2;5;138677276;138705406;28130;0
15489;ENSG00000120733;KDM3B;5;137688285;137772717;84432;0
15490;ENSG00000120738;EGR1;5;137801179;137805004;3825;1
15491;ENSG00000120875;DUSP4;8;29190581;29208185;17604;1
15492;ENSG00000120885;CLU;8;27454434;27472548;18114;0
15493;ENSG00000120889;TNFRSF10B;8;22877646;22926692;49046;0
15494;ENSG00000120896;SORBS3;8;22402499;22433301;30802;0
15495;ENSG00000120899;PTK2B;8;27168999;27316903;147904;0
15496;ENSG00000120907;ADRA1A;8;26605667;26724790;119123;0
15497;ENSG00000120910;PPP3CC;8;22298332;22398652;100320;0
15498;ENSG00000120913;PDLIM2;8;22435792;22455538;19746;0
15499;ENSG00000120915;EPHX2;8;27348296;27403081;54785;1
15500;ENSG00000120925;RNF170;8;42704780;42752433;47653;0
15501;ENSG00000120963;ZNF706;8;102190106;102218421;28315;0
15502;ENSG00000120992;LYPLA1;8;54958938;55014577;55639;0
15503;ENSG00000121005;CRISPLD1;8;75896750;75946793;50043;0
15504;ENSG00000121022;COPS5;8;67955314;67996018;40704;0
15505;ENSG00000121039;RDH10;8;74206847;74237516;30669;0
15506;ENSG00000121716;PILRB;7;99933737;99965356;31619;0
15507;ENSG00000122008;POLK;5;74807581;74896969;89388;0
15508;ENSG00000122012;SV2C;5;75378997;75649764;270767;0
15509;ENSG00000122126;OCRL;X;128673826;128726538;52712;0
15510;ENSG00000122140;MRPS2;9;138391830;138396519;4689;0
15511;ENSG00000122203;KIAA1191;5;175773064;175788971;15907;0
15512;ENSG00000122335;SERAC1;6;158530536;158589312;58776;0
15513;ENSG00000122507;BBS9;7;33168856;33645680;476824;0
15514;ENSG00000122512;PMS2;7;6012870;6048756;35886;0
15515;ENSG00000122515;ZMIZ2;7;44788180;44809477;21297;0
15516;ENSG00000122543;OCM;7;5919458;5925993;6535;0
15517;ENSG00000122545;07-Sep;7;35840542;35944917;104375;0
15518;ENSG00000122547;EEPD1;7;36192758;36341152;148394;0
15519;ENSG00000122550;KLHL7;7;23145353;23217533;72180;0
15520;ENSG00000122557;HERPUD2;7;35672269;35735181;62912;0
15521;ENSG00000122565;CBX3;7;26240782;26252976;12194;0
15522;ENSG00000122566;HNRNPA2B1;7;26229547;26241149;11602;0
15523;ENSG00000122574;WIPF3;7;29846102;29956682;110580;0
15524;ENSG00000122584;NXPH1;7;8473585;8792593;319008;1
15525;ENSG00000122585;NPY;7;24323782;24331484;7702;0
15526;ENSG00000122591;FAM126A;7;22980878;23053749;72871;0
15527;ENSG00000122641;INHBA;7;41724712;41742706;17994;0
15528;ENSG00000122642;FKBP9;7;32997017;33046543;49526;0
15529;ENSG00000122643;NT5C3A;7;33053742;33102409;48667;0
15530;ENSG00000122644;ARL4A;7;12726481;12730559;4078;0
15531;ENSG00000122674;CCZ1;7;5938356;5965605;27249;0
15532;ENSG00000122678;POLM;7;44111846;44122139;10293;0
15533;ENSG00000122687;FTSJ2;7;2273866;2281840;7974;0
15534;ENSG00000122691;TWIST1;7;19060614;19157295;96681;0
15535;ENSG00000122692;SMU1;9;33041762;33076665;34903;0
15536;ENSG00000122694;GLIPR2;9;36136732;36163910;27178;0
15537;ENSG00000122696;SLC25A51;9;37879400;37904350;24950;0
15538;ENSG00000122705;CLTA;9;36190853;36304778;113925;0
15539;ENSG00000122707;RECK;9;36036430;36124448;88018;0
15540;ENSG00000122729;ACO1;9;32384618;32454767;70149;0
15541;ENSG00000122733;KIAA1045;9;34957484;34982541;25057;0
15542;ENSG00000122735;DNAI1;9;34457412;34520982;63570;0
15543;ENSG00000122741;DCAF10;9;37800499;37867663;67164;0
15544;ENSG00000122756;CNTFR;9;34551430;34590121;38691;0
15545;ENSG00000122778;KIAA1549;7;138516126;138666064;149938;0
15546;ENSG00000122779;TRIM24;7;138145079;138274738;129659;0
15547;ENSG00000122783;C7orf49;7;134777115;134855547;78432;0
15548;ENSG00000122786;CALD1;7;134429003;134655479;226476;1
15549;ENSG00000122824;NUDT10;X;51075083;51080377;5294;0
15550;ENSG00000123119;NECAB1;8;91803778;91971636;167858;0
15551;ENSG00000123124;WWP1;8;87354967;87490649;135682;0
15552;ENSG00000123130;ACOT9;X;23720370;23784592;64222;0
15553;ENSG00000123131;PRDX4;X;23682379;23704516;22137;0
15554;ENSG00000123496;IL13RA2;X;114238538;114254540;16002;0
15555;ENSG00000123505;AMD1;6;111195973;111216916;20943;0
15556;ENSG00000123545;NDUFAF4;6;97337189;97345757;8568;0
15557;ENSG00000123552;USP45;6;99880190;99969604;89414;0
15558;ENSG00000123560;PLP1;X;103028647;103047548;18901;0
15559;ENSG00000123562;MORF4L2;X;102930424;102943086;12662;0
15560;ENSG00000123570;RAB9B;X;103077252;103087158;9906;0
15561;ENSG00000123572;NRK;X;105066536;105202602;136066;0
15562;ENSG00000123575;FAM199X;X;103411301;103440583;29282;0
15563;ENSG00000123595;RAB9A;X;13707244;13728625;21381;0
15564;ENSG00000123643;SLC36A1;5;150816607;150871942;55335;0
15565;ENSG00000123728;RAP2C;X;131337053;131353471;16418;0
15566;ENSG00000123908;AGO2;8;141541264;141645718;104454;0
15567;ENSG00000123965;PMS2P5;7;74306894;74366314;59420;0
15568;ENSG00000123975;CKS2;9;91926113;91931618;5505;0
15569;ENSG00000124313;IQSEC2;X;53262058;53350522;88464;0
15570;ENSG00000124333;VAMP7;X;155110956;155173433;62477;0
15571;ENSG00000124479;NDP;X;43808022;43832750;24728;0
15572;ENSG00000124486;USP9X;X;40944888;41095832;150944;0
15573;ENSG00000124490;CRISP2;6;49660073;49681274;21201;0
15574;ENSG00000124493;GRM4;6;33989628;34123399;133771;0
15575;ENSG00000124496;TRERF1;6;42192669;42419789;227120;0
15576;ENSG00000124507;PACSIN1;6;34433916;34503006;69090;0
15577;ENSG00000124508;BTN2A2;6;26383324;26395102;11778;0
15578;ENSG00000124523;SIRT5;6;13574816;13614790;39974;0
15579;ENSG00000124532;MRS2;6;24403153;24425810;22657;0
15580;ENSG00000124535;WRNIP1;6;2765648;2787186;21538;0
15581;ENSG00000124541;RRP36;6;42989383;43001894;12511;0
15582;ENSG00000124549;BTN2A3P;6;26421619;26432611;10992;0
15583;ENSG00000124562;SNRPC;6;34725183;34741571;16388;0
15584;ENSG00000124570;SERPINB6;6;2948393;2972090;23697;0
15585;ENSG00000124571;XPO5;6;43490072;43543812;53740;0
15586;ENSG00000124574;ABCC10;6;43395104;43418168;23064;0
15587;ENSG00000124587;PEX6;6;42931608;42946958;15350;0
15588;ENSG00000124588;NQO2;6;2988221;3019996;31775;0
15589;ENSG00000124593;PRICKLE4;6;41748087;41757879;9792;0
15590;ENSG00000124596;OARD1;6;41001366;41065526;64160;0
15591;ENSG00000124602;UNC5CL;6;40994772;41006928;12156;0
15592;ENSG00000124608;AARS2;6;44267391;44281063;13672;0
15593;ENSG00000124613;ZNF391;6;27342394;27371683;29289;0
15594;ENSG00000124614;RPS10;6;34385231;34393902;8671;0
15595;ENSG00000124615;MOCS1;6;39867354;39902290;34936;0
15596;ENSG00000124635;HIST1H2BJ;6;27093676;27100541;6865;0
15597;ENSG00000124641;MED20;6;41873092;41888877;15785;0
15598;ENSG00000124659;TBCC;6;42712219;42714558;2339;0
15599;ENSG00000124664;SPDEF;6;34505579;34524110;18531;0
15600;ENSG00000124678;TCP11;6;35085848;35116387;30539;0
15601;ENSG00000124688;MAD2L1BP;6;43597277;43608689;11412;0
15602;ENSG00000124702;KLHDC3;6;42981951;42989036;7085;0
15603;ENSG00000124713;GNMT;6;42928496;42931618;3122;0
15604;ENSG00000124721;DNAH8;6;38683117;38998301;315184;0
15605;ENSG00000124733;MEA1;6;42979832;42981706;1874;0
15606;ENSG00000124743;KLHL31;6;53512699;53530506;17807;0
15607;ENSG00000124762;CDKN1A;6;36644305;36655116;10811;0
15608;ENSG00000124766;SOX4;6;21593972;21598847;4875;0
15609;ENSG00000124767;GLO1;6;38643701;38670917;27216;0
15610;ENSG00000124772;CPNE5;6;36708552;36807778;99226;0
15611;ENSG00000124782;RREB1;6;7107830;7252213;144383;0
15612;ENSG00000124783;SSR1;6;7268539;7347679;79140;0
15613;ENSG00000124784;RIOK1;6;7389729;7418270;28541;0
15614;ENSG00000124785;NRN1;6;5998232;6007200;8968;0
15615;ENSG00000124786;SLC35B3;6;8413301;8435794;22493;0
15616;ENSG00000124787;RPP40;6;4994966;5004297;9331;0
15617;ENSG00000124788;ATXN1;6;16299343;16761722;462379;0
15618;ENSG00000124789;NUP153;6;17615269;17706656;91387;0
15619;ENSG00000124795;DEK;6;18224099;18265054;40955;0
15620;ENSG00000124802;EEF1E1;6;8073593;8102811;29218;0
15621;ENSG00000124813;RUNX2;6;45295894;45632086;336192;0
15622;ENSG00000125347;IRF1;5;131817301;131826490;9189;0
15623;ENSG00000125351;UPF3B;X;118967985;118986961;18976;0
15624;ENSG00000125352;RNF113A;X;119004497;119005791;1294;0
15625;ENSG00000125354;06-Sep;X;118749687;118827333;77646;0
15626;ENSG00000125355;TMEM255A;X;119392505;119445411;52906;0
15627;ENSG00000125356;NDUFA1;X;119005450;119010625;5175;0
15628;ENSG00000125482;TTF1;9;135251008;135282209;31201;0
15629;ENSG00000125484;GTF3C4;9;135545422;135570342;24920;0
15630;ENSG00000125485;DDX31;9;135468384;135545788;77404;0
15631;ENSG00000125675;GRIA3;X;122318006;122624766;306760;0
15632;ENSG00000125676;THOC2;X;122734412;122866906;132494;0
15633;ENSG00000125931;CITED1;X;71521488;71527037;5549;0
15634;ENSG00000125962;ARMCX5;X;101854096;101859087;4991;0
15635;ENSG00000126010;GRPR;X;16141679;16171144;29465;0
15636;ENSG00000126012;KDM5C;X;53220503;53254604;34101;0
15637;ENSG00000126016;AMOT;X;112017731;112084043;66312;0
15638;ENSG00000126522;ASL;7;65540785;65558545;17760;0
15639;ENSG00000126524;SBDS;7;66452664;66460588;7924;0
15640;ENSG00000126733;DACH2;X;85403462;86087607;684145;0
15641;ENSG00000126756;UXT;X;47511197;47518560;7363;0
15642;ENSG00000126759;CFP;X;47483612;47489704;6092;1
15643;ENSG00000126767;ELK1;X;47494920;47510003;15083;0
15644;ENSG00000126768;TIMM17B;X;48750730;48755426;4696;0
15645;ENSG00000126870;WDR60;7;158649269;158749438;100169;0
15646;ENSG00000126878;AIF1L;9;133971863;133998539;26676;0
15647;ENSG00000126882;FAM78A;9;134133463;134151934;18471;0
15648;ENSG00000126883;NUP214;9;134000948;134110057;109109;0
15649;ENSG00000126903;SLC10A3;X;153715645;153719016;3371;0
15650;ENSG00000126945;HNRNPH2;X;100663283;100669121;5838;0
15651;ENSG00000126947;ARMCX1;X;100805514;100809683;4169;0
15652;ENSG00000126950;TMEM35;X;100333709;100351353;17644;0
15653;ENSG00000126953;TIMM8A;X;100600649;100604184;3535;0
15654;ENSG00000126970;ZC4H2;X;64136250;64254593;118343;0
15655;ENSG00000127022;CANX;5;179105629;179157926;52297;0
15656;ENSG00000127080;IPPK;9;95375466;95432547;57081;0
15657;ENSG00000127081;ZNF484;9;95607874;95640304;32430;0
15658;ENSG00000127084;FGD3;9;95709733;95798518;88785;0
15659;ENSG00000127184;COX7C;5;85913721;85916779;3058;0
15660;ENSG00000127191;TRAF2;9;139776364;139821059;44695;0
15661;ENSG00000127362;TAS2R3;7;141463897;141464997;1100;0
15662;ENSG00000127364;TAS2R4;7;141478242;141479235;993;1
15663;ENSG00000127366;TAS2R5;7;141490017;141491166;1149;0
15664;ENSG00000127377;CRYGN;7;151125921;151137899;11978;1
15665;ENSG00000127399;LRRC61;7;150019728;150035239;15511;0
15666;ENSG00000127589;TUBBP1;8;30209389;30211034;1645;0
15667;ENSG00000127914;AKAP9;7;91570181;91739987;169806;0
15668;ENSG00000127920;GNG11;7;93551011;93557922;6911;0
15669;ENSG00000127922;SHFM1;7;96110938;96339203;228265;0
15670;ENSG00000127946;HIP1;7;75162621;75368280;205659;0
15671;ENSG00000127947;PTPN12;7;77166592;77269388;102796;0
15672;ENSG00000127948;POR;7;75528518;75616173;87655;0
15673;ENSG00000127951;FGL2;7;76822688;76829143;6455;0
15674;ENSG00000127952;STYXL1;7;75625656;75677322;51666;0
15675;ENSG00000127955;GNAI1;7;79763271;79848718;85447;0
15676;ENSG00000127957;PMS2P3;7;75132254;75157478;25224;0
15677;ENSG00000127980;PEX1;7;92116334;92157845;41511;0
15678;ENSG00000127989;MTERF;7;91321323;91510034;188711;0
15679;ENSG00000127990;SGCE;7;94214542;94285521;70979;0
15680;ENSG00000127993;RBM48;7;92158087;92167319;9232;0
15681;ENSG00000127995;CASD1;7;94138531;94186331;47800;0
15682;ENSG00000128512;DOCK4;7;111366166;111846466;480300;0
15683;ENSG00000128513;POT1;7;124462440;124570037;107597;0
15684;ENSG00000128524;ATP6V1F;7;128502880;128505898;3018;0
15685;ENSG00000128534;NAA38;7;117824086;117832878;8792;0
15686;ENSG00000128536;CDHR3;7;105517242;105676877;159635;1
15687;ENSG00000128563;PRKRIP1;7;102004319;102067123;62804;0
15688;ENSG00000128564;VGF;7;100805790;100808874;3084;0
15689;ENSG00000128567;PODXL;7;131185021;131242976;57955;0
15690;ENSG00000128573;FOXP2;7;113726382;114333827;607445;0
15691;ENSG00000128578;STRIP2;7;129074274;129128240;53966;0
15692;ENSG00000128581;RABL5;7;100956975;100965104;8129;0
15693;ENSG00000128585;MKLN1;7;130794855;131181395;386540;0
15694;ENSG00000128590;DNAJB9;7;108210012;108215294;5282;0
15695;ENSG00000128591;FLNC;7;128470431;128499328;28897;0
15696;ENSG00000128594;LRRC4;7;127667124;127672160;5036;0
15697;ENSG00000128595;CALU;7;128379346;128411861;32515;0
15698;ENSG00000128596;CCDC136;7;128430811;128462186;31375;0
15699;ENSG00000128602;SMO;7;128828713;128853386;24673;0
15700;ENSG00000128604;IRF5;7;128577666;128590089;12423;0
15701;ENSG00000128606;LRRC17;7;102553438;102585396;31958;0
15702;ENSG00000128607;KLHDC10;7;129710350;129775560;65210;0
15703;ENSG00000128609;NDUFA5;7;123177051;123198309;21258;0
15704;ENSG00000128617;OPN1SW;7;128412545;128415844;3299;0
15705;ENSG00000129103;SUMF2;7;56131695;56148363;16668;0
15706;ENSG00000129292;PHF20L1;8;133787618;133861052;73434;0
15707;ENSG00000129295;LRRC6;8;133584320;133687838;103518;0
15708;ENSG00000129422;MTUS1;8;17501304;17658426;157122;0
15709;ENSG00000129595;EPB41L4A;5;111478138;111755013;276875;0
15710;ENSG00000129596;CDO1;5;115140430;115152651;12221;0
15711;ENSG00000129625;REEP5;5;112212084;112258236;46152;0
15712;ENSG00000129675;ARHGEF6;X;135747706;135864247;116541;0
15713;ENSG00000129680;MAP7D3;X;135295381;135338641;43260;0
15714;ENSG00000129682;FGF13;X;137713735;138304939;591204;0
15715;ENSG00000129691;ASH2L;8;37962760;38001594;38834;0
15716;ENSG00000129696;TTI2;8;33330904;33371119;40215;0
15717;ENSG00000129824;RPS4Y1;Y;2709527;2800041;90514;0
15718;ENSG00000130021;HDHD1;X;6966961;7066231;99270;0
15719;ENSG00000130023;ERMARD;6;170151718;170181680;29962;0
15720;ENSG00000130024;PHF10;6;170104001;170124151;20150;0
15721;ENSG00000130032;PRRG3;X;150863596;150874396;10800;1
15722;ENSG00000130045;NXNL2;9;91150016;91199189;49173;0
15723;ENSG00000130052;STARD8;X;67867508;67945684;78176;0
15724;ENSG00000130054;FAM155B;X;68725084;68752351;27267;0
15725;ENSG00000130055;GDPD2;X;69642881;69653240;10359;0
15726;ENSG00000130066;SAT1;X;23801290;23804343;3053;0
15727;ENSG00000130119;GNL3L;X;54556644;54587504;30860;0
15728;ENSG00000130150;MOSPD2;X;14891563;14940449;48886;0
15729;ENSG00000130193;THEM6;8;143808621;143818345;9724;0
15730;ENSG00000130222;GADD45G;9;92219928;92221470;1542;0
15731;ENSG00000130224;LRCH2;X;114345185;114468635;123450;0
15732;ENSG00000130226;DPP6;7;153584182;154685995;1101813;0
15733;ENSG00000130227;XPO7;8;21777180;21864096;86916;0
15734;ENSG00000130234;ACE2;X;15579156;15620271;41115;0
15735;ENSG00000130305;NSUN5;7;72716514;72722864;6350;0
15736;ENSG00000130338;TULP4;6;158733692;158932860;199168;0
15737;ENSG00000130340;SNX9;6;158244296;158366109;121813;0
15738;ENSG00000130347;RTN4IP1;6;107018903;107077373;58470;0
15739;ENSG00000130348;QRSL1;6;107077453;107116292;38839;0
15740;ENSG00000130349;C6orf203;6;107349407;107372546;23139;0
15741;ENSG00000130363;RSPH3;6;159393903;159421219;27316;0
15742;ENSG00000130396;MLLT4;6;168227602;168372703;145101;0
15743;ENSG00000130429;ARPC1B;7;98971872;98992424;20552;0
15744;ENSG00000130558;OLFM1;9;137967268;138013025;45757;0
15745;ENSG00000130559;CAMSAP1;9;138700333;138799074;98741;0
15746;ENSG00000130560;UBAC1;9;138824815;138853226;28411;0
15747;ENSG00000130635;COL5A1;9;137533620;137736686;203066;0
15748;ENSG00000130653;PNPLA7;9;140354404;140444986;90582;0
15749;ENSG00000130707;ASS1;9;133320316;133376661;56345;1
15750;ENSG00000130711;PRDM12;9;133539981;133558368;18387;0
15751;ENSG00000130713;EXOSC2;9;133569108;133580248;11140;0
15752;ENSG00000130714;POMT1;9;134378289;134399193;20904;0
15753;ENSG00000130717;UCK1;9;134399188;134406655;7467;0
15754;ENSG00000130720;FIBCD1;9;133777825;133814673;36848;0
15755;ENSG00000130723;PRRC2B;9;134269480;134375584;106104;0
15756;ENSG00000130741;EIF2S3;X;24072833;24096088;23255;0
15757;ENSG00000130821;SLC6A8;X;152953554;152962048;8494;0
15758;ENSG00000130822;PNCK;X;152935185;152954465;19280;0
15759;ENSG00000130826;DKC1;X;153991031;154005964;14933;0
15760;ENSG00000130827;PLXNA3;X;153686621;153701989;15368;0
15761;ENSG00000130829;DUSP9;X;152907946;152916781;8835;0
15762;ENSG00000130830;MPP1;X;154006959;154049282;42323;0
15763;ENSG00000130950;NUTM2F;9;97077605;97090926;13321;0
15764;ENSG00000130956;HABP4;9;99212483;99253618;41135;0
15765;ENSG00000130958;SLC35D2;9;99082988;99145992;63004;0
15766;ENSG00000130962;PRRG1;X;37208528;37316548;108020;0
15767;ENSG00000130985;UBA1;X;47050260;47074527;24267;0
15768;ENSG00000130988;RGN;X;46937775;46952712;14937;0
15769;ENSG00000131002;TXLNG2P;Y;21729199;21768160;38961;0
15770;ENSG00000131013;PPIL4;6;149825869;149867174;41305;0
15771;ENSG00000131015;ULBP2;6;150263136;150270371;7235;0
15772;ENSG00000131016;AKAP12;6;151561134;151679692;118558;0
15773;ENSG00000131018;SYNE1;6;152442819;152958936;516117;0
15774;ENSG00000131019;ULBP3;6;150384286;150390231;5945;0
15775;ENSG00000131023;LATS1;6;149979289;150039392;60103;0
15776;ENSG00000131080;EDA2R;X;65815479;65859108;43629;0
15777;ENSG00000131089;ARHGEF9;X;62854847;63005426;150579;0
15778;ENSG00000131171;SH3BGRL;X;80457442;80554046;96604;0
15779;ENSG00000131174;COX7B;X;77154935;77162870;7935;0
15780;ENSG00000131187;F12;5;176829141;176836577;7436;0
15781;ENSG00000131188;PRR7;5;176873446;176883283;9837;0
15782;ENSG00000131263;RLIM;X;73805052;73834452;29400;0
15783;ENSG00000131269;ABCB7;X;74273115;74376567;103452;0
15784;ENSG00000131435;PDLIM4;5;131593364;131609147;15783;0
15785;ENSG00000131437;KIF3A;5;132028320;132073330;45010;0
15786;ENSG00000131446;MGAT1;5;180217541;180242652;25111;0
15787;ENSG00000131459;GFPT2;5;179727690;179780387;52697;0
15788;ENSG00000131495;NDUFA2;5;140018325;140027370;9045;0
15789;ENSG00000131503;ANKHD1;5;139781399;139929163;147764;0
15790;ENSG00000131504;DIAPH1;5;140894583;140998622;104039;0
15791;ENSG00000131507;NDFIP1;5;141488070;141534005;45935;0
15792;ENSG00000131508;UBE2D2;5;138906016;139008018;102002;0
15793;ENSG00000131558;EXOC4;7;132937829;133751342;813513;0
15794;ENSG00000131669;NINJ1;9;95883771;95896570;12799;0
15795;ENSG00000131724;IL13RA1;X;117861535;117928502;66967;0
15796;ENSG00000131725;WDR44;X;117480036;117583924;103888;0
15797;ENSG00000131732;ZCCHC9;5;80597409;80609116;11707;0
15798;ENSG00000131773;KHDRBS3;8;136469700;136668965;199265;0
15799;ENSG00000131828;PDHA1;X;19362011;19379823;17812;0
15800;ENSG00000131831;RAI2;X;17818169;17879457;61288;0
15801;ENSG00000131931;THAP1;8;42691817;42698468;6651;0
15802;ENSG00000132294;EFR3A;8;132916335;133025889;109554;0
15803;ENSG00000132297;HHLA1;8;133073733;133123406;49673;0
15804;ENSG00000132423;COQ3;6;99817276;99842080;24804;0
15805;ENSG00000132424;PNISR;6;99845927;99873207;27280;0
15806;ENSG00000132429;POPDC3;6;105606155;105627870;21715;0
15807;ENSG00000132432;SEC61G;7;54819943;54827667;7724;0
15808;ENSG00000132434;LANCL2;7;55433141;55501435;68294;0
15809;ENSG00000132436;FIGNL1;7;50511831;50518088;6257;0
15810;ENSG00000132437;DDC;7;50526134;50633154;107020;0
15811;ENSG00000132498;ANKRD20A3;9;43064966;43133544;68578;0
15812;ENSG00000132541;HRSP12;8;99114572;99129469;14897;0
15813;ENSG00000132549;VPS13B;8;100025494;100889808;864314;0
15814;ENSG00000132561;MATN2;8;98881068;99048944;167876;0
15815;ENSG00000132563;REEP2;5;137774706;137782658;7952;0
15816;ENSG00000132570;PCBD2;5;134240596;134343649;103053;0
15817;ENSG00000132837;DMGDH;5;78293438;78531861;238423;0
15818;ENSG00000132842;AP3B1;5;77296349;77590579;294230;0
15819;ENSG00000132846;ZBED3;5;76367897;76383148;15251;0
15820;ENSG00000132911;NMUR2;5;151771093;151812929;41836;0
15821;ENSG00000132912;DCTN4;5;150088002;150138671;50669;0
15822;ENSG00000133124;IRS4;X;107975712;107979651;3939;0
15823;ENSG00000133131;MORC4;X;106057101;106243474;186373;0
15824;ENSG00000133134;BEX2;X;102564274;102565974;1700;0
15825;ENSG00000133135;RNF128;X;105937024;106040223;103199;0
15826;ENSG00000133138;TBC1D8B;X;106045910;106119375;73465;0
15827;ENSG00000133142;TCEAL4;X;102831159;102842657;11498;0
15828;ENSG00000133169;BEX1;X;102317579;102319168;1589;0
15829;ENSG00000133302;ANKRD32;5;93954052;94075141;121089;0
15830;ENSG00000133597;ADCK2;7;140372953;140396061;23108;0
15831;ENSG00000133606;MKRN1;7;140152840;140179369;26529;0
15832;ENSG00000133612;AGAP3;7;150782918;150841523;58605;0
15833;ENSG00000133619;KRBA1;7;149411872;149431664;19792;0
15834;ENSG00000133624;ZNF767;7;149244245;149321843;77598;0
15835;ENSG00000133627;ACTR3B;7;152456834;152552463;95629;0
15836;ENSG00000133706;LARS;5;145492601;145562223;69622;0
15837;ENSG00000133710;SPINK5;5;147405246;147516852;111606;0
15838;ENSG00000133731;IMPA1;8;82570196;82598928;28732;0
15839;ENSG00000133739;LRRCC1;8;86019382;86058311;38929;0
15840;ENSG00000133740;E2F5;8;86089460;86129387;39927;0
15841;ENSG00000133835;HSD17B4;5;118788138;118972894;184756;0
15842;ENSG00000133863;TEX15;8;30689060;30748122;59062;0
15843;ENSG00000133872;TMEM66;8;29920528;29940723;20195;0
15844;ENSG00000133874;RNF122;8;33405273;33424643;19370;0
15845;ENSG00000133878;DUSP26;8;33448856;33457624;8768;0
15846;ENSG00000134013;LOXL2;8;23154702;23282841;128139;0
15847;ENSG00000134014;ELP3;8;27947190;28048673;101483;0
15848;ENSG00000134480;CCNH;5;86687311;86708836;21525;0
15849;ENSG00000134516;DOCK2;5;169064251;169510386;446135;0
15850;ENSG00000134590;FAM127A;X;134166333;134167576;1243;0
15851;ENSG00000134594;RAB33A;X;129305623;129318844;13221;0
15852;ENSG00000134595;SOX3;X;139585152;139587225;2073;0
15853;ENSG00000134597;RBMX2;X;129535943;129547317;11374;0
15854;ENSG00000134602;;X;131157293;131209971;52678;0
15855;ENSG00000134970;TMED7;5;114949205;114968689;19484;0
15856;ENSG00000134982;APC;5;112043195;112181936;138741;0
15857;ENSG00000134986;NREP;5;110998318;111333161;334843;0
15858;ENSG00000134987;WDR36;5;110427414;110466200;38786;0
15859;ENSG00000134996;OSTF1;9;77703459;77762181;58722;0
15860;ENSG00000135002;RFK;9;79000433;79009433;9000;0
15861;ENSG00000135018;UBQLN1;9;86274878;86323118;48240;0
15862;ENSG00000135040;NAA35;9;88556061;88637213;81152;0
15863;ENSG00000135045;C9orf40;9;77561497;77567802;6305;0
15864;ENSG00000135046;ANXA1;9;75766673;75785309;18636;0
15865;ENSG00000135047;CTSL;9;90340434;90346308;5874;0
15866;ENSG00000135048;TMEM2;9;74298282;74431606;133324;0
15867;ENSG00000135049;AGTPBP1;9;88161455;88356944;195489;0
15868;ENSG00000135052;GOLM1;9;88641061;88715088;74027;0
15869;ENSG00000135063;FAM189A2;9;71939488;72007371;67883;0
15870;ENSG00000135069;PSAT1;9;80912059;80945009;32950;0
15871;ENSG00000135070;ISCA1;9;88879461;88897676;18215;0
15872;ENSG00000135074;ADAM19;5;156822542;157002783;180241;0
15873;ENSG00000135077;HAVCR2;5;156512843;156569880;57037;0
15874;ENSG00000135083;CCNJL;5;159678659;159772403;93744;0
15875;ENSG00000135164;DMTF1;7;86781677;86825653;43976;0
15876;ENSG00000135185;TMEM243;7;86825478;86849903;24425;0
15877;ENSG00000135205;CCDC146;7;76751751;76958850;207099;0
15878;ENSG00000135211;TMEM60;7;77423045;77427897;4852;0
15879;ENSG00000135213;POM121C;7;75046066;75115548;69482;0
15880;ENSG00000135218;CD36;7;79998891;80308593;309702;1
15881;ENSG00000135241;PNPLA8;7;108110866;108210110;99244;0
15882;ENSG00000135245;HILPDA;7;128095903;128098472;2569;0
15883;ENSG00000135248;FAM71F1;7;128349115;128371797;22682;0
15884;ENSG00000135249;RINT1;7;105172532;105208124;35592;0
15885;ENSG00000135250;SRPK2;7;104751151;105039755;288604;0
15886;ENSG00000135253;KCP;7;128502505;128550773;48268;0
15887;ENSG00000135269;TES;7;115850547;115898837;48290;0
15888;ENSG00000135272;MDFIC;7;114562209;114659256;97047;0
15889;ENSG00000135297;MTO1;6;74171301;74218959;47658;0
15890;ENSG00000135298;BAI3;6;69345259;70099403;754144;0
15891;ENSG00000135299;ANKRD6;6;90142889;90343553;200664;0
15892;ENSG00000135312;HTR1B;6;78171948;78173490;1542;0
15893;ENSG00000135314;KHDC1;6;73951037;74020088;69051;0
15894;ENSG00000135315;KIAA1009;6;84833960;84937353;103393;0
15895;ENSG00000135316;SYNCRIP;6;86318053;86353510;35457;0
15896;ENSG00000135317;SNX14;6;86215214;86303874;88660;0
15897;ENSG00000135318;NT5E;6;86159809;86205500;45691;1
15898;ENSG00000135324;MRAP2;6;84743475;84800600;57125;0
15899;ENSG00000135333;EPHA7;6;93949738;94129265;179527;0
15900;ENSG00000135334;AKIRIN2;6;88384790;88411927;27137;0
15901;ENSG00000135336;ORC3;6;88299839;88377169;77330;0
15902;ENSG00000135338;LCA5;6;80194708;80247175;52467;0
15903;ENSG00000135341;MAP3K7;6;91223292;91296764;73472;0
15904;ENSG00000135521;LTV1;6;144164481;144184949;20468;0
15905;ENSG00000135525;MAP7;6;136663875;136871957;208082;0
15906;ENSG00000135535;CD164;6;109687717;109703762;16045;0
15907;ENSG00000135537;LACE1;6;108616098;108847999;231901;0
15908;ENSG00000135540;NHSL1;6;138743180;139013708;270528;0
15909;ENSG00000135541;AHI1;6;135604670;135818914;214244;0
15910;ENSG00000135547;HEY2;6;126068810;126082415;13605;0
15911;ENSG00000135549;PKIB;6;122793076;123047518;254442;0
15912;ENSG00000135577;NMBR;6;142379467;142409936;30469;0
15913;ENSG00000135587;SMPD2;6;109761966;109765122;3156;0
15914;ENSG00000135596;MICAL1;6;109765265;109787171;21906;0
15915;ENSG00000135597;REPS1;6;139224630;139309398;84768;0
15916;ENSG00000136193;SCRN1;7;29959719;30029905;70186;0
15917;ENSG00000136197;C7orf25;7;42948325;42951904;3579;0
15918;ENSG00000136205;TNS3;7;47314752;47622156;307404;0
15919;ENSG00000136213;CHST12;7;2443223;2474242;31019;0
15920;ENSG00000136231;IGF2BP3;7;23349828;23510086;160258;0
15921;ENSG00000136235;GPNMB;7;23275586;23314727;39141;0
15922;ENSG00000136237;RAPGEF5;7;22157856;22396763;238907;1
15923;ENSG00000136238;RAC1;7;6414154;6443608;29454;0
15924;ENSG00000136240;KDELR2;7;6485584;6523873;38289;0
15925;ENSG00000136243;NUPL2;7;23221446;23240630;19184;0
15926;ENSG00000136247;ZDHHC4;7;6617065;6629005;11940;0
15927;ENSG00000136250;AOAH;7;36552456;36764154;211698;0
15928;ENSG00000136261;BZW2;7;16685756;16746148;60392;1
15929;ENSG00000136267;DGKB;7;14184674;15014402;829728;0
15930;ENSG00000136270;TBRG4;7;45139699;45151646;11947;0
15931;ENSG00000136271;DDX56;7;44605016;44614650;9634;0
15932;ENSG00000136273;HUS1;7;47735328;48019178;283850;0
15933;ENSG00000136274;NACAD;7;45120037;45128513;8476;0
15934;ENSG00000136279;DBNL;7;44084239;44109055;24816;0
15935;ENSG00000136280;CCM2;7;45039074;45116068;76994;0
15936;ENSG00000136295;TTYH3;7;2671585;2704436;32851;0
15937;ENSG00000136297;MMD2;7;4945620;4998844;53224;0
15938;ENSG00000136783;NIPSNAP3A;9;107509969;107522403;12434;0
15939;ENSG00000136802;LRRC8A;9;131644391;131680318;35927;0
15940;ENSG00000136807;CDK9;9;130547958;130553066;5108;0
15941;ENSG00000136810;TXN;9;113006091;113018920;12829;0
15942;ENSG00000136811;ODF2;9;131217465;131263571;46106;0
15943;ENSG00000136813;KIAA0368;9;114122972;114247025;124053;0
15944;ENSG00000136816;TOR1B;9;132565432;132573560;8128;0
15945;ENSG00000136819;C9orf78;9;132589569;132598142;8573;0
15946;ENSG00000136824;SMC2;9;106856541;106903698;47157;0
15947;ENSG00000136826;KLF4;9;110247133;110252763;5630;0
15948;ENSG00000136827;TOR1A;9;132575223;132586413;11190;0
15949;ENSG00000136828;RALGPS1;9;129677053;129985445;308392;0
15950;ENSG00000136830;FAM129B;9;130267618;130341268;73650;0
15951;ENSG00000136840;ST6GALNAC4;9;130670165;130679317;9152;0
15952;ENSG00000136842;TMOD1;9;100263462;100364030;100568;0
15953;ENSG00000136848;DAB2IP;9;124329336;124547809;218473;0
15954;ENSG00000136854;STXBP1;9;130374544;130457460;82916;0
15955;ENSG00000136856;SLC2A8;9;130159421;130170703;11282;0
15956;ENSG00000136859;ANGPTL2;9;129849611;129885162;35551;0
15957;ENSG00000136861;CDK5RAP2;9;123151147;123342448;191301;0
15958;ENSG00000136866;ZFP37;9;115800660;115819039;18379;0
15959;ENSG00000136867;SLC31A2;9;115913222;115926417;13195;0
15960;ENSG00000136868;SLC31A1;9;115983808;116028674;44866;0
15961;ENSG00000136869;TLR4;9;120466610;120479149;12539;0
15962;ENSG00000136870;ZNF189;9;104161155;104172942;11787;0
15963;ENSG00000136874;STX17;9;102668915;102732618;63703;0
15964;ENSG00000136875;PRPF4;9;116037623;116055185;17562;0
15965;ENSG00000136877;FPGS;9;130556876;130576606;19730;0
15966;ENSG00000136878;USP20;9;132596977;132644107;47130;0
15967;ENSG00000136881;BAAT;9;104122699;104145801;23102;0
15968;ENSG00000136883;KIF12;9;116848406;116861507;13101;0
15969;ENSG00000136888;ATP6V1G1;9;117350026;117360653;10627;0
15970;ENSG00000136891;TEX10;9;103064359;103115221;50862;0
15971;ENSG00000136895;GARNL3;9;129986544;130155939;169395;0
15972;ENSG00000136897;MRPL50;9;104149915;104160896;10981;0
15973;ENSG00000136908;DPM2;9;130697378;130700763;3385;0
15974;ENSG00000136918;WDR38;9;127615755;127620160;4405;0
15975;ENSG00000136925;TSTD2;9;100362362;100395962;33600;0
15976;ENSG00000136928;GABBR2;9;101050391;101471479;421088;0
15977;ENSG00000136930;PSMB7;9;127115745;127177723;61978;0
15978;ENSG00000136932;C9orf156;9;100666771;100684852;18081;0
15979;ENSG00000136933;RABEPK;9;127962821;127996437;33616;0
15980;ENSG00000136935;GOLGA1;9;127640646;127710771;70125;0
15981;ENSG00000136936;XPA;9;100437191;100459639;22448;0
15982;ENSG00000136937;NCBP1;9;100395908;100436030;40122;0
15983;ENSG00000136938;ANP32B;9;100745643;100778225;32582;0
15984;ENSG00000136940;PDCL;9;125560668;125590910;30242;0
15985;ENSG00000136942;RPL35;9;127620159;127624260;4101;0
15986;ENSG00000136943;CTSV;9;99794940;99801925;6985;0
15987;ENSG00000136944;LMX1B;9;129376722;129463311;86589;0
15988;ENSG00000136950;ARPC5L;9;127624409;127640003;15594;0
15989;ENSG00000136960;ENPP2;8;120569326;120685693;116367;0
15990;ENSG00000136982;DSCC1;8;120846216;120868250;22034;0
15991;ENSG00000136986;DERL1;8;124025404;124054663;29259;0
15992;ENSG00000136997;MYC;8;128747680;128753674;5994;0
15993;ENSG00000136999;NOV;8;120428546;120436593;8047;0
15994;ENSG00000137033;IL33;9;6215805;6257983;42178;1
15995;ENSG00000137038;TMEM261;9;7796490;7888380;91890;0
15996;ENSG00000137040;RANBP6;9;6011043;6015618;4575;0
15997;ENSG00000137054;POLR1E;9;37485932;37503694;17762;0
15998;ENSG00000137055;PLAA;9;26904081;26947461;43380;0
15999;ENSG00000137070;IL11RA;9;34650699;34661889;11190;0
16000;ENSG00000137073;UBAP2;9;33921691;34048947;127256;0
16001;ENSG00000137074;APTX;9;32972604;33025166;52562;0
16002;ENSG00000137075;RNF38;9;36336393;36487545;151152;0
16003;ENSG00000137076;TLN1;9;35696945;35732392;35447;0
16004;ENSG00000137094;DNAJB5;9;34989638;34998897;9259;0
16005;ENSG00000137098;SPAG8;9;35808042;35812269;4227;0
16006;ENSG00000137100;DCTN3;9;34613548;34620515;6967;0
16007;ENSG00000137103;TMEM8B;9;35814448;35854844;40396;0
16008;ENSG00000137106;GRHPR;9;37422663;37436987;14324;0
16009;ENSG00000137124;ALDH1B1;9;38392661;38398658;5997;0
16010;ENSG00000137133;HINT2;9;35812957;35815351;2394;0
16011;ENSG00000137135;ARHGEF39;9;35658872;35675863;16991;0
16012;ENSG00000137142;IGFBPL1;9;38408991;38424444;15453;0
16013;ENSG00000137145;DENND4C;9;19230433;19374139;143706;0
16014;ENSG00000137154;RPS6;9;19375713;19380252;4539;0
16015;ENSG00000137161;CNPY3;6;42896938;42907025;10087;0
16016;ENSG00000137166;FOXP4;6;41514164;41570122;55958;1
16017;ENSG00000137168;PPIL1;6;36822603;36842800;20197;0
16018;ENSG00000137171;KLC4;6;43008515;43042837;34322;0
16019;ENSG00000137177;KIF13A;6;17759414;17987854;228440;0
16020;ENSG00000137185;ZSCAN9;6;28192664;28201260;8596;0
16021;ENSG00000137193;PIM1;6;37137979;37143202;5223;0
16022;ENSG00000137200;CMTR1;6;37400995;37450603;49608;0
16023;ENSG00000137203;TFAP2A;6;10393419;10419892;26473;1
16024;ENSG00000137204;SLC22A7;6;43263432;43273276;9844;0
16025;ENSG00000137207;YIPF3;6;43479565;43484728;5163;0
16026;ENSG00000137210;TMEM14B;6;10747992;10852986;104994;1
16027;ENSG00000137216;TMEM63B;6;44094651;44123256;28605;0
16028;ENSG00000137218;FRS3;6;41737914;41754280;16366;0
16029;ENSG00000137221;TJAP1;6;43445261;43474294;29033;0
16030;ENSG00000137252;HCRTR2;6;55039050;55147418;108368;0
16031;ENSG00000137261;KIAA0319;6;24544332;24646383;102051;0
16032;ENSG00000137265;IRF4;6;391739;411447;19708;0
16033;ENSG00000137266;SLC22A23;6;3269196;3457256;188060;0
16034;ENSG00000137267;TUBB2A;6;3153903;3157760;3857;0
16035;ENSG00000137269;LRRC1;6;53659295;53788919;129624;0
16036;ENSG00000137274;BPHL;6;3118608;3153812;35204;0
16037;ENSG00000137275;RIPK1;6;3064225;3115421;51196;0
16038;ENSG00000137285;TUBB2B;6;3224495;3231964;7469;0
16039;ENSG00000137288;UQCC2;6;33662070;33679504;17434;0
16040;ENSG00000137309;HMGA1;6;34204650;34214008;9358;0
16041;ENSG00000137310;TCF19;6;31126319;31134936;8617;0
16042;ENSG00000137312;FLOT1;6;30695486;30710510;15024;0
16043;ENSG00000137331;IER3;6;30710976;30712331;1355;0
16044;ENSG00000137337;MDC1;6;30667584;30685666;18082;0
16045;ENSG00000137338;PGBD1;6;28249314;28270326;21012;0
16046;ENSG00000137343;ATAT1;6;30594619;30614600;19981;0
16047;ENSG00000137364;TPMT;6;18128542;18155305;26763;0
16048;ENSG00000137393;RNF144B;6;18368779;18469105;100326;0
16049;ENSG00000137404;NRM;6;30655824;30659197;3373;0
16050;ENSG00000137409;MTCH1;6;36935917;36954074;18157;0
16051;ENSG00000137411;VARS2;6;30876019;30894236;18217;0
16052;ENSG00000137413;TAF8;6;42018251;42055199;36948;0
16053;ENSG00000137414;FAM8A1;6;17600586;17611950;11364;0
16054;ENSG00000137434;C6orf52;6;10671651;10695030;23379;0
16055;ENSG00000137547;MRPL15;8;55047770;55060461;12691;0
16056;ENSG00000137558;PI15;8;75736772;75767264;30492;0
16057;ENSG00000137561;TTPA;8;63961112;63998612;37500;0
16058;ENSG00000137563;GGH;8;63927638;63951730;24092;0
16059;ENSG00000137571;SLCO5A1;8;70579282;70747299;168017;0
16060;ENSG00000137573;SULF1;8;70378859;70573150;194291;1
16061;ENSG00000137574;TGS1;8;56685701;56738007;52306;0
16062;ENSG00000137575;SDCBP;8;59465483;59495419;29936;0
16063;ENSG00000138829;FBN2;5;127593601;127994878;401277;1
16064;ENSG00000138835;RGS3;9;116207011;116360018;153007;0
16065;ENSG00000140396;NCOA2;8;71021997;71316040;294043;0
16066;ENSG00000145685;LHFPL2;5;77781038;78065844;284806;1
16067;ENSG00000145687;SSBP2;5;80708840;81047616;338776;0
16068;ENSG00000145703;IQGAP2;5;75699074;76003957;304883;0
16069;ENSG00000145708;CRHBP;5;76248538;76276983;28445;0
16070;ENSG00000145715;RASA1;5;86563705;86687748;124043;0
16071;ENSG00000145721;LIX1;5;96427574;96478576;51002;0
16072;ENSG00000145723;GIN1;5;102421704;102455855;34151;0
16073;ENSG00000145725;PPIP5K2;5;102455853;102548500;92647;0
16074;ENSG00000145730;PAM;5;102089685;102366809;277124;0
16075;ENSG00000145743;FBXL17;5;107194736;107717799;523063;0
16076;ENSG00000145757;SPATA9;5;94987885;95034415;46530;1
16077;ENSG00000145779;TNFAIP8;5;118604387;118735383;130996;0
16078;ENSG00000145780;FEM1C;5;114856608;114880591;23983;0
16079;ENSG00000145781;COMMD10;5;115420688;115748459;327771;0
16080;ENSG00000145782;ATG12;5;115163893;115177555;13662;0
16081;ENSG00000145794;MEGF10;5;126626523;126801429;174906;0
16082;ENSG00000145808;ADAMTS19;5;128795958;129074376;278418;0
16083;ENSG00000145817;YIPF5;5;143537723;143550278;12555;0
16084;ENSG00000145819;ARHGAP26;5;142149949;142608576;458627;0
16085;ENSG00000145824;CXCL14;5;134906373;134914969;8596;0
16086;ENSG00000145833;DDX46;5;134094469;134190823;96354;0
16087;ENSG00000145860;RNF145;5;158584417;158637061;52644;0
16088;ENSG00000145861;C1QTNF2;5;159774758;159797648;22890;0
16089;ENSG00000145864;GABRB2;5;160715436;160976050;260614;0
16090;ENSG00000145868;FBXO38;5;147763498;147822399;58901;0
16091;ENSG00000145882;PCYOX1L;5;148737570;148749216;11646;1
16092;ENSG00000145888;GLRA1;5;151202074;151304403;102329;0
16093;ENSG00000145901;TNIP1;5;150409506;150473138;63632;0
16094;ENSG00000145907;G3BP1;5;151150606;151192346;41740;0
16095;ENSG00000145908;ZNF300;5;150273954;150284545;10591;0
16096;ENSG00000145911;N4BP3;5;177540444;177553088;12644;0
16097;ENSG00000145912;NHP2;5;177576461;177580968;4507;0
16098;ENSG00000145916;RMND5B;5;177557997;177577566;19569;0
16099;ENSG00000145919;BOD1;5;173034517;173043663;9146;0
16100;ENSG00000145920;CPLX2;5;175223313;175311023;87710;0
16101;ENSG00000145934;TENM2;5;166711804;167691162;979358;0
16102;ENSG00000145936;KCNMB1;5;169801675;169816681;15006;0
16103;ENSG00000145945;FAM50B;6;3849620;3851551;1931;1
16104;ENSG00000145949;MYLK4;6;2663863;2751200;87337;0
16105;ENSG00000145979;TBC1D7;6;13266774;13328815;62041;0
16106;ENSG00000145982;FARS2;6;5261277;5771813;510536;0
16107;ENSG00000145990;GFOD1;6;13358062;13487894;129832;0
16108;ENSG00000145996;CDKAL1;6;20534688;21232635;697947;0
16109;ENSG00000146001;PCDHB18;5;140613938;140617101;3163;0
16110;ENSG00000146005;PSD2;5;139175406;139224051;48645;0
16111;ENSG00000146006;LRRTM2;5;138204612;138211057;6445;0
16112;ENSG00000146007;ZMAT2;5;140078265;140086248;7983;0
16113;ENSG00000146021;KLHL3;5;136953189;137071779;118590;0
16114;ENSG00000146038;DCDC2;6;24171984;24358280;186296;0
16115;ENSG00000146054;TRIM7;5;180620924;180632293;11369;1
16116;ENSG00000146063;TRIM41;5;180649499;180662809;13310;0
16117;ENSG00000146066;HIGD2A;5;175815748;175816772;1024;0
16118;ENSG00000146067;FAM193B;5;176946789;176981542;34753;0
16119;ENSG00000146070;PLA2G7;6;46671938;46703430;31492;0
16120;ENSG00000146072;TNFRSF21;6;47199268;47277641;78373;0
16121;ENSG00000146083;RNF44;5;175953698;175965026;11328;0
16122;ENSG00000146085;MUT;6;49398073;49430904;32831;0
16123;ENSG00000146090;RASGEF1C;5;179527795;179636153;108358;0
16124;ENSG00000146094;DOK3;5;176928908;176938275;9367;0
16125;ENSG00000146109;ABT1;6;26597180;26600278;3098;0
16126;ENSG00000146112;PPP1R18;6;30644166;30655672;11506;0
16127;ENSG00000146122;DAAM2;6;39760142;39872648;112506;0
16128;ENSG00000146143;PRIM2;6;57179603;57513375;333772;0
16129;ENSG00000146147;MLIP;6;53794780;54131078;336298;0
16130;ENSG00000146151;HMGCLL1;6;55299167;55444012;144845;0
16131;ENSG00000146197;SCUBE3;6;35182190;35220856;38666;0
16132;ENSG00000146215;CRIP3;6;43267448;43276535;9087;0
16133;ENSG00000146216;TTBK1;6;43211418;43255997;44579;0
16134;ENSG00000146221;TCTE1;6;44246480;44265458;18978;0
16135;ENSG00000146223;RPL7L1;6;42847356;42857663;10307;0
16136;ENSG00000146232;NFKBIE;6;44225903;44233500;7597;0
16137;ENSG00000146233;CYP39A1;6;46517541;46620523;102982;0
16138;ENSG00000146242;TPBG;6;83072923;83080545;7622;0
16139;ENSG00000146243;IRAK1BP1;6;79577189;79656157;78968;0
16140;ENSG00000146247;PHIP;6;79645584;79787953;142369;0
16141;ENSG00000146250;PRSS35;6;84222194;84235423;13229;1
16142;ENSG00000146263;MMS22L;6;97590037;97731093;141056;0
16143;ENSG00000146267;FAXC;6;99719045;99797938;78893;0
16144;ENSG00000146276;GABRR1;6;89887220;89940997;53777;1
16145;ENSG00000146278;PNRC1;6;89790470;89794879;4409;0
16146;ENSG00000146281;PM20D2;6;89855769;89875284;19515;0
16147;ENSG00000146282;RARS2;6;88224096;88299721;75625;0
16148;ENSG00000146285;SCML4;6;108025308;108145521;120213;0
16149;ENSG00000146350;TBC1D32;6;121400640;121655891;255251;0
16150;ENSG00000146352;CLVS2;6;123317116;123394072;76956;0
16151;ENSG00000146373;RNF217;6;125283691;125413779;130088;0
16152;ENSG00000146374;RSPO3;6;127439749;127518910;79161;0
16153;ENSG00000146376;ARHGAP18;6;129897277;130031370;134093;1
16154;ENSG00000146386;ABRACL;6;139349819;139364439;14620;0
16155;ENSG00000146409;SLC18B1;6;133090509;133119701;29192;1
16156;ENSG00000146410;MTFR2;6;136552162;136571473;19311;0
16157;ENSG00000146411;SLC2A12;6;134309835;134373774;63939;0
16158;ENSG00000146414;SHPRH;6;146185381;146285559;100178;0
16159;ENSG00000146416;AIG1;6;143381633;143661441;279808;0
16160;ENSG00000146425;DYNLT1;6;159057506;159065771;8265;0
16161;ENSG00000146426;TIAM2;6;155153831;155578857;425026;0
16162;ENSG00000146433;TMEM181;6;158957468;159056460;98992;0
16163;ENSG00000146453;PNLDC1;6;160221298;160241736;20438;0
16164;ENSG00000146457;WTAP;6;160146617;160177351;30734;0
16165;ENSG00000146476;C6orf211;6;151773422;151791236;17814;0
16166;ENSG00000146477;SLC22A3;6;160769300;160876014;106714;0
16167;ENSG00000146521;C6orf123;6;168185217;168197539;12322;0
16168;ENSG00000146530;VWDE;7;12370511;12443567;73056;0
16169;ENSG00000146535;GNA12;7;2767746;2883958;116212;0
16170;ENSG00000146540;C7orf50;7;1036622;1177896;141274;0
16171;ENSG00000146555;SDK1;7;3341080;4308632;967552;0
16172;ENSG00000146574;CCZ1B;7;6833765;6866401;32636;0
16173;ENSG00000146576;C7orf26;7;6629648;6648357;18709;0
16174;ENSG00000146587;RBAK;7;5085452;5109119;23667;0
16175;ENSG00000146592;CREB5;7;28338940;28865511;526571;1
16176;ENSG00000146648;EGFR;7;55086714;55324313;237599;0
16177;ENSG00000146674;IGFBP3;7;45951949;45961473;9524;0
16178;ENSG00000146676;PURB;7;44915896;44924960;9064;0
16179;ENSG00000146677;;7;44507441;44507939;498;0
16180;ENSG00000146700;SRCRB4D;7;76018651;76039012;20361;0
16181;ENSG00000146701;MDH2;7;75677369;75696826;19457;0
16182;ENSG00000146707;POMZP3;7;76239303;76256578;17275;0
16183;ENSG00000146729;GBAS;7;56019486;56067874;48388;0
16184;ENSG00000146731;CCT6A;7;56119323;56131682;12359;0
16185;ENSG00000146733;PSPH;7;56078744;56119297;40553;0
16186;ENSG00000146757;ZNF92;7;64838712;64866038;27326;0
16187;ENSG00000146776;ATXN7L1;7;105245514;105517050;271536;0
16188;ENSG00000146802;TMEM168;7;112402437;112430647;28210;0
16189;ENSG00000146826;C7orf43;7;99752043;99756338;4295;0
16190;ENSG00000146828;SLC12A9;7;100424442;100464631;40189;0
16191;ENSG00000146830;GIGYF1;7;100277130;100287071;9941;0
16192;ENSG00000146833;TRIM4;7;99474581;99517223;42642;0
16193;ENSG00000146834;MEPCE;7;100026413;100031741;5328;0
16194;ENSG00000146842;TMEM209;7;129804555;129847610;43055;0
16195;ENSG00000146856;AGBL3;7;134671259;134832715;161456;0
16196;ENSG00000146858;ZC3HAV1L;7;138710452;138720775;10323;0
16197;ENSG00000146909;NOM1;7;156742417;156765876;23459;0
16198;ENSG00000146910;CNPY1;7;155266901;155326557;59656;0
16199;ENSG00000146918;NCAPG2;7;158424003;158497520;73517;0
16200;ENSG00000146938;NLGN4X;X;5758678;6146904;388226;0
16201;ENSG00000146950;SHROOM2;X;9754496;9917483;162987;0
16202;ENSG00000146963;C7orf55-LUC7L2;7;139025105;139108198;83093;0
16203;ENSG00000146966;DENND2A;7;140218220;140373793;155573;0
16204;ENSG00000147003;TMEM27;X;15645441;15683154;37713;0
16205;ENSG00000147010;SH3KBP1;X;19552093;19905719;353626;0
16206;ENSG00000147027;TMEM47;X;34645181;34675405;30224;0
16207;ENSG00000147036;LANCL3;X;37430822;37543716;112894;0
16208;ENSG00000147041;SYTL5;X;37865835;37988072;122237;0
16209;ENSG00000147044;CASK;X;41374187;41782716;408529;0
16210;ENSG00000147050;KDM6A;X;44732757;44971847;239090;0
16211;ENSG00000147065;MSN;X;64808257;64961791;153534;1
16212;ENSG00000147082;CCNB3;X;49967364;50094909;127545;0
16213;ENSG00000147099;HDAC8;X;71549366;71792953;243587;0
16214;ENSG00000147100;SLC16A2;X;73641085;73753752;112667;0
16215;ENSG00000147117;ZNF157;X;47229982;47273704;43722;0
16216;ENSG00000147118;ZNF182;X;47834250;47863377;29127;0
16217;ENSG00000147119;CHST7;X;46433219;46457843;24624;0
16218;ENSG00000147121;KRBOX4;X;46306292;46356857;50565;0
16219;ENSG00000147123;NDUFB11;X;47001615;47004903;3288;0
16220;ENSG00000147124;ZNF41;X;47305278;47342345;37067;0
16221;ENSG00000147130;ZMYM3;X;70459474;70474996;15522;0
16222;ENSG00000147133;TAF1;X;70586114;70752224;166110;0
16223;ENSG00000147140;NONO;X;70503042;70521018;17976;0
16224;ENSG00000147144;CCDC120;X;48911101;48927509;16408;0
16225;ENSG00000147145;LPAR4;X;78003206;78012591;9385;0
16226;ENSG00000147155;EBP;X;48379546;48387104;7558;0
16227;ENSG00000147162;OGT;X;70752933;70795747;42814;0
16228;ENSG00000147164;SNX12;X;70279094;70288273;9179;0
16229;ENSG00000147166;ITGB1BP2;X;70521584;70525221;3637;0
16230;ENSG00000147174;ACRC;X;70798261;70833433;35172;0
16231;ENSG00000147180;ZNF711;X;84498997;84528368;29371;0
16232;ENSG00000147202;DIAPH2;X;95939662;96859996;920334;0
16233;ENSG00000147224;PRPS1;X;106871737;106894256;22519;0
16234;ENSG00000147231;CXorf57;X;105855160;105922672;67512;0
16235;ENSG00000147234;FRMPD3;X;106765680;106848481;82801;0
16236;ENSG00000147246;HTR2C;X;113818551;114144624;326073;1
16237;ENSG00000147251;DOCK11;X;117629861;117820126;190265;0
16238;ENSG00000147255;IGSF1;X;130407480;130533677;126197;0
16239;ENSG00000147256;ARHGAP36;X;130192216;130223857;31641;0
16240;ENSG00000147257;GPC3;X;132669773;133119922;450149;0
16241;ENSG00000147274;RBMX;X;135930163;135962923;32760;0
16242;ENSG00000147316;MCPH1;8;6264113;6501144;237031;0
16243;ENSG00000147324;MFHAS1;8;8640864;8751155;110291;0
16244;ENSG00000147364;FBXO25;8;356428;421225;64797;0
16245;ENSG00000147382;FAM58A;X;152853377;152865500;12123;0
16246;ENSG00000147383;NSDHL;X;151999511;152038273;38762;0
16247;ENSG00000147394;ZNF185;X;152082986;152142024;59038;0
16248;ENSG00000147400;CETN2;X;151995517;151999321;3804;0
16249;ENSG00000147402;GABRQ;X;151806637;151825999;19362;0
16250;ENSG00000147403;RPL10;X;153618315;153637504;19189;0
16251;ENSG00000147408;CSGALNACT1;8;19261672;19615540;353868;1
16252;ENSG00000147416;ATP6V1B2;8;20054878;20084330;29452;0
16253;ENSG00000147419;CCDC25;8;27590835;27630170;39335;0
16254;ENSG00000147421;HMBOX1;8;28747911;28922281;174370;0
16255;ENSG00000147432;CHRNB3;8;42552519;42592550;40031;0
16256;ENSG00000147434;CHRNA6;8;42607763;42651535;43772;0
16257;ENSG00000147437;GNRH1;8;25276776;25282170;5394;0
16258;ENSG00000147439;BIN3;8;22477931;22526661;48730;0
16259;ENSG00000147454;SLC25A37;8;23386318;23432976;46658;0
16260;ENSG00000147457;CHMP7;8;23101150;23119512;18362;0
16261;ENSG00000147459;DOCK5;8;25042238;25275598;233360;1
16262;ENSG00000147465;STAR;8;38001167;38008783;7616;0
16263;ENSG00000147471;PROSC;8;37620111;37637283;17172;0
16264;ENSG00000147475;ERLIN2;8;37594117;37616619;22502;0
16265;ENSG00000147481;SNTG1;8;50822349;51706678;884329;0
16266;ENSG00000147485;PXDNL;8;52232138;52722005;489867;0
16267;ENSG00000147488;ST18;8;53023399;53373519;350120;0
16268;ENSG00000147509;RGS20;8;54764368;54871863;107495;0
16269;ENSG00000147526;TACC1;8;38585704;38710546;124842;0
16270;ENSG00000147533;GOLGA7;8;41347915;41368499;20584;0
16271;ENSG00000147535;PPAPDC1B;8;38120648;38126761;6113;0
16272;ENSG00000147536;GINS4;8;41386725;41402565;15840;0
16273;ENSG00000147548;WHSC1L1;8;38127215;38239790;112575;0
16274;ENSG00000147576;ADHFE1;8;67342420;67383836;41416;0
16275;ENSG00000147586;MRPS28;8;80830952;80942524;111572;0
16276;ENSG00000147588;PMP2;8;82352561;82359758;7197;0
16277;ENSG00000147592;LACTB2;8;71547553;71581409;33856;1
16278;ENSG00000147601;TERF1;8;73921099;73960357;39258;0
16279;ENSG00000147604;RPL7;8;74202506;74208024;5518;0
16280;ENSG00000147606;SLC26A7;8;92221722;92410378;188656;1
16281;ENSG00000147642;SYBU;8;110586207;110704020;117813;0
16282;ENSG00000147649;MTDH;8;98656407;98740998;84591;0
16283;ENSG00000147650;LRP12;8;105501459;105601252;99793;0
16284;ENSG00000147654;EBAG9;8;110551940;110578225;26285;0
16285;ENSG00000147655;RSPO2;8;108911544;109095913;184369;0
16286;ENSG00000147669;POLR2K;8;101162812;101166230;3418;0
16287;ENSG00000147676;MAL2;8;120177273;120257913;80640;0
16288;ENSG00000147677;EIF3H;8;117654369;117779164;124795;0
16289;ENSG00000147679;UTP23;8;117778742;117861702;82960;0
16290;ENSG00000147684;NDUFB9;8;125551344;125580751;29407;0
16291;ENSG00000147687;TATDN1;8;125500726;125551699;50973;0
16292;ENSG00000147789;ZNF7;8;146052849;146072894;20045;0
16293;ENSG00000147799;ARHGAP39;8;145754563;145911194;156631;0
16294;ENSG00000147813;NAPRT1;8;144656955;144660819;3864;0
16295;ENSG00000147852;VLDLR;9;2621834;2660053;38219;0
16296;ENSG00000147853;AK3;9;4711155;4742043;30888;0
16297;ENSG00000147854;UHRF2;9;6413151;6507054;93903;0
16298;ENSG00000147862;NFIB;9;14081842;14398982;317140;0
16299;ENSG00000147869;CER1;9;14719722;14722715;2993;0
16300;ENSG00000147872;PLIN2;9;19108373;19149288;40915;0
16301;ENSG00000147874;HAUS6;9;19053141;19103117;49976;0
16302;ENSG00000147883;CDKN2B;9;22002902;22009362;6460;0
16303;ENSG00000147889;CDKN2A;9;21967751;21995300;27549;0
16304;ENSG00000147894;C9orf72;9;27546544;27573864;27320;0
16305;ENSG00000147905;ZCCHC7;9;37120536;37358146;237610;0
16306;ENSG00000147912;FBXO10;9;37510889;37588871;77982;0
16307;ENSG00000147955;SIGMAR1;9;34634719;34637806;3087;0
16308;ENSG00000147996;CBWD5;9;70432004;70497240;65236;0
16309;ENSG00000148019;CEP78;9;80850978;80894606;43628;0
16310;ENSG00000148053;NTRK2;9;87283466;87638505;355039;0
16311;ENSG00000148057;IDNK;9;86237964;86259045;21081;1
16312;ENSG00000148082;SHC3;9;91628060;91793682;165622;0
16313;ENSG00000148090;AUH;9;93976097;94124195;148098;0
16314;ENSG00000148110;HIATL1;9;97136833;97223324;86491;0
16315;ENSG00000148120;C9orf3;9;97488983;97849441;360458;0
16316;ENSG00000148123;;9;103790991;104087417;296426;0
16317;ENSG00000148143;ZNF462;9;109625378;109775915;150537;0
16318;ENSG00000148153;INIP;9;115446206;115480516;34310;0
16319;ENSG00000148154;UGCG;9;114659046;114697649;38603;0
16320;ENSG00000148158;SNX30;9;115513118;115643951;130833;0
16321;ENSG00000148175;STOM;9;124101355;124132531;31176;0
16322;ENSG00000148180;GSN;9;123970072;124095121;125049;0
16323;ENSG00000148187;MRRF;9;125026882;125085743;58861;0
16324;ENSG00000148200;NR6A1;9;127279554;127533589;254035;1
16325;ENSG00000148204;CRB2;9;126118449;126142603;24154;0
16326;ENSG00000148218;ALAD;9;116148597;116163613;15016;0
16327;ENSG00000148219;ASTN2;9;119187504;120177348;989844;0
16328;ENSG00000148225;WDR31;9;116075502;116102578;27076;0
16329;ENSG00000148229;POLE3;9;116169515;116172952;3437;0
16330;ENSG00000148248;SURF4;9;136228325;136242970;14645;0
16331;ENSG00000148288;GBGT1;9;136028340;136039332;10992;0
16332;ENSG00000148290;SURF1;9;136218610;136223552;4942;0
16333;ENSG00000148291;SURF2;9;136223428;136228045;4617;0
16334;ENSG00000148296;SURF6;9;136197552;136203235;5683;0
16335;ENSG00000148297;MED22;9;136205160;136214986;9826;0
16336;ENSG00000148300;REXO4;9;136271186;136283164;11978;0
16337;ENSG00000148303;RPL7A;9;136215069;136218281;3212;0
16338;ENSG00000148308;GTF3C5;9;135906076;135933890;27814;0
16339;ENSG00000148331;ASB6;9;132399171;132404444;5273;0
16340;ENSG00000148334;PTGES2;9;130882972;130890741;7769;0
16341;ENSG00000148335;NTMT1;9;132371163;132398209;27046;0
16342;ENSG00000148337;CIZ1;9;130928343;130966662;38319;0
16343;ENSG00000148339;SLC25A25;9;130830480;130871524;41044;0
16344;ENSG00000148341;SH3GLB2;9;131769315;131790582;21267;0
16345;ENSG00000148343;FAM73B;9;131798900;131834361;35461;0
16346;ENSG00000148344;PTGES;9;132500610;132515326;14716;0
16347;ENSG00000148356;LRSAM1;9;130213765;130265780;52015;0
16348;ENSG00000148358;GPR107;9;132815705;132902448;86743;0
16349;ENSG00000148362;C9orf142;9;139886870;139888436;1566;0
16350;ENSG00000148384;INPP5E;9;139323071;139334274;11203;0
16351;ENSG00000148396;SEC16A;9;139334549;139372141;37592;0
16352;ENSG00000148399;DPH7;9;140449356;140473387;24031;0
16353;ENSG00000148400;NOTCH1;9;139388896;139440314;51418;0
16354;ENSG00000148408;CACNA1B;9;140772241;141019076;246835;0
16355;ENSG00000148411;NACC2;9;138898383;138987131;88748;0
16356;ENSG00000149970;CNKSR2;X;21392536;21672813;280277;0
16357;ENSG00000151292;CSNK1G3;5;122847793;122952739;104946;0
16358;ENSG00000151304;SRFBP1;5;121297656;121411265;113609;0
16359;ENSG00000151422;FER;5;108083523;108532542;449019;0
16360;ENSG00000151914;DST;6;56322785;56819426;496641;0
16361;ENSG00000151917;BEND6;6;56819773;56892140;72367;0
16362;ENSG00000152348;ATG10;5;81267844;81572676;304832;0
16363;ENSG00000152359;POC5;5;74969949;75013313;43364;0
16364;ENSG00000152377;SPOCK1;5;136310987;136934068;623081;0
16365;ENSG00000152380;FAM151B;5;79783788;79838382;54594;0
16366;ENSG00000152409;JMY;5;78532012;78623038;91026;0
16367;ENSG00000152413;HOMER1;5;78668459;78810040;141581;0
16368;ENSG00000152422;XRCC4;5;82373317;82649606;276289;0
16369;ENSG00000152495;CAMK4;5;110559351;110830584;271233;0
16370;ENSG00000152503;TRIM36;5;114460459;114516243;55784;0
16371;ENSG00000152661;GJA1;6;121756838;121770873;14035;0
16372;ENSG00000152700;SAR1B;5;133936834;133984961;48127;0
16373;ENSG00000152705;CATSPER3;5;134303596;134347392;43796;0
16374;ENSG00000152818;UTRN;6;144606837;145174170;567333;1
16375;ENSG00000152822;GRM1;6;146348782;146758734;409952;0
16376;ENSG00000152894;PTPRK;6;128289924;128841870;551946;0
16377;ENSG00000152926;ZNF117;7;64432154;64467062;34908;1
16378;ENSG00000152954;NRSN1;6;24126350;24155128;28778;1
16379;ENSG00000153037;SRP19;5;112196919;112205485;8566;0
16380;ENSG00000153046;CDYL;6;4706393;4955785;249392;0
16381;ENSG00000153113;CAST;5;95860971;96115299;254328;0
16382;ENSG00000153140;CETN3;5;89688078;89705603;17525;0
16383;ENSG00000153157;SYCP2L;6;10748027;10979553;231526;0
16384;ENSG00000153162;BMP6;6;7727030;7881655;154625;0
16385;ENSG00000153291;SLC25A27;6;46620678;46645930;25252;0
16386;ENSG00000153310;FAM49B;8;130851839;131029375;177536;0
16387;ENSG00000153317;ASAP1;8;131064353;131455906;391553;0
16388;ENSG00000153347;FAM81B;5;94727048;94786158;59110;0
16389;ENSG00000153707;PTPRD;9;8314246;10612723;2298477;0
16390;ENSG00000153714;LURAP1L;9;12775020;12822130;47110;0
16391;ENSG00000153721;CNKSR3;6;154708638;154831793;123155;0
16392;ENSG00000153790;C7orf31;7;25174316;25219975;45659;0
16393;ENSG00000153814;JAZF1;7;27870192;28220362;350170;0
16394;ENSG00000153922;CHD1;5;98190908;98262240;71332;0
16395;ENSG00000153956;CACNA2D1;7;81575760;82073114;497354;0
16396;ENSG00000153975;ZUFSP;6;116956781;116989957;33176;0
16397;ENSG00000153989;NUS1;6;117996665;118031803;35138;0
16398;ENSG00000153993;SEMA3D;7;84624869;84816171;191302;1
16399;ENSG00000154079;C6orf57;6;71276620;71299272;22652;0
16400;ENSG00000154188;ANGPT1;8;108261721;108510283;248562;0
16401;ENSG00000154269;ENPP3;6;131949582;132068553;118971;0
16402;ENSG00000154316;TDH;8;11197146;11225961;28815;1
16403;ENSG00000154319;FAM167A;8;11278972;11332224;53252;0
16404;ENSG00000154328;NEIL2;8;11627148;11644855;17707;0
16405;ENSG00000154330;PGM5;9;70943224;71145977;202753;1
16406;ENSG00000154359;LONRF1;8;12579403;12613582;34179;0
16407;ENSG00000154529;CNTNAP3B;9;43684902;43924049;239147;0
16408;ENSG00000154545;MAGED4;X;51927919;51935364;7445;0
16409;ENSG00000154548;SRSF12;6;89805678;89827800;22122;0
16410;ENSG00000154582;TCEB1;8;74851404;74884522;33118;0
16411;ENSG00000154620;TMSB4Y;Y;15815447;15817904;2457;1
16412;ENSG00000154678;PDE1C;7;31790793;32338941;548148;0
16413;ENSG00000154710;RABGEF1;7;66147151;66276451;129300;1
16414;ENSG00000154978;VOPP1;7;55503749;55640681;136932;0
16415;ENSG00000155008;APOOL;X;84258832;84343069;84237;0
16416;ENSG00000155026;RSPH10B;7;5965181;6010314;45133;0
16417;ENSG00000155034;FBXL18;7;5470966;5553429;82463;0
16418;ENSG00000155085;AK9;6;109814059;110012420;198361;0
16419;ENSG00000155090;KLF10;8;103661007;103668130;7123;0
16420;ENSG00000155093;PTPRN2;7;157331750;158380480;1048730;0
16421;ENSG00000155096;AZIN1;8;103838585;103906092;67507;0
16422;ENSG00000155097;ATP6V1C1;8;104033291;104085279;51988;0
16423;ENSG00000155099;TMEM55A;8;92006024;92053292;47268;0
16424;ENSG00000155100;OTUD6B;8;92082424;92099323;16899;0
16425;ENSG00000155111;CDK19;6;110931181;111137161;205980;0
16426;ENSG00000155115;GTF3C6;6;111279763;111289093;9330;0
16427;ENSG00000155130;MARCKS;6;114178541;114184648;6107;0
16428;ENSG00000155158;TTC39B;9;15163620;15307358;143738;0
16429;ENSG00000155189;AGPAT5;8;6565878;6617184;51306;0
16430;ENSG00000155324;GRAMD3;5;125695824;125832186;136362;1
16431;ENSG00000155329;ZCCHC10;5;132332677;132362296;29619;0
16432;ENSG00000155428;TRIM74;7;72430016;72439997;9981;0
16433;ENSG00000155506;LARP1;5;154092462;154197167;104705;0
16434;ENSG00000155508;CNOT8;5;154237113;154256353;19240;0
16435;ENSG00000155511;GRIA1;5;152869175;153193429;324254;0
16436;ENSG00000155530;LRGUK;7;133812052;133949343;137291;0
16437;ENSG00000155561;NUP205;7;135242667;135333505;90838;0
16438;ENSG00000155621;C9orf85;9;74526426;74600970;74544;0
16439;ENSG00000155660;PDIA4;7;148700154;148725733;25579;0
16440;ENSG00000155792;DEPTOR;8;120885957;121063152;177195;0
16441;ENSG00000155827;RNF20;9;104296133;104325622;29489;0
16442;ENSG00000155846;PPARGC1B;5;149109861;149234585;124724;0
16443;ENSG00000155849;ELMO1;7;36893961;37488852;594891;0
16444;ENSG00000155850;SLC26A2;5;149340300;149373018;32718;0
16445;ENSG00000155858;LSM11;5;157170703;157187717;17014;0
16446;ENSG00000155868;MED7;5;156564423;156586030;21607;0
16447;ENSG00000155876;RRAGA;9;19049372;19051019;1647;0
16448;ENSG00000155886;SLC24A2;9;19507450;19786926;279476;0
16449;ENSG00000155897;ADCY8;8;131792547;132054672;262125;0
16450;ENSG00000155906;RMND1;6;151725989;151773259;47270;0
16451;ENSG00000155926;SLA;8;134048973;134115298;66325;1
16452;ENSG00000155959;VBP1;X;154425284;154468098;42814;0
16453;ENSG00000155961;RAB39B;X;154487526;154493874;6348;0
16454;ENSG00000155962;CLIC2;X;154505500;154563966;58466;1
16455;ENSG00000155966;AFF2;X;147582139;148082193;500054;0
16456;ENSG00000155970;MICU3;8;16884747;16980153;95406;0
16457;ENSG00000155975;VPS37A;8;17104080;17159936;55856;0
16458;ENSG00000155984;TMEM185A;X;148678216;148713568;35352;0
16459;ENSG00000156011;PSD3;8;18384811;18942240;557429;0
16460;ENSG00000156017;C9orf41;9;77595936;77643339;47403;0
16461;ENSG00000156049;GNA14;9;80037995;80263223;225228;0
16462;ENSG00000156052;GNAQ;9;80331003;80646374;315371;0
16463;ENSG00000156103;MMP16;8;89044237;89340254;296017;0
16464;ENSG00000156162;DPY19L4;8;95731931;95806064;74133;0
16465;ENSG00000156170;NDUFAF6;8;95907995;96128683;220688;0
16466;ENSG00000156172;C8orf37;8;96257147;96281429;24282;0
16467;ENSG00000156298;TSPAN7;X;38420623;38548169;127546;0
16468;ENSG00000156313;RPGR;X;38128416;38186817;58401;0
16469;ENSG00000156345;CDK20;9;90581356;90589668;8312;0
16470;ENSG00000156427;FGF18;5;170846660;170884627;37967;0
16471;ENSG00000156453;PCDH1;5;141232938;141258811;25873;0
16472;ENSG00000156466;GDF6;8;97154562;97173020;18458;0
16473;ENSG00000156467;UQCRB;8;97238148;97247862;9714;0
16474;ENSG00000156469;MTERFD1;8;97251626;97273838;22212;0
16475;ENSG00000156471;PTDSS1;8;97273943;97349223;75280;0
16476;ENSG00000156475;PPP2R2B;5;145967936;146464347;496411;0
16477;ENSG00000156482;RPL30;8;99037079;99058697;21618;0
16478;ENSG00000156486;KCNS2;8;99439250;99445076;5826;1
16479;ENSG00000156500;FAM122C;X;133930819;133988640;57821;0
16480;ENSG00000156504;FAM122B;X;133903596;133931262;27666;0
16481;ENSG00000156508;EEF1A1;6;74225473;74233520;8047;0
16482;ENSG00000156509;FBXO43;8;101145588;101158028;12440;0
16483;ENSG00000156531;PHF6;X;133507283;133562820;55537;0
16484;ENSG00000156535;CD109;6;74405508;74538040;132532;1
16485;ENSG00000156564;LRFN2;6;40359325;40555204;195879;0
16486;ENSG00000156639;ZFAND3;6;37787275;38122400;335125;0
16487;ENSG00000156675;RAB11FIP1;8;37716136;37756985;40849;0
16488;ENSG00000156687;UNC5D;8;35092975;35654068;561093;0
16489;ENSG00000156697;UTP14A;X;129040097;129063737;23640;0
16490;ENSG00000156709;AIFM1;X;129263337;129299861;36524;0
16491;ENSG00000156711;MAPK13;6;36095586;36107842;12256;0
16492;ENSG00000156735;BAG4;8;38034051;38070819;36768;0
16493;ENSG00000156787;TBC1D31;8;124054208;124164393;110185;0
16494;ENSG00000156795;WDYHV1;8;124428965;124479470;50505;0
16495;ENSG00000156802;ATAD2;8;124332090;124428590;96500;0
16496;ENSG00000156804;FBXO32;8;124510129;124553446;43317;0
16497;ENSG00000156831;NSMCE2;8;126103921;126379362;275441;0
16498;ENSG00000156925;ZIC3;X;136648301;136659850;11549;0
16499;ENSG00000156928;MALSU1;7;23338358;23351348;12990;0
16500;ENSG00000157110;RBPMS;8;30241944;30429778;187834;0
16501;ENSG00000157168;NRG1;8;31496902;32622548;1125646;0
16502;ENSG00000157212;PAXIP1;7;154735397;154794794;59397;0
16503;ENSG00000157214;STEAP2;7;89796904;89867451;70547;0
16504;ENSG00000157219;HTR5A;7;154862034;154877459;15425;0
16505;ENSG00000157224;CLDN12;7;90013035;90142716;129681;0
16506;ENSG00000157240;FZD1;7;90893783;90898123;4340;0
16507;ENSG00000157259;GATAD1;7;92076767;92088150;11383;0
16508;ENSG00000157343;ARMC12;6;35704809;35716856;12047;1
16509;ENSG00000157399;ARSE;X;2852699;2886286;33587;0
16510;ENSG00000157502;MUM1L1;X;105412298;105452949;40651;0
16511;ENSG00000157514;TSC22D3;X;106956451;107020572;64121;0
16512;ENSG00000157593;SLC35B2;6;44221833;44225291;3458;0
16513;ENSG00000157600;TMEM164;X;109245859;109425962;180103;0
16514;ENSG00000157625;TAB3;X;30845559;30993201;147642;0
16515;ENSG00000157653;C9orf43;9;116172334;116191964;19630;0
16516;ENSG00000157657;ZNF618;9;116638562;116818871;180309;0
16517;ENSG00000157680;DGKI;7;137065783;137531838;466055;0
16518;ENSG00000157693;C9orf91;9;117373486;117408702;35216;0
16519;ENSG00000157703;SVOPL;7;138279030;138386097;107067;0
16520;ENSG00000157741;UBN2;7;138915102;138992982;77880;0
16521;ENSG00000157764;BRAF;7;140419127;140624564;205437;0
16522;ENSG00000157778;PSMG3;7;1606966;1610641;3675;0
16523;ENSG00000157800;SLC37A3;7;139993493;140104233;110740;1
16524;ENSG00000157927;RADIL;7;4836686;4923350;86664;0
16525;ENSG00000157954;WIPI2;7;5229819;5273457;43638;0
16526;ENSG00000158079;PTPDC1;9;96793076;96872138;79062;0
16527;ENSG00000158106;RHPN1;8;144451057;144466390;15333;0
16528;ENSG00000158122;AAED1;9;99401859;99417585;15726;0
16529;ENSG00000158164;TMSB15A;X;101768604;101771712;3108;0
16530;ENSG00000158169;FANCC;9;97861336;98079991;218655;0
16531;ENSG00000158290;CUL4B;X;119658464;119709649;51185;0
16532;ENSG00000158301;GPRASP2;X;101967104;101973607;6503;0
16533;ENSG00000158321;AUTS2;7;69063905;70258054;1194149;0
16534;ENSG00000158352;SHROOM4;X;50334647;50557302;222655;0
16535;ENSG00000158373;HIST1H2BD;6;26158349;26171577;13228;0
16536;ENSG00000158402;CDC25C;5;137620954;137674044;53090;0
16537;ENSG00000158406;HIST1H4H;6;26281283;26285762;4479;1
16538;ENSG00000158423;RIBC1;X;53449639;53458059;8420;0
16539;ENSG00000158427;TMSB15B;X;103173479;103229570;56091;0
16540;ENSG00000158457;TSPAN33;7;128784712;128808671;23959;1
16541;ENSG00000158458;NRG2;5;139226364;139422884;196520;0
16542;ENSG00000158467;AHCYL2;7;128864864;129070052;205188;0
16543;ENSG00000158526;TSR2;X;54466834;54471920;5086;0
16544;ENSG00000158528;PPP1R9A;7;94536514;94925727;389213;0
16545;ENSG00000158560;DYNC1I1;7;95401866;95739634;337768;0
16546;ENSG00000158571;PFKFB1;X;54959394;55024967;65573;0
16547;ENSG00000158604;TMED4;7;44617493;44621886;4393;0
16548;ENSG00000158623;COPG2;7;130146089;130353598;207509;0
16549;ENSG00000158669;AGPAT6;8;41434706;41482520;47814;0
16550;ENSG00000158683;PKD1L1;7;47814250;47988088;173838;0
16551;ENSG00000158691;ZSCAN12;6;28346732;28367511;20779;0
16552;ENSG00000158806;NPM2;8;21881636;21894408;12772;0
16553;ENSG00000158813;EDA;X;68835911;69259319;423408;0
16554;ENSG00000158815;FGF17;8;21899909;21906320;6411;0
16555;ENSG00000158856;DMTN;8;21906506;21940038;33532;0
16556;ENSG00000158863;FAM160B2;8;21946670;21962409;15739;0
16557;ENSG00000158941;CCAR2;8;22462145;22479027;16882;0
16558;ENSG00000158985;CDC42SE2;5;130581186;130734140;152954;0
16559;ENSG00000158987;RAPGEF6;5;130759614;130970929;211315;0
16560;ENSG00000159069;FBXW5;9;139834887;139839148;4261;0
16561;ENSG00000159167;STC1;8;23699428;23712320;12892;0
16562;ENSG00000159247;TUBBP5;9;141044565;141071821;27256;0
16563;ENSG00000159784;FAM131B;7;143050493;143059863;9370;0
16564;ENSG00000159840;ZYX;7;143078173;143088204;10031;0
16565;ENSG00000159884;CCDC107;9;35658301;35661508;3207;0
16566;ENSG00000159899;NPR2;9;35792151;35809729;17578;0
16567;ENSG00000159904;ZNF890P;7;5160870;5184177;23307;0
16568;ENSG00000159921;GNE;9;36214438;36277053;62615;0
16569;ENSG00000160131;VMA21;X;150564987;150577836;12849;0
16570;ENSG00000160211;G6PD;X;153759606;153775787;16181;0
16571;ENSG00000160271;RALGDS;9;135973107;136039301;66194;0
16572;ENSG00000160293;VAV2;9;136627016;136857726;230710;0
16573;ENSG00000160323;ADAMTS13;9;136279478;136324508;45030;0
16574;ENSG00000160325;CACFD1;9;136325089;136335970;10881;0
16575;ENSG00000160326;SLC2A6;9;136336217;136344259;8042;0
16576;ENSG00000160345;C9orf116;9;138387027;138393580;6553;0
16577;ENSG00000160360;GPSM1;9;139221932;139254057;32125;0
16578;ENSG00000160401;C9orf117;9;130469268;130478281;9013;0
16579;ENSG00000160404;TOR2A;9;130493803;130497604;3801;0
16580;ENSG00000160408;ST6GALNAC6;9;130647600;130667687;20087;0
16581;ENSG00000160445;ZER1;9;131492065;131534693;42628;0
16582;ENSG00000160446;ZDHHC12;9;131483148;131486406;3258;0
16583;ENSG00000160447;PKN3;9;131464802;131483197;18395;0
16584;ENSG00000160539;PPAPDC3;9;134165081;134184649;19568;0
16585;ENSG00000160563;MED27;9;134735494;134955295;219801;0
16586;ENSG00000160813;PPP1R35;7;100032905;100034188;1283;0
16587;ENSG00000160828;STAG3L2;7;74112305;74306731;194426;0
16588;ENSG00000160867;FGFR4;5;176513887;176525145;11258;1
16589;ENSG00000160908;ZNF394;7;99084142;99097947;13805;0
16590;ENSG00000160917;CPSF4;7;99036545;99054994;18449;0
16591;ENSG00000160932;LY6E;8;144099399;144105249;5850;0
16592;ENSG00000160948;VPS28;8;145649000;145653931;4931;0
16593;ENSG00000160949;TONSL;8;145654165;145669827;15662;0
16594;ENSG00000160957;RECQL4;8;145736667;145743229;6562;0
16595;ENSG00000160959;LRRC14;8;145743376;145750557;7181;0
16596;ENSG00000160963;COL26A1;7;101006101;101202304;196203;0
16597;ENSG00000160972;PPP1R16A;8;145703352;145727504;24152;0
16598;ENSG00000160991;ORAI2;7;102073553;102097268;23715;0
16599;ENSG00000160993;ALKBH4;7;102096685;102105323;8638;0
16600;ENSG00000160999;SH2B2;7;101928405;101962178;33773;0
16601;ENSG00000161010;C5orf45;5;179261436;179289173;27737;0
16602;ENSG00000161011;SQSTM1;5;179233388;179265078;31690;0
16603;ENSG00000161013;MGAT4B;5;179224597;179233952;9355;0
16604;ENSG00000161016;RPL8;8;146015150;146017972;2822;0
16605;ENSG00000161021;MAML1;5;179159851;179223512;63661;0
16606;ENSG00000161036;LRWD1;7;102105376;102113615;8239;0
16607;ENSG00000161040;FBXL13;7;102453308;102715286;261978;0
16608;ENSG00000161048;NAPEPLD;7;102740223;102790007;49784;0
16609;ENSG00000161057;PSMC2;7;102984701;103009842;25141;0
16610;ENSG00000161904;LEMD2;6;33738979;33756913;17934;0
16611;ENSG00000161912;ADCY10P1;6;41068761;41108571;39810;0
16612;ENSG00000164176;EDIL3;5;83236373;83680611;444238;0
16613;ENSG00000164180;TMEM161B;5;87485450;87565293;79843;0
16614;ENSG00000164185;ZNF474;5;121465208;121515312;50104;0
16615;ENSG00000164199;GPR98;5;89825161;90460038;634877;0
16616;ENSG00000164209;SLC25A46;5;110073837;110100857;27020;0
16617;ENSG00000164211;STARD4;5;110831731;110848288;16557;0
16618;ENSG00000164219;PGGT1B;5;114546527;114598569;52042;0
16619;ENSG00000164221;CCDC112;5;114602885;114632528;29643;0
16620;ENSG00000164241;C5orf63;5;126378250;126409184;30934;0
16621;ENSG00000164244;PRRC1;5;126853301;126890781;37480;0
16622;ENSG00000164251;F2RL1;5;76114758;76131140;16382;0
16623;ENSG00000164252;AGGF1;5;76325076;76361059;35983;0
16624;ENSG00000164253;WDR41;5;76721795;76916436;194641;0
16625;ENSG00000164284;GRPEL2;5;148724993;148734146;9153;0
16626;ENSG00000164291;ARSK;5;94890778;94940768;49990;0
16627;ENSG00000164292;RHOBTB3;5;95049226;95160087;110861;0
16628;ENSG00000164296;TIGD6;5;149372681;149380730;8049;0
16629;ENSG00000164300;SERINC5;5;79407050;79551898;144848;0
16630;ENSG00000164307;ERAP1;5;96096521;96143803;47282;0
16631;ENSG00000164308;ERAP2;5;96211643;96255420;43777;0
16632;ENSG00000164309;CMYA5;5;78985700;79096063;110363;0
16633;ENSG00000164329;PAPD4;5;78907943;78982471;74528;0
16634;ENSG00000164330;EBF1;5;158122928;158526769;403841;0
16635;ENSG00000164332;UBLCP1;5;158690089;158713044;22955;0
16636;ENSG00000164385;C6orf195;6;2622147;2634837;12690;0
16637;ENSG00000164398;ACSL6;5;131142683;131347936;205253;0
16638;ENSG00000164402;08-Sep;5;132086509;132142933;56424;0
16639;ENSG00000164403;SHROOM1;5;132157833;132166590;8757;0
16640;ENSG00000164404;GDF9;5;132196873;132202576;5703;0
16641;ENSG00000164405;UQCRQ;5;132202252;132203723;1471;0
16642;ENSG00000164406;LEAP2;5;132208014;132210738;2724;1
16643;ENSG00000164414;SLC35A1;6;88180341;88222054;41713;0
16644;ENSG00000164418;GRIK2;6;101846664;102517958;671294;1
16645;ENSG00000164430;MB21D1;6;74123238;74161999;38761;0
16646;ENSG00000164434;FABP7;6;123100620;123105219;4599;0
16647;ENSG00000164438;TLX3;5;170736288;170739138;2850;0
16648;ENSG00000164440;TXLNB;6;139561198;139613276;52078;0
16649;ENSG00000164442;CITED2;6;139693393;139695757;2364;0
16650;ENSG00000164463;CREBRF;5;172483355;172566291;82936;0
16651;ENSG00000164465;DCBLD1;6;117774980;117891021;116041;0
16652;ENSG00000164466;SFXN1;5;174904065;174956745;52680;0
16653;ENSG00000164483;SAMD3;6;130465460;130686570;221110;0
16654;ENSG00000164484;TMEM200A;6;130686879;130764208;77329;0
16655;ENSG00000164494;PDSS2;6;107473761;107780768;307007;0
16656;ENSG00000164506;STXBP5;6;147525561;147706866;181305;0
16657;ENSG00000164535;DAGLB;7;6448757;6523821;75064;0
16658;ENSG00000164542;KIAA0895;7;36363830;36429734;65904;0
16659;ENSG00000164543;STK17A;7;43622357;43666385;44028;0
16660;ENSG00000164548;TRA2A;7;23544399;23571660;27261;0
16661;ENSG00000164574;GALNT10;5;153570290;153800544;230254;0
16662;ENSG00000164576;SAP30L;5;153825517;153840614;15097;0
16663;ENSG00000164587;RPS14;5;149822753;149829319;6566;0
16664;ENSG00000164591;MYOZ3;5;150040436;150058927;18491;0
16665;ENSG00000164597;COG5;7;106842000;107204959;362959;0
16666;ENSG00000164600;NEUROD6;7;31377075;31380508;3433;1
16667;ENSG00000164603;C7orf60;7;112459202;112579971;120769;0
16668;ENSG00000164604;GPR85;7;112718386;112727833;9447;0
16669;ENSG00000164609;SLU7;5;159828648;159848718;20070;0
16670;ENSG00000164610;RP9;7;33134409;33149013;14604;0
16671;ENSG00000164611;PTTG1;5;159848829;159855748;6919;0
16672;ENSG00000164615;CAMLG;5;134074191;134087847;13656;0
16673;ENSG00000164616;FBXL21;5;135266006;135287280;21274;0
16674;ENSG00000164619;BMPER;7;33944523;34195484;250961;1
16675;ENSG00000164620;RELL2;5;141016517;141020644;4127;0
16676;ENSG00000164627;KIF6;6;39297766;39693181;395415;0
16677;ENSG00000164631;ZNF12;7;6728064;6746554;18490;0
16678;ENSG00000164638;SLC29A4;7;5314000;5346501;32501;0
16679;ENSG00000164647;STEAP1;7;89783689;89794143;10454;0
16680;ENSG00000164649;CDCA7L;7;21940518;21985702;45184;1
16681;ENSG00000164654;MIOS;7;7606503;7648560;42057;0
16682;ENSG00000164659;KIAA1324L;7;86506222;86689015;182793;0
16683;ENSG00000164663;USP49;6;41757634;41863099;105465;0
16684;ENSG00000164669;INTS4L1;7;64601603;64694600;92997;0
16685;ENSG00000164674;SYTL3;6;159071046;159185908;114862;0
16686;ENSG00000164675;IQUB;7;123092454;123175131;82677;0
16687;ENSG00000164683;HEY1;8;80676245;80680098;3853;0
16688;ENSG00000164684;ZNF704;8;81540686;81787016;246330;0
16689;ENSG00000164687;FABP5;8;82192598;82197012;4414;0
16690;ENSG00000164692;COL1A2;7;94023873;94060544;36671;1
16691;ENSG00000164694;FNDC1;6;159590429;159693141;102712;0
16692;ENSG00000164713;BRI3;7;97881691;97937162;55471;0
16693;ENSG00000164715;LMTK2;7;97736197;97838945;102748;0
16694;ENSG00000164733;CTSB;8;11700033;11726957;26924;0
16695;ENSG00000164741;DLC1;8;12940870;13373167;432297;0
16696;ENSG00000164742;ADCY1;7;45613739;45762715;148976;0
16697;ENSG00000164743;C8orf48;8;13424352;13425796;1444;0
16698;ENSG00000164746;C7orf57;7;48075108;48100901;25793;0
16699;ENSG00000164749;HNF4G;8;76320149;76479078;158929;0
16700;ENSG00000164751;PEX2;8;77892494;77913280;20786;0
16701;ENSG00000164754;RAD21;8;117858174;117887105;28931;0
16702;ENSG00000164758;MED30;8;118532952;118552501;19549;0
16703;ENSG00000164761;TNFRSF11B;8;119935796;119964439;28643;0
16704;ENSG00000164776;PHKG1;7;56148440;56160689;12249;0
16705;ENSG00000164778;EN2;7;155250824;155257526;6702;0
16706;ENSG00000164794;KCNV1;8;110975874;110988076;12202;0
16707;ENSG00000164796;CSMD3;8;113235157;114449328;1214171;0
16708;ENSG00000164808;SPIDR;8;48173167;48648868;475701;0
16709;ENSG00000164815;ORC5;7;103766788;103848495;81707;0
16710;ENSG00000164818;HEATR2;7;766338;829190;62852;0
16711;ENSG00000164823;OSGIN2;8;90914087;90940116;26029;0
16712;ENSG00000164828;SUN1;7;855528;936072;80544;0
16713;ENSG00000164830;OXR1;8;107282473;107764922;482449;0
16714;ENSG00000164841;TMEM74;8;109619079;109799844;180765;0
16715;ENSG00000164849;GPR146;7;1084212;1098897;14685;0
16716;ENSG00000164850;GPER1;7;1121844;1133451;11607;0
16717;ENSG00000164853;UNCX;7;1272543;1276954;4411;0
16718;ENSG00000164855;TMEM184A;7;1581871;1600457;18586;0
16719;ENSG00000164877;MICALL2;7;1468101;1499138;31037;0
16720;ENSG00000164879;CA3;8;86285665;86361269;75604;0
16721;ENSG00000164880;INTS1;7;1509913;1545489;35576;0
16722;ENSG00000164885;CDK5;7;150750899;150755617;4718;0
16723;ENSG00000164889;SLC4A2;7;150754297;150773614;19317;0
16724;ENSG00000164896;FASTK;7;150773711;150777953;4242;0
16725;ENSG00000164897;TMUB1;7;150778167;150780633;2466;0
16726;ENSG00000164898;C7orf55;7;139024203;139031065;6862;0
16727;ENSG00000164902;PHAX;5;125935960;125962944;26984;0
16728;ENSG00000164904;ALDH7A1;5;125877533;125931110;53577;0
16729;ENSG00000164916;FOXK1;7;4683388;4811074;127686;0
16730;ENSG00000164919;COX6C;8;100885428;100906290;20862;0
16731;ENSG00000164924;YWHAZ;8;101928753;101965616;36863;0
16732;ENSG00000164929;BAALC;8;104152938;104242533;89595;1
16733;ENSG00000164930;FZD6;8;104310661;104345094;34433;0
16734;ENSG00000164933;SLC25A32;8;104410863;104427417;16554;0
16735;ENSG00000164934;DCAF13;8;104426942;104455681;28739;0
16736;ENSG00000164938;TP53INP1;8;95938200;95961639;23439;0
16737;ENSG00000164941;INTS8;8;95825539;95893974;68435;0
16738;ENSG00000164944;KIAA1429;8;95499921;95565757;65836;0
16739;ENSG00000164946;FREM1;9;14734664;14910993;176329;0
16740;ENSG00000164949;GEM;8;95261481;95274578;13097;0
16741;ENSG00000164951;PDP1;8;94870035;94938294;68259;0
16742;ENSG00000164953;TMEM67;8;94767072;94831462;64390;0
16743;ENSG00000164961;KIAA0196;8;126036502;126104082;67580;0
16744;ENSG00000164967;RPP25L;9;34610483;34612101;1618;0
16745;ENSG00000164970;FAM219A;9;34398182;34458568;60386;0
16746;ENSG00000164972;C9orf24;9;34379017;34397830;18813;0
16747;ENSG00000164975;SNAPC3;9;15422702;15465951;43249;0
16748;ENSG00000164976;KIAA1161;9;34366668;34376851;10183;0
16749;ENSG00000164978;NUDT2;9;34329504;34343709;14205;0
16750;ENSG00000164983;TMEM65;8;125324231;125384933;60702;0
16751;ENSG00000164985;PSIP1;9;15464064;15511017;46953;0
16752;ENSG00000164989;CCDC171;9;15552895;16061661;508766;0
16753;ENSG00000165006;UBAP1;9;34179003;34252521;73518;0
16754;ENSG00000165023;DIRAS2;9;93372114;93405386;33272;1
16755;ENSG00000165028;NIPSNAP3B;9;107526438;107539738;13300;0
16756;ENSG00000165029;ABCA1;9;107543283;107690518;147235;0
16757;ENSG00000165030;NFIL3;9;94171327;94186144;14817;0
16758;ENSG00000165046;LETM2;8;38243725;38267045;23320;0
16759;ENSG00000165055;METTL2B;7;128116783;128146656;29873;0
16760;ENSG00000165060;FXN;9;71650175;71715094;64919;0
16761;ENSG00000165061;ZMAT4;8;40388109;40755352;367243;0
16762;ENSG00000165066;NKX6-3;8;41502697;41508855;6158;0
16763;ENSG00000165071;TMEM71;8;133697253;133772958;75705;0
16764;ENSG00000165072;MAMDC2;9;72658497;72841886;183389;1
16765;ENSG00000165084;C8orf34;8;69242957;69731257;488300;0
16766;ENSG00000165097;KDM1B;6;18155560;18224084;68524;0
16767;ENSG00000165102;HGSNAT;8;42995556;43057998;62442;0
16768;ENSG00000165105;RASEF;9;85594500;85678092;83592;0
16769;ENSG00000165113;GKAP1;9;86354336;86444431;90095;0
16770;ENSG00000165115;KIF27;9;86451613;86536342;84729;0
16771;ENSG00000165119;HNRNPK;9;86582998;86595569;12571;0
16772;ENSG00000165121;;9;88430881;88464426;33545;0
16773;ENSG00000165124;SVEP1;9;113127531;113342160;214629;0
16774;ENSG00000165138;ANKS6;9;101493611;101559247;65636;0
16775;ENSG00000165152;TMEM246;9;104235453;104295819;60366;0
16776;ENSG00000165156;ZHX1;8;124260696;124287781;27085;0
16777;ENSG00000165164;CXorf22;X;35937851;36008269;70418;0
16778;ENSG00000165168;CYBB;X;37639264;37672714;33450;0
16779;ENSG00000165169;DYNLT3;X;37696010;37706890;10880;1
16780;ENSG00000165175;MID1IP1;X;38660685;38665790;5105;0
16781;ENSG00000165182;CXorf58;X;23925918;23957624;31706;0
16782;ENSG00000165185;KIAA1958;9;115249127;115431677;182550;0
16783;ENSG00000165186;PTCHD1;X;23352133;23422489;70356;0
16784;ENSG00000165194;PCDH19;X;99546642;99665271;118629;0
16785;ENSG00000165195;PIGA;X;15337573;15353676;16103;0
16786;ENSG00000165209;STRBP;9;125871779;126030855;159076;0
16787;ENSG00000165219;GAPVD1;9;128024073;128129486;105413;0
16788;ENSG00000165233;C9orf89;9;95858500;95875565;17065;0
16789;ENSG00000165238;WNK2;9;95947198;96082854;135656;0
16790;ENSG00000165240;ATP7A;X;77166194;77305892;139698;0
16791;ENSG00000165244;ZNF367;9;99148223;99180611;32388;0
16792;ENSG00000165246;NLGN4Y;Y;16634518;16957530;323012;0
16793;ENSG00000165259;HDX;X;83572882;83757487;184605;0
16794;ENSG00000165264;NDUFB6;9;32552997;32573160;20163;0
16795;ENSG00000165269;AQP7;9;33384765;33402643;17878;0
16796;ENSG00000165271;NOL6;9;33461439;33473928;12489;0
16797;ENSG00000165272;AQP3;9;33441152;33447609;6457;0
16798;ENSG00000165275;TRMT10B;9;37753804;37778969;25165;0
16799;ENSG00000165280;VCP;9;35056061;35073246;17185;0
16800;ENSG00000165282;PIGO;9;35088685;35096591;7906;0
16801;ENSG00000165283;STOML2;9;35099888;35103154;3266;0
16802;ENSG00000165288;BRWD3;X;79926353;80065187;138834;0
16803;ENSG00000165304;MELK;9;36572859;36677678;104819;1
16804;ENSG00000165349;SLC7A3;X;70145432;70150975;5543;0
16805;ENSG00000165359;DDX26B;X;134654584;134716435;61851;0
16806;ENSG00000165392;WRN;8;30891317;31031285;139968;0
16807;ENSG00000165509;MAGEC3;X;140926102;140985618;59516;0
16808;ENSG00000165591;FAAH2;X;57313139;57515629;202490;0
16809;ENSG00000165661;QSOX2;9;139098179;139137687;39508;0
16810;ENSG00000165671;NSD1;5;176560026;176727216;167190;0
16811;ENSG00000165675;ENOX2;X;129757350;130037208;279858;0
16812;ENSG00000165684;SNAPC4;9;139270029;139293249;23220;0
16813;ENSG00000165688;PMPCA;9;139305110;139318213;13103;0
16814;ENSG00000165689;SDCCAG3;9;139296377;139305061;8684;0
16815;ENSG00000165694;FRMD7;X;131211021;131262048;51027;0
16816;ENSG00000165695;AK8;9;135600965;135754164;153199;0
16817;ENSG00000165698;C9orf9;9;135753414;135765588;12174;0
16818;ENSG00000165699;TSC1;9;135766735;135820020;53285;0
16819;ENSG00000165704;HPRT1;X;133594183;133654543;60360;0
16820;ENSG00000165716;FAM69B;9;139607022;139618502;11480;0
16821;ENSG00000165724;ZMYND19;9;140476531;140484942;8411;0
16822;ENSG00000165775;FUNDC2;X;154254255;154288578;34323;0
16823;ENSG00000165802;NSMF;9;140342022;140353786;11764;0
16824;ENSG00000165810;BTNL9;5;180467225;180488523;21298;0
16825;ENSG00000166049;PASD1;X;150732094;150845211;113117;0
16826;ENSG00000166278;C2;6;31865562;31913449;47887;0
16827;ENSG00000166432;ZMAT1;X;101137262;101187004;49742;0
16828;ENSG00000166448;TMEM130;7;98444111;98468394;24283;0
16829;ENSG00000166508;MCM7;7;99690351;99699563;9212;0
16830;ENSG00000166526;ZNF3;7;99661656;99680171;18515;0
16831;ENSG00000166529;ZSCAN21;7;99647390;99662661;15271;0
16832;ENSG00000166681;NGFRAP1;X;102631268;102633005;1737;0
16833;ENSG00000166707;ZCCHC18;X;103356822;103360533;3711;0
16834;ENSG00000166924;NYAP1;7;100081550;100092422;10872;0
16835;ENSG00000166925;TSC22D4;7;100060982;100076902;15920;0
16836;ENSG00000166997;CNPY4;7;99717236;99723134;5898;0
16837;ENSG00000167011;NAT16;7;100813774;100823557;9783;0
16838;ENSG00000167081;PBX3;9;128509624;128729656;220032;0
16839;ENSG00000167103;PIP5KL1;9;130683158;130693076;9918;0
16840;ENSG00000167106;FAM102A;9;130702858;130742792;39934;0
16841;ENSG00000167110;GOLGA2;9;131018108;131038274;20166;0
16842;ENSG00000167112;TRUB2;9;131071382;131085021;13639;0
16843;ENSG00000167113;COQ4;9;131084815;131096351;11536;0
16844;ENSG00000167114;SLC27A4;9;131102925;131123749;20824;0
16845;ENSG00000167118;URM1;9;131133598;131153015;19417;0
16846;ENSG00000167123;CERCAM;9;131174030;131199626;25596;0
16847;ENSG00000167130;DOLPP1;9;131843379;131852717;9338;0
16848;ENSG00000167136;ENDOG;9;131580753;131584956;4203;0
16849;ENSG00000167393;PPP2R3B;X;294698;347690;52992;0
16850;ENSG00000167632;TRAPPC9;8;140742586;141468678;726092;0
16851;ENSG00000167700;MFSD3;8;145734457;145736596;2139;0
16852;ENSG00000167701;GPT;8;145728356;145732557;4201;0
16853;ENSG00000167702;KIFC2;8;145691426;145699585;8159;0
16854;ENSG00000167904;TMEM68;8;56608983;56685966;76983;0
16855;ENSG00000167912;;8;60031599;60033905;2306;0
16856;ENSG00000168077;SCARA3;8;27491385;27534293;42908;0
16857;ENSG00000168078;PBK;8;27667137;27695612;28475;0
16858;ENSG00000168090;COPS6;7;99686577;99689823;3246;0
16859;ENSG00000168116;KIAA1586;6;56911347;56920023;8676;0
16860;ENSG00000168172;HOOK3;8;42752075;42885682;133607;0
16861;ENSG00000168216;LMBRD1;6;70385694;70507003;121309;0
16862;ENSG00000168246;UBTD2;5;171636644;171711075;74431;0
16863;ENSG00000168255;POLR2J3;7;102178365;102213103;34738;0
16864;ENSG00000168274;HIST1H2AE;6;26217165;26217711;546;0
16865;ENSG00000168300;PCMTD1;8;52730140;52811735;81595;0
16866;ENSG00000168303;MPLKIP;7;40165622;40174258;8636;0
16867;ENSG00000168394;TAP1;6;32812986;32821755;8769;1
16868;ENSG00000168438;CDC40;6;110501344;110575478;74134;0
16869;ENSG00000168476;REEP4;8;21995533;21999464;3931;0
16870;ENSG00000168477;TNXB;6;32008931;32083111;74180;0
16871;ENSG00000168481;LGI3;8;22004338;22014597;10259;0
16872;ENSG00000168487;BMP1;8;22022249;22069839;47590;0
16873;ENSG00000168490;PHYHIP;8;22077222;22089854;12632;0
16874;ENSG00000168495;POLR3D;8;22102617;22112113;9496;0
16875;ENSG00000168522;FNTA;8;42889337;42940931;51594;0
16876;ENSG00000168546;GFRA2;8;21547915;21669869;121954;0
16877;ENSG00000168566;SNRNP48;6;7590432;7612200;21768;0
16878;ENSG00000168575;SLC20A2;8;42273993;42397069;123076;0
16879;ENSG00000168615;ADAM9;8;38854388;38962663;108275;0
16880;ENSG00000168672;FAM84B;8;127564687;127570638;5951;0
16881;ENSG00000168795;ZBTB5;9;37438111;37465396;27285;0
16882;ENSG00000168913;ENHO;9;34521038;34523039;2001;0
16883;ENSG00000168916;ZNF608;5;123972608;124084500;111892;0
16884;ENSG00000168938;PPIC;5;122358945;122372436;13491;1
16885;ENSG00000168939;SPRY3;X;154997474;155012121;14647;0
16886;ENSG00000168944;CEP120;5;122680579;122759286;78707;0
16887;ENSG00000168994;PXDC1;6;3722848;3752260;29412;0
16888;ENSG00000169045;HNRNPH1;5;179041179;179061785;20606;0
16889;ENSG00000169057;MECP2;X;153287024;153363212;76188;0
16890;ENSG00000169071;ROR2;9;94325373;94712444;387071;0
16891;ENSG00000169083;AR;X;66764465;66950461;185996;1
16892;ENSG00000169084;DHRSX;X;2137557;2420846;283289;1
16893;ENSG00000169085;C8orf46;8;67372238;67430759;58521;0
16894;ENSG00000169093;ASMTL;X;1522032;1572655;50623;0
16895;ENSG00000169100;SLC25A6;X;1505045;1511617;6572;0
16896;ENSG00000169122;FAM110B;8;58907068;59116838;209770;0
16897;ENSG00000169131;ZNF354A;5;178138593;178157703;19110;0
16898;ENSG00000169139;UBE2V2;8;48920960;48977268;56308;0
16899;ENSG00000169155;ZBTB43;9;129567285;129600489;33204;0
16900;ENSG00000169188;APEX2;X;55026790;55035490;8700;0
16901;ENSG00000169193;CCDC126;7;23636998;23684327;47329;0
16902;ENSG00000169220;RGS14;5;176784838;176799602;14764;0
16903;ENSG00000169223;LMAN2;5;176758563;176778853;20290;0
16904;ENSG00000169228;RAB24;5;176728199;176730745;2546;0
16905;ENSG00000169230;PRELID1;5;176730775;176733960;3185;0
16906;ENSG00000169239;CA5B;X;15706953;15805747;98794;0
16907;ENSG00000169247;SH3TC2;5;148303202;148442726;139524;0
16908;ENSG00000169249;ZRSR2;X;15808595;15841383;32788;0
16909;ENSG00000169258;GPRIN1;5;176022803;176037134;14331;0
16910;ENSG00000169302;STK32A;5;146614526;146767415;152889;0
16911;ENSG00000169306;IL1RAPL1;X;28605516;29974840;1369324;0
16912;ENSG00000169398;PTK2;8;141667999;142012315;344316;0
16913;ENSG00000169402;RSPH10B2;7;6793740;6838996;45256;0
16914;ENSG00000169427;KCNK9;8;140613081;140715299;102218;0
16915;ENSG00000169439;SDC2;8;97505579;97624000;118421;0
16916;ENSG00000169446;MMGT1;X;135044229;135056222;11993;0
16917;ENSG00000169490;TM2D2;8;38846327;38854343;8016;0
16918;ENSG00000169499;PLEKHA2;8;38758753;38831428;72675;0
16919;ENSG00000169567;HINT1;5;130494720;130507428;12708;0
16920;ENSG00000169570;DTWD2;5;118173017;118324240;151223;0
16921;ENSG00000169692;AGPAT2;9;139567595;139581875;14280;0
16922;ENSG00000169871;TRIM56;7;100728720;100735017;6297;1
16923;ENSG00000169891;REPS2;X;16964814;17171395;206581;1
16924;ENSG00000169894;MUC3A;7;100547187;100611118;63931;0
16925;ENSG00000169895;SYAP1;X;16737755;16783459;45704;0
16926;ENSG00000169902;TPST1;7;65670186;65885530;215344;0
16927;ENSG00000169919;GUSB;7;65425671;65447301;21630;0
16928;ENSG00000169925;BRD3;9;136895427;136933657;38230;0
16929;ENSG00000169933;FRMPD4;X;12156585;12742642;586057;0
16930;ENSG00000169946;ZFPM2;8;106330920;106816760;485840;0
16931;ENSG00000169953;HSFY2;Y;20893326;20990548;97222;0
16932;ENSG00000169976;SF3B5;6;144416018;144416754;736;0
16933;ENSG00000170027;YWHAG;7;75956116;75988348;32232;0
16934;ENSG00000170085;SIMC1;5;175665365;175772994;107629;0
16935;ENSG00000170089;;5;177236408;177377733;141325;0
16936;ENSG00000170091;;5;173472607;173670504;197897;0
16937;ENSG00000170122;FOXD4;9;116237;118417;2180;0
16938;ENSG00000170161;;9;66553273;66555928;2655;0
16939;ENSG00000170165;;9;44051024;44069881;18857;0
16940;ENSG00000170214;ADRA1B;5;159343790;159399551;55761;0
16941;ENSG00000170231;FABP6;5;159614374;159665742;51368;0
16942;ENSG00000170234;PWWP2A;5;159488808;159546430;57622;0
16943;ENSG00000170260;ZNF212;7;148936742;148952700;15958;0
16944;ENSG00000170265;ZNF282;7;148892577;148923339;30762;0
16945;ENSG00000170271;FAXDC2;5;154198051;154238812;40761;1
16946;ENSG00000170381;SEMA3E;7;82993222;83278326;285104;0
16947;ENSG00000170419;VSTM2A;7;54610018;54638773;28755;0
16948;ENSG00000170445;HARS;5;140052758;140071609;18851;0
16949;ENSG00000170458;CD14;5;140011313;140013286;1973;1
16950;ENSG00000170464;DNAJC18;5;138744279;138780180;35901;0
16951;ENSG00000170469;SPATA24;5;138732252;138739777;7525;0
16952;ENSG00000170542;SERPINB9;6;2887500;2903514;16014;0
16953;ENSG00000170584;NUDCD2;5;162873532;162887146;13614;0
16954;ENSG00000170606;HSPA4;5;132387654;132442141;54487;0
16955;ENSG00000170616;SCRT1;8;145554228;145559943;5715;0
16956;ENSG00000170619;COMMD5;8;146066427;146079121;12694;0
16957;ENSG00000170624;SGCD;5;155297354;156194799;897445;1
16958;ENSG00000170629;DPY19L2P2;7;102815580;102920857;105277;0
16959;ENSG00000170631;ZNF16;8;146155744;146176274;20530;0
16960;ENSG00000170632;ARMC10;7;102715328;102740205;24877;0
16961;ENSG00000170667;RASA4B;7;102122892;102158228;35336;0
16962;ENSG00000170681;MURC;9;103340361;103350188;9827;0
16963;ENSG00000170727;BOP1;8;145486055;145515082;29027;0
16964;ENSG00000170734;POLH;6;43543887;43586701;42814;0
16965;ENSG00000170775;GPR37;7;124386051;124405681;19630;0
16966;ENSG00000170791;CHCHD7;8;57124245;57131357;7112;0
16967;ENSG00000170835;CEL;9;135937365;135947248;9883;0
16968;ENSG00000170852;KBTBD2;7;32907784;32933743;25959;0
16969;ENSG00000170873;MTSS1;8;125563031;125740730;177699;0
16970;ENSG00000170881;RNF139;8;125486979;125500155;13176;0
16971;ENSG00000170899;GSTA4;6;52842751;52860176;17425;0
16972;ENSG00000170915;PAQR8;6;52226219;52272575;46356;0
16973;ENSG00000170927;PKHD1;6;51480098;51952423;472325;0
16974;ENSG00000170961;HAS2;8;122624356;122653630;29274;0
16975;ENSG00000171004;HS6ST2;X;131760044;132095423;335379;1
16976;ENSG00000171033;PKIA;8;79428374;79517502;89128;0
16977;ENSG00000171044;XKR6;8;10753555;11058875;305320;0
16978;ENSG00000171045;TSNARE1;8;143293441;143484601;191160;0
16979;ENSG00000171056;SOX7;8;10581278;10697357;116079;0
16980;ENSG00000171097;CCBL1;9;131595221;131644773;49552;0
16981;ENSG00000171100;MTM1;X;149737069;149841795;104726;0
16982;ENSG00000171130;ATP6V0E2;7;149570057;149577784;7727;0
16983;ENSG00000171155;C1GALT1C1;X;119759648;119764005;4357;0
16984;ENSG00000171159;C9orf16;9;130922539;130926207;3668;0
16985;ENSG00000171169;NAIF1;9;130823512;130830485;6973;0
16986;ENSG00000171243;SOSTDC1;7;16501106;16570205;69099;0
16987;ENSG00000171316;CHD7;8;61591337;61779465;188128;0
16988;ENSG00000171320;ESCO2;8;27629466;27670157;40691;1
16989;ENSG00000171365;CLCN5;X;49687225;49863892;176667;0
16990;ENSG00000171388;APLN;X;128779240;128788933;9693;0
16991;ENSG00000171408;PDE7B;6;136172834;136516712;343878;0
16992;ENSG00000171428;NAT1;8;18027986;18081198;53212;0
16993;ENSG00000171444;MCC;5;112357796;112824527;466731;0
16994;ENSG00000171448;ZBTB26;9;125677845;125693779;15934;0
16995;ENSG00000171453;POLR1C;6;43477440;43497323;19883;0
16996;ENSG00000171462;DLK2;6;43418090;43424370;6280;0
16997;ENSG00000171467;ZNF318;6;43274872;43337216;62344;0
16998;ENSG00000171530;TBCA;5;76986991;77164604;177613;0
16999;ENSG00000171604;CXXC5;5;139026884;139063467;36583;0
17000;ENSG00000171720;HDAC3;5;141000443;141016437;15994;0
17001;ENSG00000171815;PCDHB1;5;140430979;140433512;2533;0
17002;ENSG00000171843;MLLT3;9;20341663;20622542;280879;0
17003;ENSG00000171992;SYNPO;5;149980642;150038782;58140;0
17004;ENSG00000172014;ANKRD20A4;9;69381812;69425560;43748;0
17005;ENSG00000172115;CYCS;7;25159710;25164980;5270;0
17006;ENSG00000172159;FRMD3;9;85857905;86153461;295556;0
17007;ENSG00000172164;SNTB1;8;121547985;121825513;277528;1
17008;ENSG00000172167;MTBP;8;121457640;121554373;96733;0
17009;ENSG00000172172;MRPL13;8;121393000;121457642;64642;0
17010;ENSG00000172197;MBOAT1;6;20100935;20212670;111735;0
17011;ENSG00000172201;ID4;6;19837617;19840915;3298;0
17012;ENSG00000172209;GPR22;7;107110463;107116098;5635;0
17013;ENSG00000172331;BPGM;7;134331560;134364565;33005;0
17014;ENSG00000172336;POP7;7;100303676;100305118;1442;0
17015;ENSG00000172348;RCAN2;6;46188475;46459709;271234;0
17016;ENSG00000172354;GNB2;7;100271154;100276797;5643;0
17017;ENSG00000172426;RSPH9;6;43612783;43640336;27553;0
17018;ENSG00000172432;GTPBP2;6;43573053;43596899;23846;0
17019;ENSG00000172461;FUT9;6;96463860;96663488;199628;0
17020;ENSG00000172465;TCEAL1;X;102883632;102885881;2249;0
17021;ENSG00000172469;MANEA;6;96025419;96057333;31914;0
17022;ENSG00000172476;RAB40A;X;102754678;102774417;19739;0
17023;ENSG00000172497;ACOT12;5;80625824;80689998;64174;0
17024;ENSG00000172534;HCFC1;X;153213004;153237258;24254;0
17025;ENSG00000172568;FNDC9;5;156768608;156772729;4121;0
17026;ENSG00000172594;SMPDL3A;6;123110315;123130865;20550;0
17027;ENSG00000172728;FUT10;8;33228342;33330940;102598;0
17028;ENSG00000172733;PURG;8;30853321;30891231;37910;0
17029;ENSG00000172738;TMEM217;6;37179956;37225931;45975;0
17030;ENSG00000172748;ZNF596;8;182137;197342;15205;0
17031;ENSG00000172785;CBWD1;9;121041;188979;67938;0
17032;ENSG00000172795;DCP2;5;112312399;112356667;44268;0
17033;ENSG00000172817;CYP7B1;8;65500320;65711318;210998;0
17034;ENSG00000172869;DMXL1;5;118373467;118584833;211366;0
17035;ENSG00000172889;EGFL7;9;139553308;139567130;13822;0
17036;ENSG00000172901;;5;115298151;115363316;65165;0
17037;ENSG00000172943;PHF8;X;53963109;54075391;112282;0
17038;ENSG00000173041;ZNF680;7;63980262;64023484;43222;0
17039;ENSG00000173068;BNC2;9;16409501;16870841;461340;0
17040;ENSG00000173114;LRRN3;7;110731062;110765510;34448;0
17041;ENSG00000173137;ADCK5;8;145596790;145618457;21667;0
17042;ENSG00000173210;ABLIM3;5;148521046;148640105;119059;0
17043;ENSG00000173214;KIAA1919;6;111580551;111592370;11819;0
17044;ENSG00000173221;GLRX;5;95087023;95158709;71686;0
17045;ENSG00000173258;ZNF483;9;114287439;114340124;52685;0
17046;ENSG00000173261;PLAC8L1;5;145463949;145483932;19983;0
17047;ENSG00000173273;TNKS;8;9413424;9639856;226432;0
17048;ENSG00000173275;ZNF449;X;134478721;134497077;18356;0
17049;ENSG00000173281;PPP1R3B;8;8993765;9009084;15319;0
17050;ENSG00000173295;FAM86B3P;8;8086117;8102387;16270;0
17051;ENSG00000173334;TRIB1;8;126442563;126450647;8084;0
17052;ENSG00000173452;TMEM196;7;19758933;19813221;54288;0
17053;ENSG00000173530;TNFRSF10D;8;22993101;23021543;28442;0
17054;ENSG00000173566;NUDT18;8;21964383;21966932;2549;0
17055;ENSG00000173611;SCAI;9;127704887;127905785;200898;0
17056;ENSG00000173626;TRAPPC3L;6;116816152;116866773;50621;0
17057;ENSG00000173674;EIF1AX;X;20142636;20159962;17326;0
17058;ENSG00000173681;CXorf23;X;19930978;19988416;57438;0
17059;ENSG00000173698;GPR64;X;19007427;19140755;133328;0
17060;ENSG00000173852;DPY19L1;7;34968488;35077883;109395;0
17061;ENSG00000173926;03-Mar;5;126203406;126366500;163094;0
17062;ENSG00000173930;SLCO4C1;5;101569690;101632253;62563;0
17063;ENSG00000174010;KLHL15;X;24001837;24045303;43466;0
17064;ENSG00000174028;FAM3C2;X;23093875;23094884;1009;0
17065;ENSG00000174132;FAM174A;5;99871009;99922445;51436;0
17066;ENSG00000174136;RGMB;5;98104354;98134347;29993;0
17067;ENSG00000174353;STAG3L3;7;72440227;72476445;36218;0
17068;ENSG00000174374;WBSCR16;7;74441226;74490064;48838;0
17069;ENSG00000174428;GTF2IRD2B;7;74508364;74565623;57259;0
17070;ENSG00000174460;ZCCHC12;X;117957753;117960931;3178;0
17071;ENSG00000174469;CNTNAP2;7;145813453;148118090;2304637;0
17072;ENSG00000174482;LINGO2;9;27948076;28670283;722207;0
17073;ENSG00000174695;TMEM167A;5;82348665;82373682;25017;0
17074;ENSG00000174705;SH3PXD2B;5;171752185;171881527;129342;0
17075;ENSG00000174740;PABPC5;X;90689594;90693583;3989;0
17076;ENSG00000174945;AMZ1;7;2719156;2815134;95978;0
17077;ENSG00000175003;SLC22A1;6;160542821;160579750;36929;0
17078;ENSG00000175048;ZDHHC14;6;157802165;158099178;297013;0
17079;ENSG00000175073;VCPIP1;8;67540722;67579452;38730;0
17080;ENSG00000175283;DOLK;9;131707809;131709898;2089;0
17081;ENSG00000175305;CCNE2;8;95891998;95908906;16908;0
17082;ENSG00000175309;PHYKPL;5;177635498;177659792;24294;0
17083;ENSG00000175324;LSM1;8;38020839;38034248;13409;0
17084;ENSG00000175414;ARL10;5;175792471;175828866;36395;0
17085;ENSG00000175416;CLTB;5;175819456;175843570;24114;0
17086;ENSG00000175426;PCSK1;5;95726119;95769847;43728;0
17087;ENSG00000175445;LPL;8;19759228;19824769;65541;1
17088;ENSG00000175449;RFESD;5;94982458;95020477;38019;0
17089;ENSG00000175471;MCTP1;5;94039446;94620279;580833;0
17090;ENSG00000175556;LONRF3;X;118108581;118152318;43737;0
17091;ENSG00000175600;SUGCT;7;40174575;40900362;725787;0
17092;ENSG00000175606;TMEM70;8;74884672;74895018;10346;0
17093;ENSG00000175611;LINC00476;9;98521513;98638259;116746;0
17094;ENSG00000175741;RWDD4P2;7;39894093;39894655;562;0
17095;ENSG00000175745;NR2F1;5;92919043;92930321;11278;0
17096;ENSG00000175749;EIF3KP1;5;102368080;102368735;655;0
17097;ENSG00000175764;TTLL11;9;124584207;124855885;271678;0
17098;ENSG00000175766;EIF4E1B;5;176057683;176073642;15959;0
17099;ENSG00000175768;TOMM5;9;37582643;37592639;9996;0
17100;ENSG00000175787;ZNF169;9;97021593;97063736;42143;0
17101;ENSG00000175806;MSRA;8;9911778;10286401;374623;0
17102;ENSG00000175854;SWI5;9;131037658;131051269;13611;0
17103;ENSG00000175873;;7;2477398;2487485;10087;0
17104;ENSG00000175893;ZDHHC21;9;14611069;14693469;82400;0
17105;ENSG00000175895;PLEKHF2;8;96146032;96168912;22880;0
17106;ENSG00000175967;;6;114225302;114242806;17504;0
17107;ENSG00000176018;LYSMD3;5;89811428;89825401;13973;0
17108;ENSG00000176049;JAKMIP2;5;146967990;147162338;194348;0
17109;ENSG00000176055;MBLAC2;5;89754020;89770585;16565;0
17110;ENSG00000176058;TPRN;9;140086069;140098645;12576;0
17111;ENSG00000176087;SLC35A4;5;139944041;139948688;4647;0
17112;ENSG00000176101;SSNA1;9;140083099;140084822;1723;0
17113;ENSG00000176125;UFSP1;7;100486346;100487339;993;0
17114;ENSG00000176209;SMIM19;8;42396298;42409603;13305;0
17115;ENSG00000176248;ANAPC2;9;140069236;140082989;13753;0
17116;ENSG00000176274;SLC25A53;X;103343898;103401708;57810;0
17117;ENSG00000176381;PRR18;6;166719168;166721936;2768;0
17118;ENSG00000176386;CDC26;9;116018115;116037869;19754;0
17119;ENSG00000176399;DMRTA1;9;22446840;22455739;8899;0
17120;ENSG00000176406;RIMS2;8;104512976;105268322;755346;0
17121;ENSG00000176410;DNAJC30;7;73095299;73097783;2484;0
17122;ENSG00000176428;VPS37D;7;73082155;73086442;4287;0
17123;ENSG00000176595;KBTBD11;8;1922044;1955102;33058;0
17124;ENSG00000176623;RMDN1;8;87480486;87526586;46100;0
17125;ENSG00000176728;TTTY14;Y;21034387;21239302;204915;0
17126;ENSG00000176731;C8orf59;8;86126311;86132650;6339;0
17127;ENSG00000176783;RUFY1;5;178977559;179037027;59468;0
17128;ENSG00000176853;FAM91A1;8;124780696;124827692;46996;0
17129;ENSG00000176884;GRIN1;9;140032842;140063207;30365;0
17130;ENSG00000176896;TCEANC;X;13671225;13700083;28858;0
17131;ENSG00000176907;C8orf4;8;40010989;40012821;1832;1
17132;ENSG00000176919;C8G;9;139839698;139841426;1728;0
17133;ENSG00000176956;LY6H;8;144239331;144242128;2797;0
17134;ENSG00000176978;DPP7;9;140004994;140009629;4635;0
17135;ENSG00000177034;MTX3;5;79275584;79287082;11498;0
17136;ENSG00000177076;ACER2;9;19408925;19452018;43093;0
17137;ENSG00000177125;ZBTB34;9;129622944;129648157;25213;0
17138;ENSG00000177182;CLVS1;8;61969717;62414204;444487;0
17139;ENSG00000177189;RPS6KA3;X;20168029;20285523;117494;0
17140;ENSG00000177239;MAN1B1;9;139981379;140003635;22256;0
17141;ENSG00000177306;OR7E125P;8;7104248;7105874;1626;0
17142;ENSG00000177409;SAMD9L;7;92759368;92777682;18314;0
17143;ENSG00000177459;C8orf47;8;99076539;99105838;29299;0
17144;ENSG00000177485;ZBTB33;X;119384607;119392253;7646;0
17145;ENSG00000177556;ATOX1;5;151121877;151152093;30216;0
17146;ENSG00000177570;SAMD12;8;119201698;119634234;432536;0
17147;ENSG00000177679;SRRM3;7;75831216;75916605;85389;0
17148;ENSG00000177683;THAP5;7;108194987;108210194;15207;0
17149;ENSG00000177706;FAM20C;7;192969;300711;107742;0
17150;ENSG00000177710;SLC35G5;8;11188397;11189717;1320;0
17151;ENSG00000177733;HNRNPA0;5;137087075;137090039;2964;0
17152;ENSG00000177839;PCDHB9;5;140566893;140571111;4218;0
17153;ENSG00000177854;TMEM187;X;153237778;153248646;10868;0
17154;ENSG00000177879;AP3S1;5;115177178;115249778;72600;0
17155;ENSG00000177932;ZNF354C;5;178487416;178510538;23122;0
17156;ENSG00000177943;MAMDC4;9;139745395;139755249;9854;0
17157;ENSG00000178031;ADAMTSL1;9;18473892;18910948;437056;0
17158;ENSG00000178033;FAM26E;6;116832809;116845955;13146;0
17159;ENSG00000178125;PPP1R42;8;67876334;67968839;92505;0
17160;ENSG00000178187;ZNF454;5;178368192;178393434;25242;0
17161;ENSG00000178199;ZC3H12D;6;149768794;149806197;37403;0
17162;ENSG00000178209;PLEC;8;144989321;145050902;61581;0
17163;ENSG00000178233;TMEM151B;6;44238203;44275243;37040;0
17164;ENSG00000178234;GALNT11;7;151722759;151819425;96666;0
17165;ENSG00000178338;ZNF354B;5;178286954;178315123;28169;0
17166;ENSG00000178381;ZFAND2A;7;1191707;1200395;8688;0
17167;ENSG00000178397;FAM220A;7;6369040;6388612;19572;0
17168;ENSG00000178409;BEND3;6;107386386;107436473;50087;0
17169;ENSG00000178425;NT5DC1;6;116422012;116570660;148648;0
17170;ENSG00000178445;GLDC;9;6532464;6645650;113186;0
17171;ENSG00000178538;CA8;8;61099906;61193971;94065;1
17172;ENSG00000178605;GTPBP6;X;220025;230886;10861;0
17173;ENSG00000178665;ZNF713;7;55955169;56009918;54749;0
17174;ENSG00000178685;PARP10;8;145051321;145086940;35619;0
17175;ENSG00000178719;GRINA;8;145064226;145067583;3357;0
17176;ENSG00000178764;ZHX2;8;123793633;123986750;193117;0
17177;ENSG00000178809;TRIM73;7;75024337;75040279;15942;0
17178;ENSG00000178826;TMEM139;7;142977050;142985141;8091;0
17179;ENSG00000178896;EXOSC4;8;145133529;145135550;2021;0
17180;ENSG00000178913;TAF7;5;140698057;140700330;2273;0
17181;ENSG00000178947;LINC00086;X;134555868;134561999;6131;0
17182;ENSG00000178966;RMI1;9;86595626;86618985;23359;0
17183;ENSG00000179041;RRS1;8;67341263;67342966;1703;0
17184;ENSG00000179083;FAM133A;X;92929012;92967273;38261;0
17185;ENSG00000179091;CYC1;8;145149930;145152428;2498;0
17186;ENSG00000179222;MAGED1;X;51546103;51645453;99350;0
17187;ENSG00000179304;FAM156B;X;52920336;52937587;17251;0
17188;ENSG00000179363;TMEM31;X;102965837;102968956;3119;0
17189;ENSG00000179388;EGR3;8;22545172;22550815;5643;1
17190;ENSG00000179406;LINC00174;7;65841031;65866325;25294;0
17191;ENSG00000179526;SHARPIN;8;145153536;145163027;9491;0
17192;ENSG00000179542;SLITRK4;X;142710596;142723596;13000;0
17193;ENSG00000179562;GCC1;7;127220672;127233665;12993;0
17194;ENSG00000179603;GRM8;7;126078652;126893348;814696;1
17195;ENSG00000179632;MAF1;8;145159402;145162514;3112;0
17196;ENSG00000179698;KIAA1875;8;145162629;145173218;10589;0
17197;ENSG00000179766;ATP8B5P;9;35406752;35483026;76274;0
17198;ENSG00000179832;MROH1;8;145202919;145316843;113924;0
17199;ENSG00000179869;ABCA13;7;48211055;48687092;476037;0
17200;ENSG00000179886;TIGD5;8;144680074;144682485;2411;0
17201;ENSG00000179950;PUF60;8;144898514;144912029;13515;0
17202;ENSG00000180071;ANKRD18A;9;38540566;38620657;80091;1
17203;ENSG00000180113;TDRD6;6;46655612;46672056;16444;1
17204;ENSG00000180155;LYNX1;8;143845752;143859640;13888;0
17205;ENSG00000180182;MED14;X;40507558;40595110;87552;0
17206;ENSG00000180190;TDRP;8;439803;495781;55978;0
17207;ENSG00000180233;ZNRF2;7;30323923;30452118;128195;0
17208;ENSG00000180316;PNPLA1;6;36210980;36276372;65392;0
17209;ENSG00000180354;MTURN;7;30174426;30202378;27952;0
17210;ENSG00000180447;GAS1;9;89559279;89562104;2825;0
17211;ENSG00000180537;RNF182;6;13924677;13980533;55856;0
17212;ENSG00000180549;FUT7;9;139924626;139927462;2836;0
17213;ENSG00000180573;HIST1H2AC;6;26124373;26139344;14971;0
17214;ENSG00000180694;TMEM64;8;91634223;91803860;169637;0
17215;ENSG00000180815;MAP3K15;X;19378174;19533379;155205;0
17216;ENSG00000180822;PSMG4;6;3231637;3303607;71970;0
17217;ENSG00000180828;BHLHE22;8;65492814;65496181;3367;1
17218;ENSG00000180879;SSR4;X;153058971;153063960;4989;0
17219;ENSG00000180900;SCRIB;8;144873090;144897549;24459;0
17220;ENSG00000180921;FAM83H;8;144806103;144815971;9868;0
17221;ENSG00000180938;ZNF572;8;125985540;125991631;6091;0
17222;ENSG00000180964;TCEAL8;X;102507923;102510131;2208;0
17223;ENSG00000180992;MRPL14;6;44081194;44095194;14000;0
17224;ENSG00000181016;LSMEM1;7;112120908;112131117;10209;0
17225;ENSG00000181072;CHRM2;7;136553416;136705002;151586;0
17226;ENSG00000181085;MAPK15;8;144798429;144804628;6199;0
17227;ENSG00000181090;EHMT1;9;140513444;140764468;251024;0
17228;ENSG00000181097;;8;144778324;144780583;2259;0
17229;ENSG00000181104;F2R;5;76011868;76031606;19738;0
17230;ENSG00000181135;ZNF707;8;144766622;144796068;29446;0
17231;ENSG00000181163;NPM1;5;170814120;170838141;24021;0
17232;ENSG00000181191;PJA1;X;68380694;68385636;4942;0
17233;ENSG00000181211;HECW1-IT1;7;43157495;43202786;45291;0
17234;ENSG00000181220;ZNF746;7;149169885;149194908;25023;0
17235;ENSG00000181315;ZNF322;6;26636518;26659980;23462;0
17236;ENSG00000181404;;9;14511;29739;15228;0
17237;ENSG00000181444;ZNF467;7;149461271;149470568;9297;0
17238;ENSG00000181472;ZBTB2;6;151685252;151712683;27431;0
17239;ENSG00000181524;RPL24P4;6;42924083;42924503;420;0
17240;ENSG00000181544;FANCB;X;14861529;14891191;29662;0
17241;ENSG00000181638;ZFP41;8;144328991;144344875;15884;0
17242;ENSG00000181652;ATG9B;7;150709297;150721586;12289;0
17243;ENSG00000181690;PLAG1;8;57073463;57123883;50420;0
17244;ENSG00000181704;YIPF6;X;67718165;67757127;38962;0
17245;ENSG00000181751;C5orf30;5;102594403;102614361;19958;0
17246;ENSG00000181790;BAI1;8;143530791;143626370;95579;0
17247;ENSG00000181904;C5orf24;5;134181370;134195427;14057;0
17248;ENSG00000182095;TNRC18;7;5346421;5465045;118624;0
17249;ENSG00000182132;KCNIP1;5;169780491;170163636;383145;1
17250;ENSG00000182150;ERCC6L2;9;98637983;98776842;138859;0
17251;ENSG00000182154;MRPL41;9;140445651;140447007;1356;0
17252;ENSG00000182158;CREB3L2;7;137559725;137686813;127088;0
17253;ENSG00000182165;TP53TG1;7;86954541;86974831;20290;0
17254;ENSG00000182195;LDOC1;X;140269934;140271310;1376;0
17255;ENSG00000182197;EXT1;8;118806729;119124092;317363;0
17256;ENSG00000182220;ATP6AP2;X;40440146;40465889;25743;0
17257;ENSG00000182287;AP1S2;X;15843929;15873054;29125;0
17258;ENSG00000182307;C8orf33;8;146277764;146281416;3652;0
17259;ENSG00000182319;;8;8175258;8244008;68750;0
17260;ENSG00000182325;FBXL6;8;145579091;145583036;3945;0
17261;ENSG00000182348;ZNF804B;7;88388682;88966346;577664;0
17262;ENSG00000182368;FAM27A;9;45727107;45728274;1167;0
17263;ENSG00000182372;CLN8;8;1703944;1734738;30794;0
17264;ENSG00000182378;PLCXD1;X;192989;220023;27034;0
17265;ENSG00000182484;WASH6P;X;155250491;155255375;4884;0
17266;ENSG00000182508;LHFPL1;X;111873876;111923375;49499;0
17267;ENSG00000182518;FAM104B;X;55169535;55187743;18208;0
17268;ENSG00000182646;FAM156A;X;52976462;53024651;48189;0
17269;ENSG00000182648;LINC01006;7;156264890;156433286;168396;0
17270;ENSG00000182674;KCNB2;8;73449626;73850584;400958;0
17271;ENSG00000182700;IGIP;5;139505521;139508391;2870;0
17272;ENSG00000182722;SEPHS1P1;7;64312775;64313732;957;0
17273;ENSG00000182752;PAPPA;9;118916083;119164601;248518;0
17274;ENSG00000182872;RBM10;X;47004268;47046212;41944;0
17275;ENSG00000182890;GLUD2;X;120181462;120183794;2332;0
17276;ENSG00000182916;TCEAL7;X;102585124;102587254;2130;0
17277;ENSG00000182952;HMGN4;6;26538633;26546482;7849;0
17278;ENSG00000183111;ARHGEF37;5;148931510;149014531;83021;0
17279;ENSG00000183117;CSMD1;8;2792875;4852494;2059619;0
17280;ENSG00000183137;CEP57L1;6;109416313;109485135;68822;0
17281;ENSG00000183154;;8;37592279;37594944;2665;0
17282;ENSG00000183166;CALN1;7;71244476;71912136;667660;0
17283;ENSG00000183171;;X;149282609;149284751;2142;0
17284;ENSG00000183258;DDX41;5;176938578;176944470;5892;0
17285;ENSG00000183309;ZNF623;8;144718183;144735900;17717;0
17286;ENSG00000183337;BCOR;X;39909068;40036582;127514;0
17287;ENSG00000183354;KIAA2026;9;5881596;6007901;126305;0
17288;ENSG00000183444;OR7E38P;7;97595402;97596386;984;0
17289;ENSG00000183638;RP1L1;8;10463859;10569697;105838;1
17290;ENSG00000183665;TRMT12;8;125463048;125474391;11343;0
17291;ENSG00000183690;EFHC2;X;44007128;44202918;195790;1
17292;ENSG00000183696;UPP1;7;48128225;48148330;20105;0
17293;ENSG00000183718;TRIM52;5;180681417;180688119;6702;0
17294;ENSG00000183729;NPBWR1;8;53850991;53853677;2686;0
17295;ENSG00000183742;MACC1;7;20174278;20257027;82749;0
17296;ENSG00000183775;KCTD16;5;143550396;143865249;314853;0
17297;ENSG00000183779;ZNF703;8;37553269;37557537;4268;0
17298;ENSG00000183808;RBM12B;8;94741584;94753245;11661;0
17299;ENSG00000183826;BTBD9;6;38136227;38607924;471697;0
17300;ENSG00000183837;PNMA3;X;152224766;152228827;4061;0
17301;ENSG00000183878;UTY;Y;15360259;15592553;232294;0
17302;ENSG00000183943;PRKX;X;3522411;3631649;109238;0
17303;ENSG00000184083;FAM120C;X;54094757;54209714;114957;0
17304;ENSG00000184156;KCNQ3;8;133133108;133493200;360092;1
17305;ENSG00000184194;GPR173;X;53078273;53109797;31524;0
17306;ENSG00000184205;TSPYL2;X;53111549;53117722;6173;0
17307;ENSG00000184216;IRAK1;X;153275951;153285431;9480;0
17308;ENSG00000184343;SRPK3;X;153041867;153051187;9320;0
17309;ENSG00000184347;SLIT3;5;168088745;168728133;639388;0
17310;ENSG00000184348;HIST1H2AK;6;27805658;27806117;459;1
17311;ENSG00000184349;EFNA5;5;106712590;107006596;294006;0
17312;ENSG00000184368;MAP7D2;X;20024831;20135035;110204;0
17313;ENSG00000184388;PABPC1L2B;X;72223352;72225551;2199;0
17314;ENSG00000184408;KCND2;7;119913722;120390385;476663;0
17315;ENSG00000184428;TOP1MT;8;144386554;144442149;55595;0
17316;ENSG00000184465;WDR27;6;169857307;170102159;244852;0
17317;ENSG00000184481;FOXO4;X;70316047;70323385;7338;0
17318;ENSG00000184486;POU3F2;6;99282580;99286660;4080;0
17319;ENSG00000184489;PTP4A3;8;142402093;142441620;39527;0
17320;ENSG00000184515;BEX5;X;101408680;101411029;2349;0
17321;ENSG00000184530;C6orf58;6;127840600;127912962;72362;0
17322;ENSG00000184584;TMEM173;5;138855119;138862520;7401;0
17323;ENSG00000184634;MED12;X;70338406;70362303;23897;0
17324;ENSG00000184647;PRSS55;8;10383056;10411676;28620;0
17325;ENSG00000184661;CDCA2;8;25316513;25365436;48923;0
17326;ENSG00000184672;RALYL;8;85095022;85834079;739057;0
17327;ENSG00000184675;AMER1;X;63404997;63425624;20627;0
17328;ENSG00000184786;TCTE3;6;170140210;170151655;11445;0
17329;ENSG00000184788;SATL1;X;84347293;84364054;16761;0
17330;ENSG00000184831;APOO;X;23851470;23926057;74587;0
17331;ENSG00000184838;PRR16;5;119799973;120023027;223054;0
17332;ENSG00000184840;TMED9;5;177019159;177023125;3966;0
17333;ENSG00000184863;RBM33;7;155437145;155574179;137034;0
17334;ENSG00000184867;ARMCX2;X;100910267;100914876;4609;0
17335;ENSG00000184903;IMMP2L;7;110303110;111202573;899463;0
17336;ENSG00000184905;TCEAL2;X;101380660;101382683;2023;0
17337;ENSG00000184925;LCN12;9;139844003;139849949;5946;0
17338;ENSG00000185000;DGAT1;8;145539954;145550573;10619;0
17339;ENSG00000185010;F8;X;154064063;154255215;191152;0
17340;ENSG00000185015;CA13;8;86132816;86196302;63486;0
17341;ENSG00000185020;;9;40293025;40339528;46503;0
17342;ENSG00000185053;SGCZ;8;13947373;15095848;1148475;0
17343;ENSG00000185055;EFCAB10;7;105205567;105241322;35755;0
17344;ENSG00000185122;HSF1;8;145515280;145538385;23105;0
17345;ENSG00000185127;C6orf120;6;170102233;170106401;4168;0
17346;ENSG00000185129;PURA;5;139487362;139496321;8959;0
17347;ENSG00000185189;NRBP2;8;144915764;144924200;8436;0
17348;ENSG00000185222;WBP5;X;102611373;102613397;2024;0
17349;ENSG00000185250;PPIL6;6;109711418;109762374;50956;0
17350;ENSG00000185261;KIAA0825;5;93488671;93954309;465638;0
17351;ENSG00000185274;WBSCR17;7;70597155;71178585;581430;0
17352;ENSG00000185275;CD24P4;Y;21154353;21154595;242;0
17353;ENSG00000185345;PARK2;6;161768452;163148803;1380351;0
17354;ENSG00000185515;BRCC3;X;154299695;154351349;51654;0
17355;ENSG00000185554;NXF2;X;101470280;101581634;111354;0
17356;ENSG00000185585;OLFML2A;9;127539437;127577164;37727;0
17357;ENSG00000185641;;5;115387607;115387986;379;0
17358;ENSG00000185681;MORN5;9;124922190;124962367;40177;0
17359;ENSG00000185697;MYBL1;8;67474410;67526482;52072;0
17360;ENSG00000185728;YTHDF3;8;64081112;64125346;44234;0
17361;ENSG00000185730;ZNF696;8;144371846;144380231;8385;0
17362;ENSG00000185753;CXorf38;X;40488285;40506819;18534;0
17363;ENSG00000185760;KCNQ5;6;73331520;73908574;577054;1
17364;ENSG00000185803;SLC52A2;8;145577795;145584932;7137;0
17365;ENSG00000185811;IKZF1;7;50343720;50472799;129079;0
17366;ENSG00000185825;BCAP31;X;152965947;152990152;24205;0
17367;ENSG00000185900;POMK;8;42948658;42978577;29919;0
17368;ENSG00000185920;PTCH1;9;98205262;98279339;74077;0
17369;ENSG00000185942;NKAIN3;8;63161150;63912211;751061;0
17370;ENSG00000185963;BICD2;9;95473645;95527094;53449;0
17371;ENSG00000185973;TMLHE;X;154719776;154899605;179829;0
17372;ENSG00000185985;SLITRK2;X;144899350;144907360;8010;0
17373;ENSG00000186051;TAL2;9;108424738;108425367;629;0
17374;ENSG00000186088;GSAP;7;76940068;77045717;105649;0
17375;ENSG00000186106;ANKRD46;8;101521980;101572012;50032;0
17376;ENSG00000186130;ZBTB6;9;125670335;125675609;5274;0
17377;ENSG00000186193;SAPCD2;9;139956581;139965040;8459;0
17378;ENSG00000186231;KLHL32;6;97372605;97588630;216025;0
17379;ENSG00000186288;PABPC1L2A;X;72297115;72299351;2236;0
17380;ENSG00000186310;NAP1L3;X;92925929;92928567;2638;0
17381;ENSG00000186312;CA5BP1;X;15693055;15721847;28792;0
17382;ENSG00000186314;PRELID2;5;144851362;145214932;363570;0
17383;ENSG00000186340;THBS2;6;169615875;169654139;38264;1
17384;ENSG00000186350;RXRA;9;137208944;137332431;123487;0
17385;ENSG00000186354;C9orf47;9;91605778;91611055;5277;0
17386;ENSG00000186367;KIAA1024L;5;129083772;129102425;18653;0
17387;ENSG00000186376;ZNF75D;X;134382867;134478012;95145;0
17388;ENSG00000186416;NKRF;X;118722300;118739858;17558;0
17389;ENSG00000186439;TRDN;6;123537483;123958238;420755;1
17390;ENSG00000186462;NAP1L2;X;72432135;72434684;2549;0
17391;ENSG00000186466;AQP7P1;9;67272038;67289492;17454;0
17392;ENSG00000186468;RPS23;5;81569177;81574396;5219;0
17393;ENSG00000186470;BTN3A2;6;26365387;26378546;13159;0
17394;ENSG00000186471;AKAP14;X;119029800;119054679;24879;0
17395;ENSG00000186472;PCLO;7;82383329;82792246;408917;0
17396;ENSG00000186480;INSIG1;7;155089486;155101945;12459;0
17397;ENSG00000186523;FAM86B1;8;12039605;12051642;12037;0
17398;ENSG00000186530;XKR5;8;6666038;6693166;27128;0
17399;ENSG00000186577;C6orf1;6;34214157;34217247;3090;0
17400;ENSG00000186591;UBE2H;7;129470572;129592789;122217;0
17401;ENSG00000186625;KATNA1;6;149916009;149970108;54099;0
17402;ENSG00000186638;KIF24;9;34252379;34329198;76819;1
17403;ENSG00000186675;MAGEE2;X;75002823;75005079;2256;0
17404;ENSG00000186687;LYRM7;5;130506503;130541119;34616;0
17405;ENSG00000186704;DTX2P1;7;76607934;76673092;65158;0
17406;ENSG00000186767;SPIN4;X;62567107;62571223;4116;0
17407;ENSG00000186787;SPIN2B;X;57144984;57147980;2996;0
17408;ENSG00000186871;ERCC6L;X;71424510;71458897;34387;1
17409;ENSG00000186918;ZNF395;8;28203102;28260218;57116;0
17410;ENSG00000186952;TMEM232;5;109624934;110074657;449723;0
17411;ENSG00000187024;PTRH1;9;130455257;130487152;31895;0
17412;ENSG00000187060;;9;45562979;45563576;597;0
17413;ENSG00000187186;;9;34664160;34666109;1949;0
17414;ENSG00000187189;TSPYL4;6;116571151;116575261;4110;0
17415;ENSG00000187210;GCNT1;9;79034752;79122332;87580;0
17416;ENSG00000187239;FNBP1;9;132649466;132805473;156007;0
17417;ENSG00000187243;MAGED4B;X;51804923;51812368;7445;0
17418;ENSG00000187257;RSBN1L;7;77325760;77412339;86579;0
17419;ENSG00000187260;WDR86;7;151072995;151107813;34818;0
17420;ENSG00000187325;TAF9B;X;77385245;77395203;9958;0
17421;ENSG00000187372;PCDHB13;5;140593509;140596993;3484;0
17422;ENSG00000187391;MAGI2;7;77646393;79082890;1436497;0
17423;ENSG00000187416;LHFPL3;7;103969104;104549001;579897;0
17424;ENSG00000187546;AGMO;7;15239943;15601640;361697;0
17425;ENSG00000187559;FOXD4L3;9;70917276;70920000;2724;0
17426;ENSG00000187566;NHLRC1;6;18120718;18122851;2133;0
17427;ENSG00000187601;MAGEH1;X;55478538;55479998;1460;0
17428;ENSG00000187609;EXD3;9;140201348;140317714;116366;0
17429;ENSG00000187626;ZKSCAN4;6;28212401;28227011;14610;0
17430;ENSG00000187678;SPRY4;5;141689992;141706020;16028;0
17431;ENSG00000187682;ERAS;X;48687283;48688548;1265;0
17432;ENSG00000187690;CXorf67;X;51149767;51151687;1920;0
17433;ENSG00000187713;TMEM203;9;140098534;140100090;1556;0
17434;ENSG00000187735;TCEA1;8;54879112;54935089;55977;0
17435;ENSG00000187742;SECISBP2;9;91933421;91974557;41136;0
17436;ENSG00000187753;C9orf153;9;88835180;88874572;39392;0
17437;ENSG00000187764;SEMA4D;9;91975702;92113045;137343;0
17438;ENSG00000187772;LIN28B;6;105404923;105531207;126284;0
17439;ENSG00000187796;CARD9;9;139256355;139268133;11778;0
17440;ENSG00000187837;HIST1H1C;6;26055968;26056699;731;0
17441;ENSG00000187840;EIF4EBP1;8;37887859;37917883;30024;0
17442;ENSG00000187866;FAM122A;9;71394964;71398609;3645;0
17443;ENSG00000187871;GFRAL;6;55192267;55267291;75024;1
17444;ENSG00000187953;PMS2CL;7;6749759;6793493;43734;0
17445;ENSG00000187954;CYHR1;8;145674965;145691060;16095;0
17446;ENSG00000187955;COL14A1;8;121072019;121384275;312256;0
17447;ENSG00000187984;ANKRD19P;9;95571670;95650975;79305;0
17448;ENSG00000187987;ZSCAN23;6;28399707;28411279;11572;0
17449;ENSG00000187990;HIST1H2BG;6;26216428;26216872;444;0
17450;ENSG00000188021;UBQLN2;X;56590026;56593443;3417;0
17451;ENSG00000188107;EYS;6;64429876;66417118;1987242;0
17452;ENSG00000188133;TMEM215;9;32783497;32787397;3900;0
17453;ENSG00000188153;COL4A5;X;107683074;107940775;257701;0
17454;ENSG00000188158;NHS;X;17393543;17754114;360571;0
17455;ENSG00000188185;LINC00265;7;39773231;39832691;59460;0
17456;ENSG00000188186;LAMTOR4;7;99746530;99753567;7037;0
17457;ENSG00000188191;PRKAR1B;7;588834;767287;178453;0
17458;ENSG00000188229;TUBB4B;9;140135665;140138159;2494;0
17459;ENSG00000188312;CENPP;9;95087766;95382815;295049;0
17460;ENSG00000188343;FAM92A1;8;94710789;94743755;32966;0
17461;ENSG00000188352;FOCAD;9;20658308;20995954;337646;0
17462;ENSG00000188386;PPP3R2;9;104353897;104357283;3386;0
17463;ENSG00000188394;GPR21;9;125796806;125797975;1169;0
17464;ENSG00000188419;CHM;X;85116185;85302566;186381;0
17465;ENSG00000188428;BLOC1S5;6;8013800;8064647;50847;0
17466;ENSG00000188483;IER5L;9;131937835;131940540;2705;0
17467;ENSG00000188523;C9orf171;9;135285430;135448704;163274;0
17468;ENSG00000188566;NDOR1;9;140100147;140111461;11314;0
17469;ENSG00000188573;FBLL1;5;167956121;167957639;1518;0
17470;ENSG00000188580;NKAIN2;6;124125286;125146803;1021517;0
17471;ENSG00000188647;PTAR1;9;72324438;72374875;50437;0
17472;ENSG00000188693;;7;91763918;91810039;46121;0
17473;ENSG00000188706;ZDHHC9;X;128937264;128977885;40621;0
17474;ENSG00000188707;ZBED6CL;7;150026938;150029808;2870;0
17475;ENSG00000188730;VWC2;7;49813257;49961546;148289;0
17476;ENSG00000188732;FAM221A;7;23719749;23742868;23119;1
17477;ENSG00000188747;NOXA1;9;140317802;140328858;11056;0
17478;ENSG00000188763;FZD9;7;72848109;72850450;2341;0
17479;ENSG00000188801;ZNF322P1;9;99959537;99961910;2373;0
17480;ENSG00000188820;FAM26F;6;116782533;116784934;2401;0
17481;ENSG00000188856;RPSAP47;8;81471105;81471992;887;0
17482;ENSG00000188917;TRMT2B;X;100264335;100307105;42770;0
17483;ENSG00000188938;FAM120AOS;9;96208776;96215874;7098;0
17484;ENSG00000188986;NELFB;9;140149625;140167998;18373;0
17485;ENSG00000188994;ZNF292;6;87862551;87973914;111363;0
17486;ENSG00000189007;ADAT2;6;143743969;143771810;27841;0
17487;ENSG00000189011;;7;74702428;74714647;12219;0
17488;ENSG00000189043;NDUFA4;7;10971578;10979883;8305;0
17489;ENSG00000189045;ANKDD1B;5;74907284;74967671;60387;0
17490;ENSG00000189056;RELN;7;103112231;103629963;517732;0
17491;ENSG00000189077;TMEM120A;7;75616155;75623977;7822;0
17492;ENSG00000189108;IL1RAPL2;X;103810996;105011822;1200826;1
17493;ENSG00000189127;ANKRD34B;5;79852574;79866307;13733;0
17494;ENSG00000189212;DPY19L2P1;7;35119601;35225934;106333;0
17495;ENSG00000189221;MAOA;X;43515467;43606068;90601;0
17496;ENSG00000189241;TSPYL1;6;116597741;116601066;3325;0
17497;ENSG00000189298;ZKSCAN3;6;28317691;28336947;19256;0
17498;ENSG00000189367;KIAA0408;6;127761488;127780536;19048;0
17499;ENSG00000189369;GSPT2;X;51486481;51489324;2843;0
17500;ENSG00000189376;C8orf76;8;124232196;124253638;21442;0
17501;ENSG00000196116;TDRD7;9;100174232;100258407;84175;0
17502;ENSG00000196150;ZNF250;8;146076632;146127553;50921;0
17503;ENSG00000196152;ZNF79;9;130186661;130207651;20990;0
17504;ENSG00000196204;RNF216P1;7;5013619;5080306;66687;0
17505;ENSG00000196205;EEF1A1P5;9;135894816;135896553;1737;0
17506;ENSG00000196230;TUBB;6;30687978;30693203;5225;0
17507;ENSG00000196247;ZNF107;7;64126511;64171404;44893;0
17508;ENSG00000196262;PPIA;7;44836279;44864163;27884;0
17509;ENSG00000196275;GTF2IRD2;7;74210483;74267847;57364;0
17510;ENSG00000196284;SUPT3H;6;44777054;45345690;568636;1
17511;ENSG00000196295;;7;30555925;30634425;78500;0
17512;ENSG00000196305;IARS;9;94972489;95056038;83549;0
17513;ENSG00000196312;HIATL2;9;99660348;99775862;115514;0
17514;ENSG00000196313;POM121;7;72349936;72421979;72043;0
17515;ENSG00000196335;STK31;7;23749786;23872132;122346;0
17516;ENSG00000196338;NLGN3;X;70364681;70391051;26370;0
17517;ENSG00000196358;NTNG2;9;135037334;135119921;82587;0
17518;ENSG00000196363;WDR5;9;137000487;137025093;24606;0
17519;ENSG00000196366;C9orf163;9;139377947;139380518;2571;0
17520;ENSG00000196367;TRRAP;7;98475556;98610866;135310;0
17521;ENSG00000196368;NUDT11;X;51232863;51239448;6585;0
17522;ENSG00000196376;SLC35F1;6;118228689;118638839;410150;0
17523;ENSG00000196378;ZNF34;8;145998499;146012730;14231;0
17524;ENSG00000196409;ZNF658;9;40760700;40836415;75715;0
17525;ENSG00000196411;EPHB4;7;100400187;100425121;24934;0
17526;ENSG00000196422;PPP1R26;9;138370925;138380739;9814;0
17527;ENSG00000196433;ASMT;X;1733894;1761974;28080;0
17528;ENSG00000196440;ARMCX4;X;100673275;100788446;115171;0
17529;ENSG00000196453;ZNF777;7;149128454;149158214;29760;0
17530;ENSG00000196456;ZNF775;7;150065879;150109558;43679;0
17531;ENSG00000196459;TRAPPC2;X;13730363;13752754;22391;0
17532;ENSG00000196507;TCEAL3;X;102862379;102884618;22239;0
17533;ENSG00000196511;TPK1;7;144149034;144533488;384454;0
17534;ENSG00000196569;LAMA2;6;129204342;129837714;633372;0
17535;ENSG00000196584;XRCC2;7;152341864;152373250;31386;0
17536;ENSG00000196586;MYO6;6;76458909;76629254;170345;0
17537;ENSG00000196591;HDAC2;6;114254192;114332472;78280;0
17538;ENSG00000196597;ZNF782;9;99578754;99637905;59151;0
17539;ENSG00000196632;WNK3;X;54219256;54385075;165819;0
17540;ENSG00000196636;ACN9;7;96745902;96811075;65173;0
17541;ENSG00000196642;RABL6;9;139702374;139735639;33265;0
17542;ENSG00000196652;ZKSCAN5;7;99102274;99132323;30049;0
17543;ENSG00000196670;ZFP62;5;180274611;180288286;13675;0
17544;ENSG00000196683;TOMM7;7;22852251;22862470;10219;0
17545;ENSG00000196715;VKORC1L1;7;65338254;65424550;86296;0
17546;ENSG00000196730;DAPK1;9;90112143;90323548;211405;0
17547;ENSG00000196739;COL27A1;9;116917840;117074791;156951;0
17548;ENSG00000196741;CXorf24;X;47342970;47344207;1237;0
17549;ENSG00000196743;GM2A;5;150591711;150650001;58290;0
17550;ENSG00000196767;POU3F4;X;82763269;82764775;1506;0
17551;ENSG00000196774;ANKRD20A1;9;67926761;67969840;43079;0
17552;ENSG00000196781;TLE1;9;84198598;84304220;105622;0
17553;ENSG00000196787;HIST1H2AG;6;27100832;27103070;2238;0
17554;ENSG00000196812;ZSCAN16;6;28092338;28097860;5522;0
17555;ENSG00000196814;MVB12B;9;129089128;129269320;180192;0
17556;ENSG00000196821;C6orf106;6;34555065;34664636;109571;0
17557;ENSG00000196873;CBWD3;9;70856397;70914929;58532;0
17558;ENSG00000196911;KPNA5;6;117002350;117063029;60679;0
17559;ENSG00000196922;ZNF252P;8;146198975;146228281;29306;0
17560;ENSG00000196923;PDLIM7;5;176910395;176924607;14212;0
17561;ENSG00000196924;FLNA;X;153576892;153603006;26114;0
17562;ENSG00000196937;FAM3C;7;120988905;121036418;47513;0
17563;ENSG00000196963;PCDHB16;5;140560980;140565793;4813;0
17564;ENSG00000196966;HIST1H3E;6;26225383;26225844;461;0
17565;ENSG00000196972;LINC00087;X;134229058;134232664;3606;0
17566;ENSG00000196976;LAGE3;X;153706028;153707596;1568;0
17567;ENSG00000196998;WDR45;X;48929385;48958108;28723;0
17568;ENSG00000197008;ZNF138;7;64254766;64294054;39288;0
17569;ENSG00000197021;CXorf40B;X;149097745;149107029;9284;0
17570;ENSG00000197024;ZNF398;7;148823508;148880116;56608;0
17571;ENSG00000197037;ZSCAN25;7;99214569;99230030;15461;0
17572;ENSG00000197043;ANXA6;5;150480273;150537443;57170;0
17573;ENSG00000197061;HIST1H4C;6;26104104;26104518;414;0
17574;ENSG00000197062;;6;28234788;28245974;11186;0
17575;ENSG00000197070;ARRDC1;9;140500106;140509812;9706;0
17576;ENSG00000197081;IGF2R;6;160390131;160534539;144408;0
17577;ENSG00000197083;ZNF300P1;5;150310207;150325851;15644;0
17578;ENSG00000197093;GAL3ST4;7;99756867;99766373;9506;0
17579;ENSG00000197140;ADAM32;8;38964509;39142430;177921;1
17580;ENSG00000197146;;6;167357853;167360151;2298;1
17581;ENSG00000197150;ABCB8;7;150725510;150744869;19359;0
17582;ENSG00000197157;SND1;7;127292234;127732661;440427;0
17583;ENSG00000197180;;X;153656537;153656795;258;0
17584;ENSG00000197181;PIWIL2;8;22132810;22215076;82266;1
17585;ENSG00000197191;C9orf169;9;140119087;140120763;1676;0
17586;ENSG00000197208;SLC22A4;5;131630136;131679899;49763;0
17587;ENSG00000197217;ENTPD4;8;23243296;23315208;71912;0
17588;ENSG00000197226;TBC1D9B;5;179289066;179334859;45793;0
17589;ENSG00000197258;EIF4BP6;7;104308196;104310023;1827;0
17590;ENSG00000197265;GTF2E2;8;30435835;30515768;79933;0
17591;ENSG00000197275;RAD54B;8;95384188;95487337;103149;0
17592;ENSG00000197279;ZNF165;6;28048753;28057341;8588;0
17593;ENSG00000197283;SYNGAP1;6;33387847;33421466;33619;0
17594;ENSG00000197343;ZNF655;7;99156029;99174076;18047;0
17595;ENSG00000197355;UAP1L1;9;139971953;139978991;7038;0
17596;ENSG00000197362;ZNF786;7;148766735;148787874;21139;0
17597;ENSG00000197363;ZNF517;8;146024261;146036554;12293;0
17598;ENSG00000197375;SLC22A5;5;131705444;131731306;25862;0
17599;ENSG00000197442;MAP3K5;6;136878185;137113656;235471;0
17600;ENSG00000197448;GSTK1;7;142941186;142967947;26761;0
17601;ENSG00000197451;HNRNPAB;5;177631508;177638164;6656;0
17602;ENSG00000197459;HIST1H2BH;6;26251879;26252303;424;0
17603;ENSG00000197461;PDGFA;7;536895;559933;23038;0
17604;ENSG00000197479;PCDHB11;5;140579183;140582618;3435;0
17605;ENSG00000197498;RPF2;6;111303218;111349466;46248;0
17606;ENSG00000197536;C5orf56;5;131746328;131811736;65408;0
17607;ENSG00000197550;;9;69830288;69848759;18471;0
17608;ENSG00000197558;SSPO;7;149473131;149531068;57937;0
17609;ENSG00000197565;COL4A6;X;107386780;107682727;295947;1
17610;ENSG00000197579;TOPORS;9;32540542;32552551;12009;0
17611;ENSG00000197594;ENPP1;6;132129156;132216295;87139;0
17612;ENSG00000197620;CXorf40A;X;148621900;148632055;10155;0
17613;ENSG00000197694;SPTAN1;9;131314866;131395941;81075;0
17614;ENSG00000197724;PHF2;9;96338689;96441869;103180;0
17615;ENSG00000197744;PTMAP2;5;118309491;118309817;326;0
17616;ENSG00000197753;LHFPL5;6;35773070;35801651;28581;0
17617;ENSG00000197779;ZNF81;X;47696301;47861960;165659;0
17618;ENSG00000197816;CCDC180;9;100000765;100140806;140041;0
17619;ENSG00000197846;HIST1H2BF;6;26199748;26200942;1194;1
17620;ENSG00000197858;GPAA1;8;145137493;145141119;3626;0
17621;ENSG00000197892;KIF13B;8;28924796;29120641;195845;0
17622;ENSG00000197903;HIST1H2BK;6;27106073;27114619;8546;1
17623;ENSG00000197914;HIST1H4K;6;27798952;27799305;353;0
17624;ENSG00000197932;F8A1;X;154114635;154116335;1700;0
17625;ENSG00000197935;ZNF311;6;28962562;28973093;10531;0
17626;ENSG00000197948;FCHSD1;5;141018869;141030986;12117;0
17627;ENSG00000197958;RPL12;9;130209953;130213684;3731;0
17628;ENSG00000197969;VPS13A;9;79792269;80036457;244188;0
17629;ENSG00000197976;AKAP17A;X;1710486;1721407;10921;0
17630;ENSG00000197977;ELOVL2;6;10980992;11044547;63555;0
17631;ENSG00000197993;KEL;7;142638201;142659768;21567;0
17632;ENSG00000198000;NOL8;9;95059640;95087918;28278;0
17633;ENSG00000198010;DLGAP2;8;1449532;1656642;207110;0
17634;ENSG00000198034;RPS4X;X;71475529;71497150;21621;0
17635;ENSG00000198039;ZNF273;7;64330550;64391344;60794;0
17636;ENSG00000198042;MAK16;8;33342268;33358778;16510;0
17637;ENSG00000198055;GRK6;5;176830205;176869902;39697;0
17638;ENSG00000198087;CD2AP;6;47445525;47594999;149474;0
17639;ENSG00000198088;NUP62CL;X;106366657;106449670;83013;0
17640;ENSG00000198108;CHSY3;5;129240165;129522327;282162;0
17641;ENSG00000198113;TOR4A;9;140172201;140177093;4892;0
17642;ENSG00000198121;LPAR1;9;113635543;113800981;165438;0
17643;ENSG00000198157;HMGN5;X;80369200;80457441;88241;0
17644;ENSG00000198169;ZNF251;8;145946298;145981802;35504;0
17645;ENSG00000198205;ZXDA;X;57931864;57937067;5203;0
17646;ENSG00000198221;MLLT4-AS1;6;168224556;168227389;2833;0
17647;ENSG00000198225;FKBP1C;6;63921351;63922929;1578;0
17648;ENSG00000198312;BMS1P9;9;66960613;66964189;3576;0
17649;ENSG00000198315;ZKSCAN8;6;28109688;28127250;17562;0
17650;ENSG00000198339;HIST1H4I;6;27107076;27108418;1342;0
17651;ENSG00000198354;DCAF12L2;X;125298337;125300080;1743;0
17652;ENSG00000198363;ASPH;8;62413116;62627155;214039;0
17653;ENSG00000198416;;9;39443804;39464526;20722;0
17654;ENSG00000198420;FAM115A;7;143548468;143599291;50823;0
17655;ENSG00000198435;NRARP;9;140194083;140196703;2620;0
17656;ENSG00000198455;ZXDB;X;57618269;57623906;5637;0
17657;ENSG00000198467;TPM2;9;35681989;35691017;9028;1
17658;ENSG00000198478;SH3BGRL2;6;80341000;80413372;72372;0
17659;ENSG00000198517;MAFK;7;1570350;1582679;12329;0
17660;ENSG00000198518;HIST1H4E;6;26204858;26206266;1408;0
17661;ENSG00000198556;ZNF789;7;99070464;99101273;30809;1
17662;ENSG00000198563;DDX39B;6;31497996;31510225;12229;0
17663;ENSG00000198576;ARC;8;143692405;143696833;4428;0
17664;ENSG00000198580;;7;6713376;6715991;2615;0
17665;ENSG00000198624;CCDC69;5;150560613;150603706;43093;0
17666;ENSG00000198642;KLHL9;9;21329670;21335379;5709;0
17667;ENSG00000198663;C6orf89;6;36839646;36896740;57094;0
17668;ENSG00000198670;LPA;6;160952515;161087407;134892;0
17669;ENSG00000198677;TTC37;5;94799599;94890711;91112;0
17670;ENSG00000198680;TUSC1;9;25676396;25678856;2460;0
17671;ENSG00000198689;SLC9A6;X;135067598;135129423;61825;0
17672;ENSG00000198692;EIF1AY;Y;22737611;22755040;17429;0
17673;ENSG00000198695;MT-ND6;MT;14149;14673;524;0
17674;ENSG00000198712;MT-CO2;MT;7586;8269;683;0
17675;ENSG00000198719;DLL1;6;170591294;170599561;8267;0
17676;ENSG00000198721;ECI2;6;4115923;4135831;19908;0
17677;ENSG00000198722;UNC13B;9;35161999;35405335;243336;0
17678;ENSG00000198727;MT-CYB;MT;14747;15887;1140;0
17679;ENSG00000198729;PPP1R14C;6;150464212;150571493;107281;0
17680;ENSG00000198742;SMURF1;7;98625061;98741723;116662;0
17681;ENSG00000198750;GATSL2;7;74807499;74867509;60010;0
17682;ENSG00000198753;PLXNB3;X;153029651;153044801;15150;0
17683;ENSG00000198755;RPL10A;6;35436185;35438562;2377;0
17684;ENSG00000198759;EGFL6;X;13587724;13651694;63970;0
17685;ENSG00000198763;MT-ND2;MT;4470;5511;1041;0
17686;ENSG00000198785;GRIN3A;9;104331635;104500862;169227;1
17687;ENSG00000198786;MT-ND5;MT;12337;14148;1811;0
17688;ENSG00000198791;CNOT7;8;17086737;17104387;17650;0
17689;ENSG00000198804;MT-CO1;MT;5904;7445;1541;0
17690;ENSG00000198814;GK;X;30671476;30748725;77249;0
17691;ENSG00000198818;SFT2D1;6;166733216;166756079;22863;0
17692;ENSG00000198822;GRM3;7;86273230;86494200;220970;1
17693;ENSG00000198833;UBE2J1;6;90036344;90062567;26223;0
17694;ENSG00000198839;ZNF277;7;111846643;111983151;136508;0
17695;ENSG00000198840;MT-ND3;MT;10059;10404;345;0
17696;ENSG00000198846;TOX;8;59717977;60031767;313790;0
17697;ENSG00000198853;RUSC2;9;35490124;35561895;71771;0
17698;ENSG00000198870;C9orf96;9;136243117;136271220;28103;0
17699;ENSG00000198874;TYW1;7;66460160;66704501;244341;0
17700;ENSG00000198876;DCAF12;9;34086385;34127397;41012;0
17701;ENSG00000198883;PNMA5;X;152157368;152162671;5303;0
17702;ENSG00000198886;MT-ND4;MT;10760;12137;1377;0
17703;ENSG00000198887;SMC5;9;72873937;72969804;95867;0
17704;ENSG00000198888;MT-ND1;MT;3307;4262;955;0
17705;ENSG00000198889;DCAF12L1;X;125683369;125686834;3465;0
17706;ENSG00000198898;CAPZA2;7;116451124;116562103;110979;0
17707;ENSG00000198899;MT-ATP6;MT;8527;9207;680;0
17708;ENSG00000198908;BHLHB9;X;101975616;102008468;32852;0
17709;ENSG00000198910;L1CAM;X;153126969;153174677;47708;0
17710;ENSG00000198917;C9orf114;9;131581930;131592100;10170;0
17711;ENSG00000198918;RPL39;X;118920467;118925606;5139;0
17712;ENSG00000198932;GPRASP1;X;101906294;101914011;7717;0
17713;ENSG00000198934;MAGEE1;X;75648046;75651744;3698;0
17714;ENSG00000198937;CCDC167;6;37450696;37467698;17002;0
17715;ENSG00000198938;MT-CO3;MT;9207;9990;783;0
17716;ENSG00000198939;ZFP2;5;178322895;178360213;37318;0
17717;ENSG00000198944;SOWAHA;5;132149033;132152488;3455;0
17718;ENSG00000198945;L3MBTL3;6;130334844;130462594;127750;0
17719;ENSG00000198947;DMD;X;31115794;33357558;2241764;0
17720;ENSG00000198960;ARMCX6;X;100870110;100872991;2881;0
17721;ENSG00000198961;PJA2;5;108670410;108745695;75285;0
17722;ENSG00000198963;RORB;9;77112281;77308093;195812;0
17723;ENSG00000199036;MIR219-1;6;33175612;33175721;109;0
17724;ENSG00000199133;MIRLET7D;9;96941116;96941202;86;0
17725;ENSG00000200534;SNORA33;6;133138358;133138487;129;0
17726;ENSG00000200769;;7;91831557;91831648;91;0
17727;ENSG00000201432;;7;36377276;36377387;111;0
17728;ENSG00000201451;;9;136204565;136204661;96;0
17729;ENSG00000201772;SNORA5C;7;45144505;45144641;136;0
17730;ENSG00000202198;RN7SK;6;52860418;52860748;330;0
17731;ENSG00000202279;;X;135898636;135898733;97;0
17732;ENSG00000202343;;6;149915761;149915895;134;0
17733;ENSG00000202566;MIR421;X;73438212;73438296;84;0
17734;ENSG00000203499;FAM83H-AS1;8;144816310;144828507;12197;0
17735;ENSG00000203659;;9;32553187;32553801;614;0
17736;ENSG00000203688;;6;168080306;168084467;4161;0
17737;ENSG00000203727;SAMD5;6;147830063;148058683;228620;1
17738;ENSG00000203760;CENPW;6;126661320;126670021;8701;0
17739;ENSG00000203778;FAM229B;6;112408802;112423993;15191;0
17740;ENSG00000203799;CCDC162P;6;109612231;109676266;64035;1
17741;ENSG00000203808;BVES-AS1;6;105584183;105617820;33637;0
17742;ENSG00000203809;LINC00577;6;105384169;105388402;4233;0
17743;ENSG00000203813;HIST1H3H;6;27777842;27778314;472;0
17744;ENSG00000203863;;6;89674246;89676685;2439;0
17745;ENSG00000203871;C6orf164;6;88106840;88109467;2627;1
17746;ENSG00000203872;C6orf163;6;88054567;88075181;20614;0
17747;ENSG00000203875;SNHG5;6;86370710;86388451;17741;0
17748;ENSG00000203877;RIPPLY2;6;84562985;84567234;4249;0
17749;ENSG00000203879;GDI1;X;153665266;153671814;6548;0
17750;ENSG00000203930;LINC00632;X;139791932;139854844;62912;0
17751;ENSG00000203950;FAM127B;X;134184962;134186226;1264;0
17752;ENSG00000203952;CCDC160;X;133371077;133380237;9160;0
17753;ENSG00000203993;C9orf37;9;140509784;140513358;3574;0
17754;ENSG00000204052;LRRC73;6;43474707;43478424;3717;0
17755;ENSG00000204054;LINC00963;9;132245730;132275947;30217;0
17756;ENSG00000204055;;9;131939050;131972827;33777;0
17757;ENSG00000204065;TCEAL5;X;102528619;102531800;3181;0
17758;ENSG00000204071;TCEAL6;X;101395448;101397942;2494;0
17759;ENSG00000204110;;6;37475124;37503392;28268;1
17760;ENSG00000204116;CHIC1;X;72783036;72906937;123901;0
17761;ENSG00000204131;NHSL2;X;71130938;71363424;232486;0
17762;ENSG00000204173;LRRC37A5P;9;114353872;114393569;39697;0
17763;ENSG00000204209;DAXX;6;33286335;33297046;10711;0
17764;ENSG00000204220;PFDN6;6;33257079;33266178;9099;0
17765;ENSG00000204227;RING1;6;33176272;33180499;4227;0
17766;ENSG00000204228;HSD17B8;6;33172419;33174608;2189;0
17767;ENSG00000204231;RXRB;6;33161365;33168630;7265;0
17768;ENSG00000204248;COL11A2;6;33130458;33160276;29818;0
17769;ENSG00000204256;BRD2;6;32936437;32949282;12845;0
17770;ENSG00000204257;HLA-DMA;6;32916390;32936871;20481;0
17771;ENSG00000204267;TAP2;6;32789610;32806557;16947;0
17772;ENSG00000204271;SPIN3;X;57002803;57021970;19167;0
17773;ENSG00000204272;;X;56755692;56844813;89121;0
17774;ENSG00000204291;COL15A1;9;101705461;101833069;127608;0
17775;ENSG00000204301;NOTCH4;6;32162620;32191844;29224;0
17776;ENSG00000204304;PBX2;6;32152512;32157963;5451;0
17777;ENSG00000204305;AGER;6;32148745;32152101;3356;0
17778;ENSG00000204308;RNF5;6;32146131;32151930;5799;0
17779;ENSG00000204310;AGPAT1;6;32135989;32145873;9884;0
17780;ENSG00000204314;PRRT1;6;32116136;32122150;6014;0
17781;ENSG00000204315;FKBPL;6;32096484;32098068;1584;0
17782;ENSG00000204338;CYP21A1P;6;31973413;31976228;2815;0
17783;ENSG00000204344;STK19;6;31938868;31950598;11730;0
17784;ENSG00000204348;DXO;6;31937587;31940069;2482;0
17785;ENSG00000204351;SKIV2L;6;31926857;31937532;10675;0
17786;ENSG00000204352;C9orf129;9;96080481;96108696;28215;0
17787;ENSG00000204356;NELFE;6;31919864;31926887;7023;0
17788;ENSG00000204366;ZBTB12;6;31867384;31869769;2385;0
17789;ENSG00000204371;EHMT2;6;31847536;31865464;17928;0
17790;ENSG00000204386;NEU1;6;31825436;31830683;5247;0
17791;ENSG00000204387;C6orf48;6;31802385;31807541;5156;0
17792;ENSG00000204388;HSPA1B;6;31795512;31798031;2519;0
17793;ENSG00000204389;HSPA1A;6;31783291;31785723;2432;0
17794;ENSG00000204390;HSPA1L;6;31777396;31783437;6041;0
17795;ENSG00000204392;LSM2;6;31765173;31774761;9588;0
17796;ENSG00000204394;VARS;6;31745295;31763730;18435;0
17797;ENSG00000204396;VWA7;6;31733367;31745108;11741;0
17798;ENSG00000204410;MSH5;6;31707725;31732622;24897;0
17799;ENSG00000204421;LY6G6C;6;31686425;31689622;3197;0
17800;ENSG00000204427;ABHD16A;6;31654726;31671221;16495;0
17801;ENSG00000204428;LY6G5C;6;31644461;31651817;7356;0
17802;ENSG00000204435;CSNK2B;6;31633013;31638120;5107;0
17803;ENSG00000204438;GPANK1;6;31629006;31634060;5054;0
17804;ENSG00000204439;C6orf47;6;31626075;31628549;2474;0
17805;ENSG00000204444;APOM;6;31620193;31625987;5794;0
17806;ENSG00000204463;BAG6;6;31606805;31620482;13677;0
17807;ENSG00000204466;DGKK;X;50108408;50213737;105329;0
17808;ENSG00000204469;PRRC2A;6;31588497;31605548;17051;0
17809;ENSG00000204498;NFKBIL1;6;31514647;31526606;11959;0
17810;ENSG00000204516;MICB;6;31462658;31478901;16243;0
17811;ENSG00000204520;MICA;6;31371356;31383092;11736;0
17812;ENSG00000204525;HLA-C;6;31236526;31239907;3381;0
17813;ENSG00000204536;CCHCR1;6;31110216;31126015;15799;0
17814;ENSG00000204560;DHX16;6;30620896;30640814;19918;0
17815;ENSG00000204564;C6orf136;6;30614816;30620987;6171;0
17816;ENSG00000204568;MRPS18B;6;30585486;30594172;8686;0
17817;ENSG00000204569;PPP1R10;6;30568177;30586389;18212;0
17818;ENSG00000204574;ABCF1;6;30539153;30564956;25803;0
17819;ENSG00000204576;PRR3;6;30524663;30531500;6837;0
17820;ENSG00000204580;DDR1;6;30844198;30867933;23735;0
17821;ENSG00000204590;GNL1;6;30509154;30524951;15797;0
17822;ENSG00000204592;HLA-E;6;30457244;30461982;4738;0
17823;ENSG00000204599;TRIM39;6;30294256;30311506;17250;0
17824;ENSG00000204619;PPP1R11;6;30034486;30038110;3624;0
17825;ENSG00000204623;ZNRD1-AS1;6;29968788;30029417;60629;0
17826;ENSG00000204628;GNB2L1;5;180663909;180675096;11187;0
17827;ENSG00000204681;GABBR1;6;29523406;29601753;78347;0
17828;ENSG00000204706;MAMDC2-AS1;9;72700732;72790804;90072;1
17829;ENSG00000204713;TRIM27;6;28870779;28891766;20987;0
17830;ENSG00000204758;;5;172381789;172386395;4606;0
17831;ENSG00000204764;RANBP17;5;170288874;170727019;438145;0
17832;ENSG00000204767;FAM196B;5;169291268;169407744;116476;0
17833;ENSG00000204778;;9;70181520;70216621;35101;0
17834;ENSG00000204789;ZNF204P;6;27325604;27339304;13700;0
17835;ENSG00000204790;CBWD6;9;69204538;69269662;65124;1
17836;ENSG00000204793;FOXD4L6;9;69199480;69202204;2724;0
17837;ENSG00000204794;PGM5P1;9;68741234;68809906;68672;0
17838;ENSG00000204802;;9;46685429;46688137;2708;0
17839;ENSG00000204805;FAM27E4;9;44997777;44999352;1575;0
17840;ENSG00000204807;FAM27E2;9;45733559;45734896;1337;0
17841;ENSG00000204818;;9;44170447;44175727;5280;0
17842;ENSG00000204837;;9;41961615;42019580;57965;0
17843;ENSG00000204839;MROH6;8;144648357;144655141;6784;0
17844;ENSG00000204860;FAM201A;9;38620471;38624987;4516;1
17845;ENSG00000204909;SPINK9;5;147700766;147719412;18646;0
17846;ENSG00000204934;ATP6V0E2-AS1;7;149564786;149577699;12913;0
17847;ENSG00000204946;ZNF783;7;148959262;148994393;35131;0
17848;ENSG00000204947;ZNF425;7;148799876;148823438;23562;0
17849;ENSG00000204956;PCDHGA1;5;140710252;140892546;182294;1
17850;ENSG00000204961;PCDHA9;5;140227048;140391929;164881;0
17851;ENSG00000204962;PCDHA8;5;140220907;140391929;171022;0
17852;ENSG00000204963;PCDHA7;5;140213969;140391929;177960;0
17853;ENSG00000204965;PCDHA5;5;140201222;140391929;190707;0
17854;ENSG00000204967;PCDHA4;5;140186659;140391929;205270;0
17855;ENSG00000204969;PCDHA2;5;140174444;140391929;217485;0
17856;ENSG00000205002;AARD;8;117950438;117956726;6288;0
17857;ENSG00000205038;PKHD1L1;8;110374706;110542559;167853;0
17858;ENSG00000205060;SLC35B4;7;133974084;134001803;27719;0
17859;ENSG00000205081;CXorf30;X;36246735;36403431;156696;0
17860;ENSG00000205085;FAM71F2;7;128312342;128326929;14587;0
17861;ENSG00000205133;TRIQK;8;93895758;94029901;134143;0
17862;ENSG00000205143;ARID3C;9;34621376;34628104;6728;0
17863;ENSG00000205189;ZBTB10;8;81397854;81438500;40646;0
17864;ENSG00000205268;PDE7A;8;66629745;66754557;124812;0
17865;ENSG00000205269;TMEM170B;6;11537938;11583757;45819;0
17866;ENSG00000205277;MUC12;7;100612904;100662230;49326;0
17867;ENSG00000205279;CTXN3;5;126984736;126994322;9586;0
17868;ENSG00000205302;SNX2;5;122110691;122165803;55112;0
17869;ENSG00000205356;TECPR1;7;97843936;97881563;37627;0
17870;ENSG00000205413;SAMD9;7;92728829;92747336;18507;0
17871;ENSG00000205464;ATP6AP1L;5;81575281;81682796;107515;0
17872;ENSG00000205482;;7;76682095;76688757;6662;0
17873;ENSG00000205485;;7;76178677;76257299;78622;0
17874;ENSG00000205542;TMSB4X;X;12993227;12995346;2119;0
17875;ENSG00000205578;POM121B;7;72707497;72716496;8999;0
17876;ENSG00000205583;STAG3L1;7;74988448;75024657;36209;0
17877;ENSG00000205664;;X;3735569;3761898;26329;0
17878;ENSG00000205763;RP9P;7;32956427;32982788;26361;0
17879;ENSG00000205808;PPAPDC2;9;4662298;4665256;2958;0
17880;ENSG00000205903;ZNF316;7;6676953;6694242;17289;0
17881;ENSG00000206159;GYG2P1;Y;14475147;14532255;57108;0
17882;ENSG00000206228;HNRNPA1P4;8;83203859;83204614;755;0
17883;ENSG00000206344;HCG27;6;31165537;31171745;6208;0
17884;ENSG00000206503;HLA-A;6;29909037;29913661;4624;0
17885;ENSG00000206579;XKR4;8;56014949;56454613;439664;0
17886;ENSG00000206634;SNORA22;7;65220513;65220646;133;0
17887;ENSG00000207067;SNORA72;8;99054314;99054445;131;0
17888;ENSG00000207547;MIR25;7;99691183;99691266;83;0
17889;ENSG00000207597;MIR490;7;136587914;136588041;127;0
17890;ENSG00000207741;MIR590;7;73605528;73605624;96;0
17891;ENSG00000207816;MIR124-2;8;65291706;65291814;108;0
17892;ENSG00000207955;MIR219-2;9;131154291;131155789;1498;0
17893;ENSG00000209082;MT-TL1;MT;3230;3304;74;0
17894;ENSG00000210077;MT-TV;MT;1602;1670;68;0
17895;ENSG00000210082;MT-RNR2;MT;1671;3229;1558;0
17896;ENSG00000210100;MT-TI;MT;4263;4331;68;0
17897;ENSG00000210107;MT-TQ;MT;4329;4400;71;0
17898;ENSG00000210112;MT-TM;MT;4402;4469;67;0
17899;ENSG00000210117;MT-TW;MT;5512;5579;67;0
17900;ENSG00000210127;MT-TA;MT;5587;5655;68;0
17901;ENSG00000210135;MT-TN;MT;5657;5729;72;0
17902;ENSG00000210144;MT-TY;MT;5826;5891;65;0
17903;ENSG00000210151;MT-TS1;MT;7446;7514;68;0
17904;ENSG00000210154;MT-TD;MT;7518;7585;67;0
17905;ENSG00000210194;MT-TE;MT;14674;14742;68;0
17906;ENSG00000210195;MT-TT;MT;15888;15953;65;0
17907;ENSG00000210196;MT-TP;MT;15956;16023;67;0
17908;ENSG00000211445;GPX3;5;150400124;150408554;8430;0
17909;ENSG00000211459;MT-RNR1;MT;648;1601;953;0
17910;ENSG00000212027;MIR374B;X;73438382;73438453;71;0
17911;ENSG00000212747;FAM127C;X;134154543;134156559;2016;0
17912;ENSG00000212802;RPL15P3;6;12514342;12515006;664;0
17913;ENSG00000212864;RNF208;9;140114707;140116033;1326;0
17914;ENSG00000212907;MT-ND4L;MT;10470;10766;296;0
17915;ENSG00000212951;;9;46842616;46844326;1710;0
17916;ENSG00000212993;POU5F1B;8;128426535;128432311;5776;0
17917;ENSG00000213066;FGFR1OP;6;167412670;167466201;53531;0
17918;ENSG00000213071;LPAL2;6;160874460;160932156;57696;0
17919;ENSG00000213073;;6;160514114;160517244;3130;0
17920;ENSG00000213079;SCAF8;6;155054459;155155192;100733;0
17921;ENSG00000213089;PDCL3P5;6;151148799;151149520;721;0
17922;ENSG00000213121;;6;153552455;153668623;116168;0
17923;ENSG00000213131;YWHAZP4;6;127676901;127677934;1033;0
17924;ENSG00000213199;ASIC3;7;150745379;150749843;4464;0
17925;ENSG00000213204;C6orf165;6;88117730;88221352;103622;0
17926;ENSG00000213213;CCDC183;9;139690802;139702193;11391;0
17927;ENSG00000213221;DNLZ;9;139253932;139258241;4309;0
17928;ENSG00000213328;;5;178336711;178337610;899;0
17929;ENSG00000213347;MXD3;5;176728462;176739758;11296;0
17930;ENSG00000213385;;7;102395593;102396386;793;0
17931;ENSG00000213386;;5;172189524;172190261;737;0
17932;ENSG00000213391;;X;152871972;152872343;371;0
17933;ENSG00000213420;GPC2;7;99767229;99774995;7766;0
17934;ENSG00000213433;;5;151145420;151145939;519;0
17935;ENSG00000213462;ERV3-1;7;64451187;64467121;15934;1
17936;ENSG00000213468;;X;130836678;130964671;127993;0
17937;ENSG00000213523;SRA1;5;139916925;139937895;20970;0
17938;ENSG00000213542;;7;76744716;76745509;793;0
17939;ENSG00000213563;C8orf82;8;145751117;145754516;3399;0
17940;ENSG00000213585;VDAC1;5;133307606;133340824;33218;0
17941;ENSG00000213588;ZBTB9;6;33422356;33425325;2969;0
17942;ENSG00000213640;;7;64323377;64324748;1371;1
17943;ENSG00000213654;GPSM3;6;32158543;32163300;4757;0
17944;ENSG00000213676;ATF6B;6;32065953;32096030;30077;0
17945;ENSG00000213694;S1PR3;9;91606362;91619925;13563;0
17946;ENSG00000213706;;X;70572268;70572838;570;0
17947;ENSG00000213719;CLIC1;6;31698358;31707540;9182;0
17948;ENSG00000213722;DDAH2;6;31694815;31698394;3579;0
17949;ENSG00000213754;;X;63524927;63526613;1686;0
17950;ENSG00000213760;ATP6V1G2;6;31512239;31516204;3965;0
17951;ENSG00000213780;GTF2H4;6;30875961;30881883;5922;0
17952;ENSG00000213839;;9;37885680;37886387;707;0
17953;ENSG00000213860;RPL21P75;7;20042346;20042909;563;0
17954;ENSG00000213865;C8orf44;8;67579850;67597799;17949;0
17955;ENSG00000213866;YBX1P10;9;35971341;35972315;974;0
17956;ENSG00000213930;GALT;9;34638130;34651032;12902;0
17957;ENSG00000213997;PGAM1P7;X;46506029;46506765;736;0
17958;ENSG00000214022;REPIN1;7;150065278;150071133;5855;0
17959;ENSG00000214050;FBXO16;8;28205804;28347835;142031;0
17960;ENSG00000214102;WEE2;7;141408153;141431071;22918;0
17961;ENSG00000214110;LDHAP4;9;14921335;14922332;997;0
17962;ENSG00000214113;LYRM4;6;5102827;5261172;158345;0
17963;ENSG00000214194;LINC00998;7;112756773;112758668;1895;0
17964;ENSG00000214239;;6;159047471;159049322;1851;0
17965;ENSG00000214253;FIS1;7;100882739;100895597;12858;0
17966;ENSG00000214293;RSBN1L-AS1;7;77286977;77325582;38605;0
17967;ENSG00000214309;MBLAC1;7;99724317;99726118;1801;0
17968;ENSG00000214338;SOGA3;6;127759551;127840500;80949;0
17969;ENSG00000214357;NEURL1B;5;172068269;172118543;50274;0
17970;ENSG00000214389;RPS3AP26;7;98015113;98015896;783;0
17971;ENSG00000214402;LCNL1;9;139876356;139880862;4506;0
17972;ENSG00000214415;GNAT3;7;80087987;80141336;53349;1
17973;ENSG00000214439;FAM185BP;7;76713203;76751433;38230;0
17974;ENSG00000214485;RPL7P1;5;149473860;149474619;759;0
17975;ENSG00000214597;TMEM249;8;145575878;145578574;2696;0
17976;ENSG00000214654;;9;123555829;123561848;6019;0
17977;ENSG00000214717;ZBED1;X;2404455;2419008;14553;0
17978;ENSG00000214765;SEPT7P2;7;45763379;45808617;45238;0
17979;ENSG00000214783;POLR2J4;7;43980494;44058774;78280;1
17980;ENSG00000214784;;5;110527924;110528740;816;0
17981;ENSG00000214814;FER1L6;8;124864227;125132302;268075;0
17982;ENSG00000214827;MTCP1;X;154289897;154376212;86315;0
17983;ENSG00000214870;;7;26438213;26538594;100381;0
17984;ENSG00000214871;;7;23210760;23234503;23743;0
17985;ENSG00000214954;LRRC69;8;92114060;92231464;117404;0
17986;ENSG00000214960;ISPD;7;16130817;16460947;330130;0
17987;ENSG00000215018;COL28A1;7;7395834;7575484;179650;0
17988;ENSG00000215022;;6;13265093;13295818;30725;1
17989;ENSG00000215045;GRID2IP;7;6537093;6591067;53974;0
17990;ENSG00000215105;TTC3P1;X;74960541;74966749;6208;0
17991;ENSG00000215114;UBXN2B;8;59323823;59364060;40237;0
17992;ENSG00000215126;CBWD7;9;42668608;42714962;46354;0
17993;ENSG00000215142;;9;40491622;40633282;141660;0
17994;ENSG00000215162;LINC00269;X;68399400;68429767;30367;0
17995;ENSG00000215190;LINC00680;6;58272352;58287779;15427;0
17996;ENSG00000215237;;9;14993310;15019727;26417;0
17997;ENSG00000215301;DDX3X;X;41192651;41223725;31074;0
17998;ENSG00000215346;;8;10983980;10987745;3765;0
17999;ENSG00000215374;FAM66B;8;7159133;7212876;53743;0
18000;ENSG00000215548;;9;68427861;68455375;27514;0
18001;ENSG00000215712;TMEM242;6;157710418;157744633;34215;0
18002;ENSG00000216621;;6;150255663;150257918;2255;0
18003;ENSG00000216775;;6;52529946;52533953;4007;0
18004;ENSG00000216809;;6;118773632;118776155;2523;0
18005;ENSG00000216819;TUBB2BP1;6;3177278;3179998;2720;0
18006;ENSG00000216895;;7;155403925;155437899;33974;0
18007;ENSG00000216901;;6;28143966;28144452;486;0
18008;ENSG00000216906;;6;150225379;150227554;2175;0
18009;ENSG00000216990;HSPD1P10;6;88008490;88010165;1675;0
18010;ENSG00000217128;FNIP1;5;130977407;131132710;155303;0
18011;ENSG00000217241;CBX3P9;6;116774177;116774728;551;0
18012;ENSG00000217275;;6;26202384;26202882;498;0
18013;ENSG00000217648;;6;143663383;143664520;1137;0
18014;ENSG00000218418;;6;80774003;80779916;5913;0
18015;ENSG00000218426;;6;153603422;153603868;446;0
18016;ENSG00000218536;;6;102526747;102527430;683;0
18017;ENSG00000218672;;7;155174771;155189051;14280;0
18018;ENSG00000219023;;6;35523650;35524041;391;0
18019;ENSG00000219395;HSPA8P15;6;151732394;151735080;2686;0
18020;ENSG00000219545;RPA3-AS1;7;7680342;8043689;363347;0
18021;ENSG00000219693;;9;66544359;66545745;1386;0
18022;ENSG00000219891;ZSCAN12P1;6;28058932;28061442;2510;0
18023;ENSG00000220305;HNRNPH1P1;6;160133833;160135017;1184;0
18024;ENSG00000220563;PKMP3;6;86369610;86370324;714;0
18025;ENSG00000220583;RPL35P2;6;34231088;34231450;362;0
18026;ENSG00000220685;;6;5066029;5067216;1187;0
18027;ENSG00000220694;;6;127756781;127757334;553;0
18028;ENSG00000220744;RPL5P18;6;127683658;127684548;890;0
18029;ENSG00000220848;RPS18P9;6;149915220;149915679;459;0
18030;ENSG00000220867;HSPE1P26;6;158345434;158345708;274;0
18031;ENSG00000221676;RNU6ATAC;9;137029561;137029686;125;0
18032;ENSG00000221716;SNORA11;X;54840803;54840930;127;0
18033;ENSG00000221818;EBF2;8;25699246;25902913;203667;0
18034;ENSG00000221821;C6orf226;6;42858005;42858554;549;0
18035;ENSG00000221829;FANCG;9;35073832;35080013;6181;0
18036;ENSG00000221838;AP4M1;7;99699172;99707968;8796;0
18037;ENSG00000221866;PLXNA4;7;131808091;132333447;525356;0
18038;ENSG00000221869;CEBPD;8;48649471;48651648;2177;0
18039;ENSG00000221870;TMEM257;X;144908928;144911368;2440;0
18040;ENSG00000221886;C5orf54;5;159820155;159827104;6949;0
18041;ENSG00000221909;FAM200A;7;99143931;99156159;12228;0
18042;ENSG00000221914;PPP2R2A;8;26149007;26230196;81189;0
18043;ENSG00000221947;XKR9;8;71581600;71702606;121006;0
18044;ENSG00000221988;PPT2;6;32121218;32134011;12793;0
18045;ENSG00000221994;ZNF630;X;47842756;47931025;88269;0
18046;ENSG00000222011;FAM185A;7;102389418;102449672;60254;0
18047;ENSG00000222248;RNA5SP201;6;3088920;3089043;123;0
18048;ENSG00000222482;;7;99817650;99817743;93;0
18049;ENSG00000222533;RNU6-705P;5;180728968;180729071;103;0
18050;ENSG00000222894;;6;30584006;30584082;76;0
18051;ENSG00000222937;;5;137894659;137894728;69;0
18052;ENSG00000223044;RNU6-130P;6;82920055;82920157;102;0
18053;ENSG00000223259;RNA5SP508;X;75875410;75875528;118;0
18054;ENSG00000223414;LINC00473;6;166322290;166401536;79246;0
18055;ENSG00000223459;FAM115B;7;143295133;143305111;9978;0
18056;ENSG00000223473;;7;65956083;65958553;2470;0
18057;ENSG00000223475;;7;55640864;55656029;15165;0
18058;ENSG00000223476;VN1R42P;7;64393651;64393994;343;0
18059;ENSG00000223478;;9;131486724;131495473;8749;0
18060;ENSG00000223501;VPS52;6;33218049;33239824;21775;0
18061;ENSG00000223508;RPL23AP53;8;163186;182231;19045;0
18062;ENSG00000223537;;6;109809109;109828003;18894;0
18063;ENSG00000223546;LINC00630;X;102024089;102140334;116245;0
18064;ENSG00000223551;TMSB4XP4;9;131104432;131105049;617;0
18065;ENSG00000223561;;7;25632971;25790614;157643;0
18066;ENSG00000223571;DHRSX-IT1;X;2252336;2254451;2115;0
18067;ENSG00000223602;;9;69891208;69901481;10273;0
18068;ENSG00000223705;NSUN5P1;7;75039605;75046066;6461;0
18069;ENSG00000223749;MIR503HG;X;133677367;133680741;3374;0
18070;ENSG00000223773;CD99P1;X;2527389;2575270;47881;0
18071;ENSG00000223813;;7;29553841;29603286;49445;0
18072;ENSG00000223821;;6;74201748;74202465;717;0
18073;ENSG00000223839;FAM95B1;9;42466317;42474239;7922;0
18074;ENSG00000223855;;7;560028;564869;4841;0
18075;ENSG00000223865;HLA-DPB1;6;33043703;33054978;11275;0
18076;ENSG00000223969;;7;90219933;90226667;6734;0
18077;ENSG00000224016;;7;149588280;149606793;18513;0
18078;ENSG00000224020;MIR181A2HG;9;127420746;127460910;40164;0
18079;ENSG00000224032;EPB41L4A-AS1;5;111496223;111499973;3750;0
18080;ENSG00000224046;;7;86780739;86781736;997;0
18081;ENSG00000224106;CYP4F25P;9;69477881;69478916;1035;0
18082;ENSG00000224116;INHBA-AS1;7;41733514;41818986;85472;0
18083;ENSG00000224185;SNX18P9;9;69451764;69452598;834;0
18084;ENSG00000224204;PHEX-AS1;X;22180850;22191100;10250;1
18085;ENSG00000224216;;X;154564167;154581271;17104;0
18086;ENSG00000224223;;7;54624663;54639419;14756;0
18087;ENSG00000224280;;7;16623407;16626382;2975;0
18088;ENSG00000224281;SLC25A5-AS1;X;118599997;118603061;3064;0
18089;ENSG00000224316;;7;65238607;65267054;28447;0
18090;ENSG00000224389;C4B;6;31982539;32003195;20656;0
18091;ENSG00000224430;MKRN5P;X;73380897;73382363;1466;0
18092;ENSG00000224531;SMIM13;6;11094266;11138964;44698;0
18093;ENSG00000224546;EIF4BP3;9;98908289;98910138;1849;0
18094;ENSG00000224557;HLA-DPB2;6;33080228;33102442;22214;0
18095;ENSG00000224729;PCOLCE-AS1;7;100187025;100201829;14804;0
18096;ENSG00000224765;;X;136638350;136646546;8196;0
18097;ENSG00000224825;;9;77100467;77114043;13576;0
18098;ENSG00000224842;;9;129351873;129375979;24106;1
18099;ENSG00000224843;LINC00240;6;26924771;26991703;66932;0
18100;ENSG00000224846;;6;2989960;2999368;9408;0
18101;ENSG00000224849;;6;98150157;98155979;5822;0
18102;ENSG00000224897;POT1-AS1;7;124569927;124819369;249442;0
18103;ENSG00000224903;;7;156446879;156450387;3508;0
18104;ENSG00000224940;PRRT4;7;127990379;128001739;11360;0
18105;ENSG00000224945;;9;91703519;91724849;21330;0
18106;ENSG00000224958;PGM5-AS1;9;70970105;70972768;2663;1
18107;ENSG00000224975;INE1;X;47064320;47065264;944;0
18108;ENSG00000225031;EIF4BP7;X;110862905;110864717;1812;0
18109;ENSG00000225032;;9;130578345;130584799;6454;0
18110;ENSG00000225110;;X;152583141;152586144;3003;0
18111;ENSG00000225125;RANP4;X;135889382;135890036;654;0
18112;ENSG00000225135;;6;147708800;147711601;2801;0
18113;ENSG00000225173;;6;28805646;28806783;1137;0
18114;ENSG00000225177;;6;139013685;139018425;4740;0
18115;ENSG00000225259;ST13P6;8;134420249;134421471;1222;0
18116;ENSG00000225264;ZNRF2P2;7;29638411;29724871;86460;0
18117;ENSG00000225339;;6;34247456;34254545;7089;0
18118;ENSG00000225345;SNX18P3;9;38566257;38568208;1951;0
18119;ENSG00000225361;PPP1R26-AS1;9;138354573;138372623;18050;0
18120;ENSG00000225470;JPX;X;73164159;73290243;126084;0
18121;ENSG00000225471;;X;71364034;71381600;17566;0
18122;ENSG00000225472;;9;14317084;14357907;40823;1
18123;ENSG00000225559;;7;137848186;137849383;1197;0
18124;ENSG00000225595;;6;28827402;28832407;5005;0
18125;ENSG00000225648;SBDSP1;7;72300004;72307909;7905;0
18126;ENSG00000225689;;X;127457598;127734446;276848;0
18127;ENSG00000225706;;9;8858130;8862255;4125;0
18128;ENSG00000225725;FAM66E;8;7812536;7866277;53741;0
18129;ENSG00000225726;;7;76701068;76701554;486;0
18130;ENSG00000225791;TRAM2-AS1;6;52442105;52448783;6678;0
18131;ENSG00000225792;;7;26411764;26416321;4557;0
18132;ENSG00000225793;;6;75994730;76006719;11989;0
18133;ENSG00000225807;;7;100107340;100117549;10209;0
18134;ENSG00000225882;;X;17988317;18122764;134447;0
18135;ENSG00000225883;BMS1P11;9;69718152;69721729;3577;0
18136;ENSG00000225921;NOL7;6;13615559;13632971;17412;0
18137;ENSG00000225945;;6;37783553;37786994;3441;0
18138;ENSG00000225968;ELFN1;7;1727755;1787590;59835;0
18139;ENSG00000226002;;7;64544481;64560610;16129;0
18140;ENSG00000226007;;9;46843638;46846025;2387;0
18141;ENSG00000226031;FGF13-AS1;X;137793614;137798779;5165;0
18142;ENSG00000226055;PAICSP1;9;37878113;37879490;1377;0
18143;ENSG00000226102;SEPT7P3;7;35985904;36013282;27378;0
18144;ENSG00000226107;;X;133656732;133657020;288;0
18145;ENSG00000226179;LINC00685;X;281725;282586;861;0
18146;ENSG00000226194;;6;169770093;169788480;18387;0
18147;ENSG00000226237;;9;89563614;89616948;53334;0
18148;ENSG00000226310;;X;57148095;57153676;5581;0
18149;ENSG00000226314;ZNF192P1;6;28129559;28137372;7813;1
18150;ENSG00000226334;;9;107689834;107691173;1339;0
18151;ENSG00000226380;MIR29B1;7;130561495;130598069;36574;0
18152;ENSG00000226380;MIR29A;7;130561495;130598069;36574;0
18153;ENSG00000226445;;6;169613349;169639660;26311;0
18154;ENSG00000226524;;6;88032323;88109459;77136;0
18155;ENSG00000226530;;X;51139363;51208513;69150;0
18156;ENSG00000226574;SPANXA2-OT1;X;140590843;140738057;147214;0
18157;ENSG00000226609;;9;115511182;115512736;1554;0
18158;ENSG00000226673;LINC01108;6;14280358;14285376;5018;0
18159;ENSG00000226684;;6;97731179;97757924;26745;0
18160;ENSG00000226690;;7;12536055;12581536;45481;0
18161;ENSG00000226717;;9;10613202;10620420;7218;0
18162;ENSG00000226721;EEF1DP2;9;95599108;95599950;842;0
18163;ENSG00000226752;PSMD5-AS1;9;123587106;123616651;29545;0
18164;ENSG00000226786;;6;19535175;19839311;304136;0
18165;ENSG00000226823;;9;33503653;33510709;7056;0
18166;ENSG00000226824;;7;66119525;66134842;15317;0
18167;ENSG00000226840;PAICSP3;6;74037247;74038740;1493;0
18168;ENSG00000226904;;9;70843567;70844228;661;0
18169;ENSG00000226976;COX6A1P2;6;37012607;37013177;570;0
18170;ENSG00000226979;LTA;6;31539831;31542101;2270;0
18171;ENSG00000227014;;7;30028216;30065276;37060;0
18172;ENSG00000227057;WDR46;6;33246885;33257304;10419;0
18173;ENSG00000227060;LINC00629;X;133684003;133693953;9950;0
18174;ENSG00000227083;;X;146981696;146982977;1281;0
18175;ENSG00000227113;;7;64535401;64539158;3757;0
18176;ENSG00000227184;EPPK1;8;144939497;144952632;13135;0
18177;ENSG00000227192;;6;143360562;143363461;2899;0
18178;ENSG00000227199;ST7-AS1;7;116592500;116594388;1888;0
18179;ENSG00000227203;SUB1P1;8;11647514;11647897;383;0
18180;ENSG00000227220;;6;132272086;132398533;126447;0
18181;ENSG00000227285;;X;119055224;119056803;1579;0
18182;ENSG00000227318;;9;66664325;66665950;1625;0
18183;ENSG00000227449;;9;46687462;46746500;59038;0
18184;ENSG00000227486;;X;55934556;56041606;107050;0
18185;ENSG00000227494;USP9YP14;Y;20642973;20649286;6313;0
18186;ENSG00000227536;SOCS5P4;X;70263064;70265320;2256;0
18187;ENSG00000227544;;7;35754644;35774497;19853;0
18188;ENSG00000227558;PGM5P2;9;69080240;69147854;67614;0
18189;ENSG00000227598;;6;167383114;167412553;29439;0
18190;ENSG00000227603;;9;96197614;96199403;1789;0
18191;ENSG00000227627;;6;153304885;153310358;5473;0
18192;ENSG00000227678;;6;130454555;130465515;10960;0
18193;ENSG00000227704;;6;170125600;170139088;13488;0
18194;ENSG00000227855;DPY19L2P3;7;29689843;29782210;92367;0
18195;ENSG00000227863;;7;89073288;89123576;50288;0
18196;ENSG00000227869;;7;125071401;125106455;35054;0
18197;ENSG00000227885;;6;53605547;53611820;6273;1
18198;ENSG00000227888;FAM66A;8;12219527;12268510;48983;0
18199;ENSG00000227986;TRIM60P18;7;63815456;63816577;1121;0
18200;ENSG00000228010;;7;6703605;6748532;44927;0
18201;ENSG00000228031;;7;137029676;137039229;9553;0
18202;ENSG00000228113;;7;87848674;87921781;73107;0
18203;ENSG00000228124;;6;90383188;90385502;2314;0
18204;ENSG00000228139;;X;119251552;119253610;2058;0
18205;ENSG00000228158;TLE1P1;X;64627964;64628565;601;0
18206;ENSG00000228223;HCG11;6;26522076;26526807;4731;0
18207;ENSG00000228232;GAPDHP1;X;39646386;39647390;1004;0
18208;ENSG00000228253;MT-ATP8;MT;8366;8572;206;0
18209;ENSG00000228275;ARMCX3-AS1;X;100877973;100879154;1181;1
18210;ENSG00000228335;;7;99040513;99041119;606;0
18211;ENSG00000228360;;7;138912283;138912574;291;0
18212;ENSG00000228393;LINC01004;7;104590762;104653491;62729;0
18213;ENSG00000228395;;9;131291180;131314689;23509;0
18214;ENSG00000228409;CCT6P1;7;65216129;65228341;12212;0
18215;ENSG00000228412;;6;19802395;19804983;2588;0
18216;ENSG00000228415;PTMAP1;6;30601409;30601675;266;0
18217;ENSG00000228434;;7;44043645;44047465;3820;0
18218;ENSG00000228439;TSTD3;6;99968569;99979794;11225;0
18219;ENSG00000228451;SDAD1P1;8;26236775;26240469;3694;0
18220;ENSG00000228495;LINC01013;6;132453055;132490514;37459;1
18221;ENSG00000228506;;6;99872798;99879249;6451;0
18222;ENSG00000228510;;9;131206866;131208907;2041;0
18223;ENSG00000228532;;X;114952650;114953669;1019;0
18224;ENSG00000228544;CCDC183-AS1;9;139698379;139703300;4921;0
18225;ENSG00000228623;ZNF883;9;115759495;115774507;15012;0
18226;ENSG00000228624;;6;114290865;114792869;502004;0
18227;ENSG00000228659;;X;130115564;130192120;76556;0
18228;ENSG00000228672;PROB1;5;138727635;138730885;3250;0
18229;ENSG00000228716;DHFR;5;79922047;79950802;28755;0
18230;ENSG00000228727;SAPCD1;6;31730576;31732628;2052;0
18231;ENSG00000228775;WEE2-AS1;7;141404138;141438146;34008;1
18232;ENSG00000228789;HCG22;6;31021227;31027667;6440;0
18233;ENSG00000228801;;8;52811885;52859733;47848;0
18234;ENSG00000228878;;7;35791466;35840226;48760;0
18235;ENSG00000228903;RASA4CP;7;44066550;44081491;14941;0
18236;ENSG00000228906;;X;73168808;73169393;585;0
18237;ENSG00000229017;;6;143287558;143359214;71656;0
18238;ENSG00000229018;;7;72476064;72555749;79685;0
18239;ENSG00000229036;;6;143806116;143828464;22348;0
18240;ENSG00000229043;;7;1200010;1204903;4893;0
18241;ENSG00000229109;;9;85834246;85849157;14911;0
18242;ENSG00000229119;;5;165809310;165809604;294;0
18243;ENSG00000229153;EPHA1-AS1;7;143104906;143220542;115636;0
18244;ENSG00000229180;;7;65991075;66007536;16461;0
18245;ENSG00000229214;LINC00242;6;170188886;170198921;10035;0
18246;ENSG00000229236;TTTY10;Y;22627554;22681114;53560;0
18247;ENSG00000229273;;9;41954580;41955037;457;0
18248;ENSG00000229358;DPY19L1P1;7;32620561;32801399;180838;0
18249;ENSG00000229419;RALGAPA1P;9;108282409;108288640;6231;0
18250;ENSG00000229422;;9;66493572;66494196;624;0
18251;ENSG00000229582;;9;128506033;128508831;2798;1
18252;ENSG00000229587;;9;77624744;77630952;6208;0
18253;ENSG00000229789;;9;68726629;68745997;19368;0
18254;ENSG00000229807;XIST;X;73040486;73072588;32102;0
18255;ENSG00000229852;;6;73972938;74011124;38186;0
18256;ENSG00000229931;;6;16761369;16762883;1514;0
18257;ENSG00000229950;TFAP2A-AS1;6;10409573;10416679;7106;0
18258;ENSG00000229970;;7;8301894;8384146;82252;0
18259;ENSG00000230042;AK3P3;7;23168797;23169460;663;1
18260;ENSG00000230074;;9;34665662;34681295;15633;1
18261;ENSG00000230105;;X;56644824;56650891;6067;0
18262;ENSG00000230177;;6;111599135;111599945;810;0
18263;ENSG00000230185;C9orf147;9;115196096;115249484;53388;0
18264;ENSG00000230188;;9;37490418;37490890;472;0
18265;ENSG00000230189;;7;65874130;65955046;80916;0
18266;ENSG00000230202;;6;118320138;118320611;473;0
18267;ENSG00000230269;;6;3182978;3195990;13012;0
18268;ENSG00000230295;;7;66345695;66347968;2273;0
18269;ENSG00000230303;;9;88400637;88408395;7758;0
18270;ENSG00000230312;;X;103182679;103183597;918;0
18271;ENSG00000230313;HCG24;6;33112560;33115544;2984;0
18272;ENSG00000230314;ELOVL2-AS1;6;11043757;11078459;34702;0
18273;ENSG00000230333;;7;11221359;11559802;338443;0
18274;ENSG00000230359;TPI1P2;7;128696073;128696824;751;0
18275;ENSG00000230383;;7;137406731;137407592;861;0
18276;ENSG00000230444;TFAMP1;7;1654226;1654961;735;0
18277;ENSG00000230487;PSMG3-AS1;7;1609709;1629262;19553;0
18278;ENSG00000230537;;9;93867239;93869586;2347;0
18279;ENSG00000230551;;5;148872949;148884233;11284;0
18280;ENSG00000230578;;X;154578066;154579111;1045;0
18281;ENSG00000230583;GTF2IRD1P1;7;66274980;66309813;34833;0
18282;ENSG00000230590;FTX;X;73183790;73513409;329619;0
18283;ENSG00000230629;RPS23P8;X;70182814;70183143;329;0
18284;ENSG00000230658;KLHL7-AS1;7;23140847;23145322;4475;0
18285;ENSG00000230663;FAM224B;Y;19664680;19691634;26954;0
18286;ENSG00000230707;;X;139173902;139174720;818;0
18287;ENSG00000230715;;7;128292895;128293719;824;0
18288;ENSG00000230751;;7;30180486;30181033;547;0
18289;ENSG00000230797;YY2;X;21874105;21876845;2740;0
18290;ENSG00000230825;;7;7294785;7317410;22625;0
18291;ENSG00000230844;ZNF674-AS1;X;46404928;46407843;2915;0
18292;ENSG00000230873;STMND1;6;17102489;17131603;29114;0
18293;ENSG00000230910;;6;69339854;69344919;5065;0
18294;ENSG00000230939;;6;8784411;8785678;1267;0
18295;ENSG00000231007;CDC20P1;9;89626567;89628066;1499;0
18296;ENSG00000231028;LINC00271;6;135818489;136037193;218704;0
18297;ENSG00000231074;HCG18;6;30255174;30294927;39753;0
18298;ENSG00000231107;;9;93063184;93195787;132603;0
18299;ENSG00000231113;;6;42908102;42916098;7996;0
18300;ENSG00000231154;MORF4L2-AS1;X;102942212;102946700;4488;0
18301;ENSG00000231165;TRBV26OR9-2;9;33695765;33696057;292;0
18302;ENSG00000231167;YBX1P2;7;105222705;105223703;998;0
18303;ENSG00000231185;;5;141704858;142051566;346708;0
18304;ENSG00000231217;;X;6585906;6639585;53679;0
18305;ENSG00000231234;SKP1P1;7;65888392;65888880;488;0
18306;ENSG00000231255;;7;86404397;86405338;941;0
18307;ENSG00000231359;;7;6530424;6530729;305;0
18308;ENSG00000231389;HLA-DPA1;6;33032346;33048552;16206;0
18309;ENSG00000231441;;6;56708800;56728876;20076;0
18310;ENSG00000231460;;9;23829668;23849912;20244;0
18311;ENSG00000231500;RPS18;6;33239787;33244287;4500;0
18312;ENSG00000231527;;9;45108392;45112532;4140;0
18313;ENSG00000231587;SNORD62B;9;134365873;134365958;85;0
18314;ENSG00000231616;;9;86446501;86483335;36834;0
18315;ENSG00000231632;;9;91624949;91625393;444;0
18316;ENSG00000231652;;6;74403626;74405854;2228;1
18317;ENSG00000231690;LINC00574;6;170190417;170202969;12552;0
18318;ENSG00000231721;LINC-PINT;7;130626519;130794935;168416;0
18319;ENSG00000231725;VN1R110P;X;48494553;48495523;970;0
18320;ENSG00000231728;;X;103172005;103174131;2126;0
18321;ENSG00000231741;;9;88549503;88551514;2011;0
18322;ENSG00000231754;;6;21522707;21524003;1296;0
18323;ENSG00000231769;;6;46064830;46097443;32613;0
18324;ENSG00000231787;;X;103159243;103159675;432;0
18325;ENSG00000231806;PCAT7;9;97317351;97330409;13058;0
18326;ENSG00000231840;;7;142952357;142984473;32116;0
18327;ENSG00000231852;CYP21A2;6;32006042;32009447;3405;0
18328;ENSG00000231863;;6;161352112;161390803;38691;0
18329;ENSG00000231875;;X;80618767;80619669;902;0
18330;ENSG00000231889;TRAF3IP2-AS1;6;111804714;111919505;114791;0
18331;ENSG00000231925;TAPBP;6;33267471;33282164;14693;0
18332;ENSG00000231952;DPY19L1P2;7;32852369;32878182;25813;0
18333;ENSG00000231967;;9;5356312;5356525;213;0
18334;ENSG00000231989;PPP1R2P3;5;156277549;156279539;1990;0
18335;ENSG00000231995;;9;46577620;46578220;600;0
18336;ENSG00000232000;;9;14987300;15146399;159099;0
18337;ENSG00000232040;SCAND3;6;28539407;28583989;44582;0
18338;ENSG00000232082;RPS6KA2-IT1;6;166874151;166878871;4720;0
18339;ENSG00000232104;;9;3526723;3671646;144923;0
18340;ENSG00000232119;MCTS1;X;119727865;119754929;27064;0
18341;ENSG00000232160;RAP2C-AS1;X;131351175;131566890;215715;1
18342;ENSG00000232295;;6;71931160;72037931;106771;0
18343;ENSG00000232303;;9;32566146;32567124;978;0
18344;ENSG00000232311;;6;110147725;110149988;2263;0
18345;ENSG00000232316;;6;113749742;113754623;4881;0
18346;ENSG00000232412;;X;123093083;123095191;2108;0
18347;ENSG00000232433;;9;42493617;42494809;1192;0
18348;ENSG00000232434;C9orf172;9;139738867;139741797;2930;0
18349;ENSG00000232472;EEF1B2P3;X;24806509;24807186;677;0
18350;ENSG00000232533;;7;143076785;143077588;803;0
18351;ENSG00000232546;;7;66313483;66323123;9640;0
18352;ENSG00000232559;;7;66010634;66057373;46739;0
18353;ENSG00000232561;GTF2IP1;7;74602783;74653438;50655;0
18354;ENSG00000232593;LINC01155;X;53123327;53196196;72869;0
18355;ENSG00000232599;;X;124337654;124338187;533;0
18356;ENSG00000232600;;8;145660602;145665354;4752;0
18357;ENSG00000232611;;X;135923090;135929956;6866;0
18358;ENSG00000232618;;6;143271348;143277783;6435;0
18359;ENSG00000232633;;5;112658725;112772871;114146;0
18360;ENSG00000232725;;X;153001080;153031933;30853;0
18361;ENSG00000232759;;7;22602956;22613615;10659;0
18362;ENSG00000232815;LINC00537;9;68413482;68414196;714;0
18363;ENSG00000232818;RPS2P32;7;23530092;23530983;891;0
18364;ENSG00000232833;FAM27E3;9;67784944;67786624;1680;0
18365;ENSG00000232876;;6;135376171;135381688;5517;0
18366;ENSG00000232940;HCG25;6;33217311;33222766;5455;0
18367;ENSG00000232956;SNHG15;7;45022622;45026560;3938;0
18368;ENSG00000233006;;5;131646978;131705608;58630;0
18369;ENSG00000233016;SNHG7;9;139615818;139622636;6818;0
18370;ENSG00000233067;;X;22277914;23311263;1033349;0
18371;ENSG00000233073;;7;86413542;86415986;2444;0
18372;ENSG00000233081;;9;94188520;94189426;906;0
18373;ENSG00000233137;;9;37079893;37090398;10505;0
18374;ENSG00000233170;;8;37604854;37605522;668;0
18375;ENSG00000233225;;7;39872813;39874544;1731;0
18376;ENSG00000233237;LINC00472;6;72054047;72130472;76425;0
18377;ENSG00000233242;;9;37112545;37115487;2942;0
18378;ENSG00000233264;;7;8019943;8021859;1916;0
18379;ENSG00000233297;RASA4DP;7;102322283;102330916;8633;0
18380;ENSG00000233369;;7;72569033;72619657;50624;0
18381;ENSG00000233382;NKAPP1;X;119254863;119379122;124259;0
18382;ENSG00000233452;STXBP5-AS1;6;147163037;147525750;362713;0
18383;ENSG00000233476;EEF1A1P6;7;22550231;22551618;1387;0
18384;ENSG00000233554;;9;33166973;33179981;13008;0
18385;ENSG00000233631;;6;26634611;26637008;2397;0
18386;ENSG00000233760;;7;26591441;26596819;5378;1
18387;ENSG00000233776;;9;33732973;33738414;5441;0
18388;ENSG00000233822;HIST1H2BN;6;27806323;27823487;17164;0
18389;ENSG00000233830;EIF4HP1;7;27497782;27498468;686;0
18390;ENSG00000233864;TTTY15;Y;14774265;14804162;29897;1
18391;ENSG00000233892;PAIP1P1;6;30154575;30156391;1816;0
18392;ENSG00000233901;;9;132094579;132121817;27238;0
18393;ENSG00000233906;;9;23671786;23672397;611;0
18394;ENSG00000233913;;5;168043317;168044059;742;0
18395;ENSG00000233926;;9;84304628;84391815;87187;0
18396;ENSG00000233937;;5;180673523;180699168;25645;0
18397;ENSG00000233961;;9;69065655;69084989;19334;0
18398;ENSG00000233967;;6;81153061;81175644;22583;0
18399;ENSG00000234062;;X;135991554;136103789;112235;0
18400;ENSG00000234127;TRIM26;6;30152232;30181204;28972;0
18401;ENSG00000234129;;X;10865996;11129261;263265;0
18402;ENSG00000234141;;7;7989484;7990340;856;0
18403;ENSG00000234160;;9;37509147;37510296;1149;0
18404;ENSG00000234161;PABPC5-AS1;X;90669877;90689998;20121;0
18405;ENSG00000234210;;7;157258925;157292410;33485;0
18406;ENSG00000234215;;7;69060944;69062434;1490;0
18407;ENSG00000234224;TMEM229A;7;123670973;123673523;2550;0
18408;ENSG00000234229;;9;109378339;109464943;86604;0
18409;ENSG00000234284;ZNF879;5;178450753;178462065;11312;0
18410;ENSG00000234286;;7;23719814;23720405;591;0
18411;ENSG00000234299;CDK2AP2P1;9;45363481;45363852;371;0
18412;ENSG00000234323;;9;109040673;109367076;326403;0
18413;ENSG00000234336;JAZF1-AS1;7;28219941;28283536;63595;0
18414;ENSG00000234345;;X;103165225;103166272;1047;0
18415;ENSG00000234352;;7;136370306;136866854;496548;0
18416;ENSG00000234390;USP27X-AS1;X;49641327;49643844;2517;0
18417;ENSG00000234405;;X;102752451;102755245;2794;0
18418;ENSG00000234432;;7;5465908;5468558;2650;0
18419;ENSG00000234444;ZNF736;7;63767837;63815238;47401;0
18420;ENSG00000234449;;X;3771051;3800358;29307;0
18421;ENSG00000234456;MAGI2-AS3;7;79082198;79100524;18326;0
18422;ENSG00000234536;;7;45813194;45822756;9562;0
18423;ENSG00000234545;FAM133B;7;92190107;92219708;29601;0
18424;ENSG00000234585;CCT6P3;7;64498732;64535091;36359;0
18425;ENSG00000234616;JRK;8;143738874;143763386;24512;0
18426;ENSG00000234618;RPSAP9;9;79013615;79014502;887;0
18427;ENSG00000234636;MED14-AS1;X;40594652;40597950;3298;0
18428;ENSG00000234665;;9;66513488;66553911;40423;0
18429;ENSG00000234692;;9;118014817;118016530;1713;0
18430;ENSG00000234740;;9;13274509;13279186;4677;0
18431;ENSG00000234745;HLA-B;6;31321649;31324965;3316;0
18432;ENSG00000234771;;9;130873450;130881013;7563;0
18433;ENSG00000234817;;6;4136306;4157619;21313;0
18434;ENSG00000234882;EIF3EP1;6;74001685;74003000;1315;0
18435;ENSG00000235051;;6;10882013;10884582;2569;0
18436;ENSG00000235077;;7;99728587;99738062;9475;0
18437;ENSG00000235106;LINC00094;9;136890561;136899788;9227;0
18438;ENSG00000235109;ZSCAN31;6;28292470;28324048;31578;0
18439;ENSG00000235173;FAM203A;8;145192672;145195746;3074;0
18440;ENSG00000235174;RPL39P3;6;74082831;74082986;155;0
18441;ENSG00000235189;;X;129003040;129091504;88464;0
18442;ENSG00000235238;SUMO2P1;6;29603837;29604120;283;0
18443;ENSG00000235244;;X;115033604;115085422;51818;0
18444;ENSG00000235314;LINC00957;7;44078770;44081905;3135;0
18445;ENSG00000235326;;9;3674546;3691814;17268;0
18446;ENSG00000235381;;6;155574273;155577858;3585;0
18447;ENSG00000235436;DPY19L2P4;7;89748714;89754914;6200;0
18448;ENSG00000235437;;X;62563106;62780951;217845;0
18449;ENSG00000235447;;X;75875899;75876960;1061;0
18450;ENSG00000235448;;9;12700100;12814344;114244;0
18451;ENSG00000235453;TOPORS-AS1;9;32551142;32567003;15861;0
18452;ENSG00000235475;;7;66800963;66805011;4048;0
18453;ENSG00000235481;;9;33785948;33818793;32845;0
18454;ENSG00000235636;NUS1P1;X;47372001;47372882;881;0
18455;ENSG00000235652;;6;146136048;146207721;71673;0
18456;ENSG00000235663;SAPCD1-AS1;6;31732087;31733365;1278;0
18457;ENSG00000235703;LINC00894;X;149106846;149392815;285969;0
18458;ENSG00000235859;;7;30410987;30412357;1370;0
18459;ENSG00000235863;B3GALT4;6;33244917;33252609;7692;0
18460;ENSG00000235893;;9;70348573;70349113;540;0
18461;ENSG00000235944;ZNF815P;7;5862791;5894066;31275;0
18462;ENSG00000235946;;X;103317106;103317601;495;0
18463;ENSG00000235961;PNMA6C;X;152240819;152243399;2580;0
18464;ENSG00000236017;ASMTL-AS1;X;1520662;1532921;12259;0
18465;ENSG00000236104;ZBTB22;6;33282183;33285719;3536;0
18466;ENSG00000236166;;6;132406224;132420419;14195;0
18467;ENSG00000236184;TCEA1P4;9;32979558;32980401;843;0
18468;ENSG00000236233;;9;67792167;67794649;2482;0
18469;ENSG00000236279;CLEC2L;7;139208602;139229730;21128;0
18470;ENSG00000236337;FMR1-IT1;X;147028461;147029103;642;0
18471;ENSG00000236404;;9;2422702;2641395;218693;0
18472;ENSG00000236537;;6;158703295;158733390;30095;0
18473;ENSG00000236544;;7;155213901;155249794;35893;0
18474;ENSG00000236548;;6;125230239;125284185;53946;0
18475;ENSG00000236609;ZNF853;7;6655248;6663921;8673;0
18476;ENSG00000236708;;7;3303664;3342084;38420;0
18477;ENSG00000236714;;5;142125165;142140563;15398;0
18478;ENSG00000236753;MKLN1-AS;7;130994503;131012981;18478;0
18479;ENSG00000236796;;9;32836573;32869593;33020;0
18480;ENSG00000236814;;8;56962597;56963766;1169;0
18481;ENSG00000236816;ANKRD20A7P;9;44076368;44118444;42076;0
18482;ENSG00000236871;LINC00106;X;1515320;1518295;2975;0
18483;ENSG00000236901;MIR600HG;9;125871773;125877756;5983;0
18484;ENSG00000236924;;9;6645956;6670635;24679;0
18485;ENSG00000236939;C8orf56;8;104145191;104153703;8512;0
18486;ENSG00000237004;ZNRF2P1;7;32768181;32768623;442;0
18487;ENSG00000237021;;6;116575370;116577906;2536;1
18488;ENSG00000237026;;7;64696164;64697097;933;0
18489;ENSG00000237187;NR2F1-AS1;5;92745065;92921354;176289;0
18490;ENSG00000237190;CDKN2AIPNL;5;133737778;133747589;9811;0
18491;ENSG00000237198;FAM27E1;9;46385691;46387031;1340;0
18492;ENSG00000237212;;9;98857493;98864194;6701;0
18493;ENSG00000237238;BMS1P10;9;67327775;67334983;7208;0
18494;ENSG00000237310;;7;65958693;65960461;1768;0
18495;ENSG00000237357;;9;44401766;44404440;2674;0
18496;ENSG00000237441;RGL2;6;33259431;33267101;7670;0
18497;ENSG00000237451;CDK2AP2P2;9;66500642;66501008;366;0
18498;ENSG00000237461;;9;102348068;102582171;234103;0
18499;ENSG00000237499;;6;138144810;138189370;44560;0
18500;ENSG00000237506;RPSAP15;X;86958277;86959307;1030;0
18501;ENSG00000237529;;9;85891291;85894414;3123;0
18502;ENSG00000237596;;6;136415853;136546733;130880;0
18503;ENSG00000237640;;7;99527015;99546243;19228;0
18504;ENSG00000237649;KIFC1;6;33359313;33377701;18388;1
18505;ENSG00000237669;HCG4P3;6;29973898;29974893;995;0
18506;ENSG00000237686;;6;43963460;44042389;78929;1
18507;ENSG00000237764;;7;124812272;125019375;207103;0
18508;ENSG00000237786;GFOD1-AS1;6;13486526;13487084;558;0
18509;ENSG00000237792;;9;65585692;65661972;76280;0
18510;ENSG00000237807;;8;54427731;54436491;8760;0
18511;ENSG00000237815;;7;76689662;76689796;134;0
18512;ENSG00000237819;;7;92465797;92546501;80704;0
18513;ENSG00000237863;;X;107979241;107982133;2892;0
18514;ENSG00000237886;;9;139440664;139444345;3681;0
18515;ENSG00000237906;MUPP;9;115721414;115724541;3127;1
18516;ENSG00000237921;;7;19853308;19857713;4405;0
18517;ENSG00000237923;;6;30807303;30815936;8633;0
18518;ENSG00000237984;PTENP1;9;33673502;33677497;3995;0
18519;ENSG00000238035;;5;180733503;180755068;21565;0
18520;ENSG00000238039;;X;148593039;148607803;14764;0
18521;ENSG00000238058;;9;138799658;138805359;5701;0
18522;ENSG00000238072;;7;129049954;129050211;257;0
18523;ENSG00000238099;;6;139791301;139794192;2891;0
18524;ENSG00000238103;RPL9P7;X;23854761;23855459;698;0
18525;ENSG00000238227;C9orf69;9;139006427;139010731;4304;0
18526;ENSG00000238228;OR7E7P;7;97576299;97577310;1011;0
18527;ENSG00000238324;RN7SKP198;7;102497897;102498202;305;0
18528;ENSG00000238832;;7;107243808;107243952;144;0
18529;ENSG00000238961;SNORA47;5;76376259;76376396;137;0
18530;ENSG00000239218;RPS20P22;8;38291865;38293182;1317;0
18531;ENSG00000239264;TXNDC5;6;7881483;8026646;145163;0
18532;ENSG00000239389;PCDHA13;5;140261793;140391929;130136;1
18533;ENSG00000239407;;X;102139342;102161086;21744;0
18534;ENSG00000239419;RN7SL535P;7;142987708;142988004;296;0
18535;ENSG00000239521;;7;99798276;99869837;71561;0
18536;ENSG00000239556;;7;44024593;44029806;5213;0
18537;ENSG00000239569;KMT2E-AS1;7;104653872;104654768;896;0
18538;ENSG00000239577;RN7SL388P;X;71418562;71418898;336;0
18539;ENSG00000239650;GUSBP4;6;58246051;58256569;10518;0
18540;ENSG00000239789;MRPS17;7;56019512;56024192;4680;0
18541;ENSG00000239815;;7;128506633;128508898;2265;0
18542;ENSG00000239857;GET4;7;916189;936073;19884;0
18543;ENSG00000239911;PRKAG2-AS1;7;151574127;151576299;2172;0
18544;ENSG00000239969;;7;102004609;102021080;16471;0
18545;ENSG00000240031;OR9A3P;7;141562660;141563537;877;0
18546;ENSG00000240050;;6;116601362;116691436;90074;0
18547;ENSG00000240053;LY6G5B;6;31637944;31641553;3609;0
18548;ENSG00000240184;PCDHGC3;5;140855580;140892542;36962;0
18549;ENSG00000240204;SMKR1;7;129142320;129152773;10453;0
18550;ENSG00000240230;COX19;7;938415;1015235;76820;0
18551;ENSG00000240240;;9;42409989;42474239;64250;0
18552;ENSG00000240322;RN7SL481P;7;142995609;142995905;296;0
18553;ENSG00000240449;;7;150060866;150069679;8813;0
18554;ENSG00000240498;CDKN2B-AS1;9;21994777;22121096;126319;0
18555;ENSG00000240583;AQP1;7;30893010;30965131;72121;0
18556;ENSG00000240694;PNMA2;8;26362202;26371608;9406;0
18557;ENSG00000240720;LRRD1;7;91741473;91808845;67372;1
18558;ENSG00000240764;PCDHGC5;5;140868808;140892546;23738;0
18559;ENSG00000240859;;7;149597;155465;5868;0
18560;ENSG00000240889;NDUFB2-AS1;7;140395136;140396877;1741;0
18561;ENSG00000240907;;9;69174213;69179458;5245;0
18562;ENSG00000241043;GVQW1;9;32566787;32568619;1832;0
18563;ENSG00000241057;;7;44001189;44012924;11735;0
18564;ENSG00000241127;YAE1D1;7;39605975;39649919;43944;0
18565;ENSG00000241258;CRCP;7;65579591;65619555;39964;0
18566;ENSG00000241269;;7;5459458;5460398;940;0
18567;ENSG00000241343;RPL36A;X;100645812;100651105;5293;0
18568;ENSG00000241370;RPP21;6;30312908;30314661;1753;0
18569;ENSG00000241404;EGFL8;6;32132360;32136058;3698;0
18570;ENSG00000241468;ATP5J2;7;99046098;99063954;17856;0
18571;ENSG00000241489;;X;148564074;148615470;51396;0
18572;ENSG00000241549;GUSBP2;6;26839263;26924333;85070;0
18573;ENSG00000241685;ARPC1A;7;98923521;98985787;62266;0
18574;ENSG00000241697;TMEFF1;9;103204560;103339918;135358;0
18575;ENSG00000241764;;7;107383262;107385026;1764;0
18576;ENSG00000241769;LINC00893;X;148609130;148622504;13374;0
18577;ENSG00000241781;;9;79186731;79186787;56;0
18578;ENSG00000241847;VDAC1P8;6;143811652;143812504;852;0
18579;ENSG00000241852;C8orf58;8;22457114;22461663;4549;0
18580;ENSG00000241859;KALP;Y;15863536;16027704;164168;0
18581;ENSG00000241956;;5;163723702;164598649;874947;0
18582;ENSG00000242013;USP27X;X;49644470;49647166;2696;0
18583;ENSG00000242072;;7;115287515;115316383;28868;0
18584;ENSG00000242265;PEG10;7;94285637;94299007;13370;0
18585;ENSG00000242294;STAG3L5P;7;99933702;99949523;15821;0
18586;ENSG00000242375;;9;99957633;99959969;2336;0
18587;ENSG00000242419;PCDHGC4;5;140864741;140892546;27805;0
18588;ENSG00000242474;;7;135853;149466;13613;1
18589;ENSG00000242588;;7;128171752;128269512;97760;0
18590;ENSG00000242593;;7;123672259;124035172;362913;0
18591;ENSG00000242687;;7;98610788;98645863;35075;0
18592;ENSG00000242732;RGAG4;X;71346958;71351758;4800;0
18593;ENSG00000242798;;7;99712837;99724762;11925;0
18594;ENSG00000242802;AP5Z1;7;4815253;4833943;18690;0
18595;ENSG00000243004;;7;19958604;20180076;221472;0
18596;ENSG00000243107;;7;91829328;91836171;6843;0
18597;ENSG00000243232;PCDHAC2;5;140345820;140391936;46116;0
18598;ENSG00000243279;PRAF2;X;48928813;48931730;2917;0
18599;ENSG00000243302;;7;128291239;128292388;1149;0
18600;ENSG00000243317;C7orf73;7;135347244;135378166;30922;0
18601;ENSG00000243335;KCTD7;7;66093868;66276446;182578;0
18602;ENSG00000243444;PALM2;9;112403068;112713755;310687;0
18603;ENSG00000243554;;7;97598317;97601566;3249;0
18604;ENSG00000243566;UPK3B;7;76139745;76648340;508595;0
18605;ENSG00000243587;C6orf183;6;109487036;109592217;105181;0
18606;ENSG00000243679;;7;128294023;128294776;753;0
18607;ENSG00000243738;RN7SL181P;9;123965437;123965712;275;0
18608;ENSG00000243753;HLA-L;6;30227361;30260791;33430;0
18609;ENSG00000243978;RGAG1;X;109602044;109699562;97518;0
18610;ENSG00000244041;LINC01011;6;2988201;2991407;3206;0
18611;ENSG00000244055;;7;92086878;92120924;34046;1
18612;ENSG00000244151;;7;150771829;150773617;1788;0
18613;ENSG00000244187;TMEM141;9;139685807;139687709;1902;0
18614;ENSG00000244218;RN7SL81P;7;128401391;128401625;234;0
18615;ENSG00000244219;;7;99195689;99208439;12750;0
18616;ENSG00000244291;C7orf13;7;156431057;156433348;2291;0
18617;ENSG00000244480;;7;30562759;30564151;1392;0
18618;ENSG00000244560;;7;148982372;148994403;12031;0
18619;ENSG00000244694;PTCHD4;6;47845764;48036425;190661;1
18620;ENSG00000244701;;7;141352181;141356610;4429;1
18621;ENSG00000244731;C4A;6;31949801;31970458;20657;0
18622;ENSG00000245025;;8;22842109;22876848;34739;0
18623;ENSG00000245060;LINC00847;5;180257957;180262726;4769;0
18624;ENSG00000245146;LINC01024;5;139452442;139488215;35773;0
18625;ENSG00000245149;RNF139-AS1;8;125474726;125486817;12091;0
18626;ENSG00000245275;SAP30L-AS1;5;153708997;153825410;116413;0
18627;ENSG00000245281;;8;17942377;17953903;11526;0
18628;ENSG00000245317;;5;179286013;179288283;2270;0
18629;ENSG00000245526;LINC00461;5;87803363;87986858;183495;0
18630;ENSG00000245556;;5;77638189;77656331;18142;0
18631;ENSG00000245812;;5;158527491;158544486;16995;1
18632;ENSG00000245864;;5;87972036;88018648;46612;0
18633;ENSG00000245910;SNHG6;8;67833919;67838633;4714;0
18634;ENSG00000245937;;5;127276118;127418864;142746;0
18635;ENSG00000246089;;8;6261072;6264663;3591;0
18636;ENSG00000246130;;8;22925742;22941132;15390;0
18637;ENSG00000246263;;8;103251622;103265561;13939;0
18638;ENSG00000246323;;5;137368463;137372955;4492;0
18639;ENSG00000246334;PRR7-AS1;5;176865504;176874700;9196;0
18640;ENSG00000246339;EXTL3-AS1;8;28553718;28558981;5263;0
18641;ENSG00000246350;;6;28555155;28559524;4369;0
18642;ENSG00000246528;;8;70746346;70767206;20860;0
18643;ENSG00000246596;;5;177046060;177099210;53150;0
18644;ENSG00000246662;LINC00535;8;94225531;94712661;487130;0
18645;ENSG00000246763;RGMB-AS1;5;98105322;98109173;3851;0
18646;ENSG00000246792;;8;91658669;91668826;10157;0
18647;ENSG00000246859;STARD4-AS1;5;110847924;111075423;227499;0
18648;ENSG00000246982;;6;36114475;36164982;50507;0
18649;ENSG00000247081;;8;104169218;104311000;141782;0
18650;ENSG00000247121;;5;96149731;96271513;121782;0
18651;ENSG00000247134;;8;32853696;32902373;48677;0
18652;ENSG00000247199;;5;147647870;147763346;115476;0
18653;ENSG00000247311;;5;121464457;121490551;26094;0
18654;ENSG00000247572;CKMT2-AS1;5;80499903;80597379;97476;0
18655;ENSG00000247627;MTND4P12;5;134262350;134263726;1376;0
18656;ENSG00000247679;;5;177038254;177046755;8501;0
18657;ENSG00000247746;USP51;X;55511049;55515635;4586;0
18658;ENSG00000247828;TMEM161B-AS1;5;87564712;87732502;167790;0
18659;ENSG00000248103;;5;180708376;180710653;2277;0
18660;ENSG00000248159;HSPA8P11;8;30094898;30098513;3615;0
18661;ENSG00000248175;;5;114539713;114541943;2230;0
18662;ENSG00000248202;;5;97217124;97258399;41275;0
18663;ENSG00000248275;TRIM52-AS1;5;180688213;180699308;11095;0
18664;ENSG00000248309;MEF2C-AS1;5;88179145;88762215;583070;0
18665;ENSG00000248367;;5;179720245;179722253;2008;0
18666;ENSG00000248383;PCDHAC1;5;140306302;140391929;85627;0
18667;ENSG00000248428;;5;110306650;110344598;37948;1
18668;ENSG00000248445;;5;115783243;115843972;60729;0
18669;ENSG00000248449;PCDHGB8P;5;140805853;140808219;2366;0
18670;ENSG00000248489;;5;98264875;98330717;65842;0
18671;ENSG00000248503;;X;77166238;77220387;54149;0
18672;ENSG00000248514;;5;180632361;180633120;759;0
18673;ENSG00000248596;;5;175570088;175626298;56210;0
18674;ENSG00000248610;HSPA8P4;5;129475724;129477643;1919;0
18675;ENSG00000248616;;5;136193317;136194031;714;0
18676;ENSG00000248690;HAS2-AS1;8;122651533;122656933;5400;0
18677;ENSG00000248708;;5;87008952;87029086;20134;0
18678;ENSG00000248734;;5;96120481;96121703;1222;0
18679;ENSG00000248801;;8;69215703;69243726;28023;0
18680;ENSG00000248923;MTND5P11;5;134260338;134262149;1811;0
18681;ENSG00000248927;;5;120116913;120126473;9560;0
18682;ENSG00000249034;;5;140240341;140243224;2883;0
18683;ENSG00000249042;;5;79778112;79783882;5770;0
18684;ENSG00000249129;SUDS3P1;5;177398317;177399282;965;0
18685;ENSG00000249158;PCDHA11;5;140248689;140391929;143240;1
18686;ENSG00000249167;;5;115910178;115927094;16916;0
18687;ENSG00000249258;;8;16988690;17007298;18608;1
18688;ENSG00000249316;;8;11138873;11140010;1137;0
18689;ENSG00000249353;NPM1P27;5;93018544;93019373;829;0
18690;ENSG00000249362;;5;86957859;86974964;17105;0
18691;ENSG00000249395;CASC9;8;76135639;76236976;101337;0
18692;ENSG00000249421;ADAMTS19-AS1;5;128795252;128796382;1130;0
18693;ENSG00000249476;;5;108572821;108662070;89249;0
18694;ENSG00000249504;PCDHA14;5;140240860;140243104;2244;0
18695;ENSG00000249577;;5;126801514;126801810;296;1
18696;ENSG00000249637;;5;139750476;139780952;30476;0
18697;ENSG00000249655;;5;79926132;79927409;1277;0
18698;ENSG00000249684;;5;177377336;177390961;13625;0
18699;ENSG00000249773;;7;55954970;56022932;67962;0
18700;ENSG00000249776;;5;91745963;91996570;250607;0
18701;ENSG00000249803;;5;135802366;135855987;53621;0
18702;ENSG00000249825;;5;79348197;79379477;31280;0
18703;ENSG00000249853;HS3ST5;6;114376750;114664209;287459;0
18704;ENSG00000249859;PVT1;8;128806779;129113499;306720;0
18705;ENSG00000249868;;8;255306;281026;25720;0
18706;ENSG00000249889;ALG1L11P;8;12036206;12040228;4022;0
18707;ENSG00000249898;;8;6475996;6565730;89734;0
18708;ENSG00000249984;;5;92011663;92023961;12298;0
18709;ENSG00000250049;;5;91378414;91815133;436719;0
18710;ENSG00000250120;PCDHA10;5;140235595;140391929;156334;0
18711;ENSG00000250156;;5;87704799;87734907;30108;0
18712;ENSG00000250159;;5;137150022;137225025;75003;0
18713;ENSG00000250197;HMGN1P15;5;114624733;114625027;294;0
18714;ENSG00000250222;;5;180618924;180621429;2505;0
18715;ENSG00000250240;;5;95036953;95067999;31046;0
18716;ENSG00000250260;;5;137374888;137375668;780;0
18717;ENSG00000250284;;5;136070616;136090375;19759;0
18718;ENSG00000250305;KIAA1456;8;12803151;12889012;85861;1
18719;ENSG00000250320;;5;83680245;83786583;106338;0
18720;ENSG00000250331;;5;96840400;97006750;166350;0
18721;ENSG00000250358;;5;111964133;111967797;3664;0
18722;ENSG00000250420;AACSP1;5;178191862;178245436;53574;0
18723;ENSG00000250539;KRT8P33;5;122736616;122738038;1422;0
18724;ENSG00000250569;NTAN1P2;8;87493983;87495231;1248;0
18725;ENSG00000250571;GLI4;8;144349603;144359101;9498;0
18726;ENSG00000250615;;5;76369706;76370345;639;0
18727;ENSG00000250686;;6;62340138;62390954;50816;0
18728;ENSG00000250794;ALG1L12P;8;12278541;12282509;3968;0
18729;ENSG00000250802;ZBED3-AS1;5;76382565;76462734;80169;0
18730;ENSG00000250900;;5;180622496;180630103;7607;0
18731;ENSG00000250903;GMDS-AS1;6;2245982;2482256;236274;1
18732;ENSG00000250979;;8;73114986;73163800;48814;0
18733;ENSG00000250999;;5;179084763;179091433;6670;0
18734;ENSG00000251003;;8;106792474;107072752;280278;0
18735;ENSG00000251023;;5;93196375;93199531;3156;0
18736;ENSG00000251050;;5;79315432;79315743;311;1
18737;ENSG00000251072;;5;126087655;126112178;24523;0
18738;ENSG00000251136;;8;90621638;90769955;148317;1
18739;ENSG00000251192;ZNF674;X;46357162;46404892;47730;0
18740;ENSG00000251348;HSPD1P11;5;95104703;95106404;1701;0
18741;ENSG00000251396;;8;61297147;61429354;132207;0
18742;ENSG00000251450;;5;80243516;80256726;13210;0
18743;ENSG00000251468;;8;12815896;12819709;3813;0
18744;ENSG00000251664;PCDHA12;5;140255058;140391929;136871;0
18745;ENSG00000251666;ZNF346-IT1;5;176478715;176479964;1249;0
18746;ENSG00000251667;;5;175735066;175736016;950;0
18747;ENSG00000251680;;5;128836054;129241610;405556;0
18748;ENSG00000251705;RNA5-8SP6;Y;10037764;10037915;151;0
18749;ENSG00000251867;;8;81396796;81397854;1058;0
18750;ENSG00000251969;;6;79671213;79671289;76;0
18751;ENSG00000251988;RNU4ATAC18P;6;160141447;160141572;125;0
18752;ENSG00000252106;;6;52843956;52844053;97;0
18753;ENSG00000252464;RN7SKP70;5;178046729;178046999;270;0
18754;ENSG00000252498;RNU6-1016P;6;76353800;76353893;93;0
18755;ENSG00000252755;RNU6-703P;8;99061084;99061190;106;0
18756;ENSG00000252793;RNA5SP196;5;145965662;145965763;101;0
18757;ENSG00000252821;RNU6-388P;7;33041562;33041666;104;0
18758;ENSG00000253106;;8;125500751;125503884;3133;0
18759;ENSG00000253159;PCDHGA12;5;140810185;140892546;82361;0
18760;ENSG00000253175;;8;95577264;95577943;679;0
18761;ENSG00000253180;;8;100015635;100016070;435;0
18762;ENSG00000253200;;8;22471421;22474170;2749;1
18763;ENSG00000253208;;8;26405185;26405979;794;0
18764;ENSG00000253210;;8;142136143;142140060;3917;0
18765;ENSG00000253213;;5;170678870;170679986;1116;0
18766;ENSG00000253223;;8;67896370;67898422;2052;0
18767;ENSG00000253230;LINC00599;8;9757574;9762876;5302;1
18768;ENSG00000253250;C8orf88;8;91970865;91997485;26620;0
18769;ENSG00000253263;;8;103904104;103905836;1732;0
18770;ENSG00000253276;CCDC71L;7;106297211;106301442;4231;0
18771;ENSG00000253301;;8;58055248;58152857;97609;1
18772;ENSG00000253305;PCDHGB6;5;140787770;140892546;104776;0
18773;ENSG00000253320;;8;103876528;103990104;113576;0
18774;ENSG00000253327;RAD21-AS1;8;117886663;117889107;2444;0
18775;ENSG00000253336;;8;124300595;124302743;2148;0
18776;ENSG00000253341;;8;75515479;75516479;1000;0
18777;ENSG00000253369;;8;54307771;54308506;735;0
18778;ENSG00000253390;;8;23316114;23342484;26370;0
18779;ENSG00000253395;;8;102134373;102138386;4013;0
18780;ENSG00000253457;SMIM18;8;30496117;30503581;7464;0
18781;ENSG00000253476;;8;25283037;25284096;1059;0
18782;ENSG00000253477;;8;104495626;104513904;18278;0
18783;ENSG00000253485;PCDHGA5;5;140743898;140892546;148648;0
18784;ENSG00000253516;HMGB1P41;8;81724377;81724816;439;0
18785;ENSG00000253535;;8;24153327;24769586;616259;0
18786;ENSG00000253537;PCDHGA7;5;140762467;140892546;130079;0
18787;ENSG00000253549;;8;86354080;86377144;23064;0
18788;ENSG00000253553;;8;89339065;89749363;410298;0
18789;ENSG00000253554;;8;64599737;65281115;681378;0
18790;ENSG00000253591;;5;170066162;170108441;42279;1
18791;ENSG00000253596;;8;75259992;75262285;2293;0
18792;ENSG00000253598;SLC10A5;8;82605842;82608409;2567;0
18793;ENSG00000253633;;8;103540968;103550896;9928;0
18794;ENSG00000253636;;8;73964413;73975296;10883;1
18795;ENSG00000253641;;8;10332075;10339484;7409;1
18796;ENSG00000253642;;8;33462374;33896526;434152;0
18797;ENSG00000253653;;5;156687132;156693635;6503;0
18798;ENSG00000253661;ZFHX4-AS1;8;77403435;77595513;192078;0
18799;ENSG00000253669;;8;103817745;103822199;4454;0
18800;ENSG00000253686;;5;173134617;173173214;38597;0
18801;ENSG00000253696;KBTBD11-OT1;8;1919563;1924644;5081;0
18802;ENSG00000253704;;8;95565950;95581973;16023;0
18803;ENSG00000253706;;8;75711019;75779174;68155;0
18804;ENSG00000253716;;8;144362331;144363860;1529;0
18805;ENSG00000253729;PRKDC;8;48685669;48872743;187074;0
18806;ENSG00000253731;PCDHGA6;5;140753651;140892546;138895;0
18807;ENSG00000253734;;8;64681988;64698058;16070;0
18808;ENSG00000253738;;8;92072137;92082417;10280;0
18809;ENSG00000253741;;8;143783670;143808391;24721;0
18810;ENSG00000253762;;8;64617314;64664235;46921;0
18811;ENSG00000253764;;8;1920736;1922803;2067;0
18812;ENSG00000253767;PCDHGA8;5;140772381;140892546;120165;0
18813;ENSG00000253793;;8;30840975;30841837;862;0
18814;ENSG00000253839;;8;137501691;137542119;40428;0
18815;ENSG00000253846;PCDHGA10;5;140792743;140892546;99803;0
18816;ENSG00000253854;;8;94731802;94733395;1593;0
18817;ENSG00000253857;;8;56074043;56077287;3244;0
18818;ENSG00000253865;;5;148751737;148754679;2942;0
18819;ENSG00000253873;PCDHGA11;5;140800762;140891835;91073;0
18820;ENSG00000253878;;8;95962265;95963624;1359;1
18821;ENSG00000253910;PCDHGB2;5;140739703;140892546;152843;1
18822;ENSG00000253919;PRKRIRP7;8;79672377;79674666;2289;0
18823;ENSG00000253931;;8;144494919;144499224;4305;0
18824;ENSG00000253948;;8;100008991;100025272;16281;0
18825;ENSG00000253953;PCDHGB4;5;140767452;140892546;125094;0
18826;ENSG00000253965;;5;139728069;139737379;9310;0
18827;ENSG00000253978;;5;167656588;167659362;2774;0
18828;ENSG00000253982;;8;1710156;1712668;2512;0
18829;ENSG00000254027;;8;82192106;82193681;1575;0
18830;ENSG00000254035;;5;178396391;178417117;20726;0
18831;ENSG00000254087;LYN;8;56792372;56923940;131568;0
18832;ENSG00000254093;PINX1;8;10622473;10697394;74921;0
18833;ENSG00000254101;;8;137543041;137997178;454137;0
18834;ENSG00000254102;;8;65486863;65494445;7582;0
18835;ENSG00000254122;PCDHGB7;5;140797427;140892546;95119;0
18836;ENSG00000254144;;8;144624280;144624570;290;0
18837;ENSG00000254165;;8;42392672;42393447;775;0
18838;ENSG00000254180;;8;91546839;91632298;85459;0
18839;ENSG00000254184;TYW1B;7;72023729;72298777;275048;0
18840;ENSG00000254213;;8;74189599;74190281;682;0
18841;ENSG00000254221;PCDHGB1;5;140729828;140892546;162718;1
18842;ENSG00000254226;;5;151329132;151650009;320877;0
18843;ENSG00000254231;;8;87345503;87355543;10040;0
18844;ENSG00000254238;;8;75938663;75941695;3032;0
18845;ENSG00000254245;PCDHGA3;5;140723601;140892546;168945;0
18846;ENSG00000254266;;8;79338338;79470738;132400;0
18847;ENSG00000254270;ERHP1;7;139218986;139219295;309;0
18848;ENSG00000254281;;8;103991013;104012412;21399;0
18849;ENSG00000254305;MRPL9P1;8;77515475;77516087;612;1
18850;ENSG00000254338;;8;144499849;144501320;1471;0
18851;ENSG00000254343;;8;121064419;121068440;4021;0
18852;ENSG00000254348;;8;48100928;48101183;255;0
18853;ENSG00000254349;;8;75512010;75735548;223538;0
18854;ENSG00000254363;;5;139536904;139552636;15732;0
18855;ENSG00000254370;;8;28273041;28277572;4531;0
18856;ENSG00000254377;LINC00966;8;65285885;65296344;10459;0
18857;ENSG00000254389;RHPN1-AS1;8;144448801;144450718;1917;0
18858;ENSG00000254402;LRRC24;8;145747761;145752416;4655;0
18859;ENSG00000254473;;9;86322509;86328293;5784;0
18860;ENSG00000254507;;8;11860909;11861591;682;0
18861;ENSG00000254556;;8;10994408;10996117;1709;0
18862;ENSG00000254615;;8;107282372;107285127;2755;0
18863;ENSG00000254690;;8;145538253;145538801;548;0
18864;ENSG00000254715;OR7E154P;8;7562704;7564413;1709;0
18865;ENSG00000254876;;9;100000731;100059596;58865;0
18866;ENSG00000254893;;5;75465911;75470171;4260;0
18867;ENSG00000254936;;8;10980891;10983574;2683;0
18868;ENSG00000254973;;8;144840323;144853992;13669;0
18869;ENSG00000254981;;8;38258054;38259201;1147;0
18870;ENSG00000254996;ANKHD1-EIF4EBP3;5;139781493;139929154;147661;1
18871;ENSG00000255000;;8;146273246;146274275;1029;0
18872;ENSG00000255046;;8;11655437;11660077;4640;0
18873;ENSG00000255052;FAM66D;8;11973291;12008698;35407;0
18874;ENSG00000255085;;8;145925738;145933902;8164;0
18875;ENSG00000255098;;8;11870545;11873043;2498;0
18876;ENSG00000255122;;8;12437796;12438572;776;0
18877;ENSG00000255145;;9;102648608;102668883;20275;0
18878;ENSG00000255182;;8;145721001;145730827;9826;0
18879;ENSG00000255224;;8;145132905;145134168;1263;0
18880;ENSG00000255310;;8;10965298;10967236;1938;0
18881;ENSG00000255366;;8;48102395;48104885;2490;0
18882;ENSG00000255389;;6;111921078;111923498;2420;0
18883;ENSG00000255408;PCDHA3;5;140180783;140391929;211146;0
18884;ENSG00000255487;;8;38133406;38134198;792;1
18885;ENSG00000255495;FAM85A;8;12051976;12053789;1813;0
18886;ENSG00000255559;ZNF252P-AS1;8;146228197;146231432;3235;0
18887;ENSG00000255622;;5;140535577;140538639;3062;0
18888;ENSG00000256453;DND1;5;140050379;140053171;2792;0
18889;ENSG00000256604;;7;102120179;102121095;916;0
18890;ENSG00000257093;KIAA1147;7;141356528;141401953;45425;0
18891;ENSG00000257335;MGAM;7;141607613;141806547;198934;1
18892;ENSG00000257743;;7;141811549;141922124;110575;0
18893;ENSG00000257923;CUX1;7;101458959;101927249;468290;0
18894;ENSG00000259366;;8;28913452;28914202;750;0
18895;ENSG00000259758;CASC7;8;141530255;141539600;9345;0
18896;ENSG00000259820;;8;135804263;135810515;6252;0
18897;ENSG00000259826;;7;39987121;39989354;2233;0
18898;ENSG00000259886;;X;152689210;152691934;2724;0
18899;ENSG00000259891;;8;141515912;141518142;2230;0
18900;ENSG00000259920;;7;130121332;130124233;2901;0
18901;ENSG00000259953;;9;114794835;114800010;5175;0
18902;ENSG00000260000;;6;101329347;101330863;1516;0
18903;ENSG00000260054;;7;6694495;6696063;1568;0
18904;ENSG00000260081;;X;152864795;152869808;5013;0
18905;ENSG00000260093;;8;9907995;9911764;3769;0
18906;ENSG00000260118;;X;67233312;67234743;1431;0
18907;ENSG00000260190;;9;139831621;139832440;819;0
18908;ENSG00000260193;;9;138999654;139001270;1616;0
18909;ENSG00000260197;;Y;21853827;21856492;2665;0
18910;ENSG00000260230;FRRS1L;9;111892573;111929571;36998;0
18911;ENSG00000260231;JHDM1D-AS1;7;139877061;139879440;2379;0
18912;ENSG00000260273;;6;109703998;109704869;871;0
18913;ENSG00000260317;;8;81453535;81455339;1804;1
18914;ENSG00000260336;;7;100737328;100741248;3920;0
18915;ENSG00000260368;;8;101925475;101926616;1141;0
18916;ENSG00000260398;;8;79518187;79521940;3753;0
18917;ENSG00000260412;;9;27937615;27944495;6880;1
18918;ENSG00000260418;;6;136656852;136657225;373;0
18919;ENSG00000260426;;7;155192617;155194477;1860;0
18920;ENSG00000260484;;8;54301261;54303432;2171;0
18921;ENSG00000260581;;5;151031836;151035010;3174;0
18922;ENSG00000260604;;6;3905144;3912213;7069;0
18923;ENSG00000260645;;6;81176675;81178797;2122;1
18924;ENSG00000260686;;5;122168051;122170228;2177;0
18925;ENSG00000260802;LINC00890;X;110754890;110765627;10737;0
18926;ENSG00000260822;;X;24563633;24568583;4950;0
18927;ENSG00000260831;;X;103197629;103202112;4483;0
18928;ENSG00000260838;;8;73859385;73862680;3295;0
18929;ENSG00000260841;;5;180211782;180214869;3087;1
18930;ENSG00000260871;;5;89684285;89685180;895;0
18931;ENSG00000260912;;9;19453207;19455171;1964;0
18932;ENSG00000260947;;9;33697457;33700984;3527;0
18933;ENSG00000260949;;8;37920399;37921309;910;0
18934;ENSG00000260996;;9;140188320;140190173;1853;0
18935;ENSG00000261003;;6;170723227;170728413;5186;0
18936;ENSG00000261015;;6;3025025;3027659;2634;1
18937;ENSG00000261019;;7;42940871;42942238;1367;1
18938;ENSG00000261071;;6;13614343;13615387;1044;0
18939;ENSG00000261087;;8;102179033;102181857;2824;0
18940;ENSG00000261094;;9;125699902;125702612;2710;0
18941;ENSG00000261101;;X;100882858;100883508;650;0
18942;ENSG00000261115;TMEM178B;7;140774032;141180180;406148;0
18943;ENSG00000261139;;8;145721763;145725663;3900;0
18944;ENSG00000261212;;X;140267420;140267773;353;0
18945;ENSG00000261215;;9;34661900;34666026;4126;0
18946;ENSG00000261220;;8;134585426;134586104;678;0
18947;ENSG00000261366;MANEA-AS1;6;96023059;96025326;2267;0
18948;ENSG00000261409;;X;107963179;107968174;4995;0
18949;ENSG00000261420;;6;166796677;166798312;1635;0
18950;ENSG00000261447;;9;72287665;72288629;964;0
18951;ENSG00000261451;;8;10291182;10295822;4640;1
18952;ENSG00000261455;LINC01003;7;152160871;152162634;1763;0
18953;ENSG00000261462;;7;86738855;86740598;1743;0
18954;ENSG00000261534;;9;124577953;124581731;3778;0
18955;ENSG00000261542;;8;64128539;64130592;2053;0
18956;ENSG00000261568;;6;22221010;22222624;1614;0
18957;ENSG00000261584;;6;26686469;26688192;1723;0
18958;ENSG00000261693;;8;143485013;143488389;3376;1
18959;ENSG00000261757;;5;142083347;142084986;1639;0
18960;ENSG00000261773;;X;153746164;153746955;791;0
18961;ENSG00000261839;;6;28104627;28107456;2829;1
18962;ENSG00000261934;PCDHGA9;5;140782520;140892546;110026;0
18963;ENSG00000261970;;6;80262511;80262877;366;0
18964;ENSG00000262096;PCDHB19P;5;140619518;140621864;2346;0
18965;ENSG00000262209;PCDHGB3;5;140749831;140892546;142715;0
18966;ENSG00000262576;PCDHGA4;5;140734768;140892546;157778;0
18967;ENSG00000263391;;6;24840195;24840293;98;0
18968;ENSG00000263432;RN7SL689P;5;122358184;122358478;294;0
18969;ENSG00000263597;MIR3936;5;131701182;131701291;109;0
18970;ENSG00000263660;;8;144397091;144397176;85;0
18971;ENSG00000264017;RN7SL336P;6;89800665;89800959;294;0
18972;ENSG00000264392;;X;119058424;119058513;89;0
18973;ENSG00000265393;;8;145737950;145739056;1106;0
18974;ENSG00000265806;MIR4292;9;139725409;139725475;66;0
18975;ENSG00000265817;FSBP;8;95390605;95449180;58575;0
18976;ENSG00000265826;;8;12280513;12280578;65;0
18977;ENSG00000266017;MIR4477B;9;68415308;68415388;80;0
18978;ENSG00000266017;MIR4477A;9;68415308;68415388;80;0
18979;ENSG00000266045;;5;75627662;75629781;2119;1
18980;ENSG00000266289;;8;104395306;104396082;776;0
18981;ENSG00000266680;;6;64280910;64282313;1403;0
18982;ENSG00000266896;;6;170170509;170172138;1629;0
18983;ENSG00000267064;UXT-AS1;X;47518232;47519776;1544;0
18984;ENSG00000267793;;Y;21760074;21760643;569;0
18985;ENSG00000267834;;9;131766781;131767277;496;0
18986;ENSG00000268066;FMR1-AS1;X;146990949;146993335;2386;0
18987;ENSG00000268211;;9;131062367;131064212;1845;0
18988;ENSG00000268358;EPB41L4A-AS2;5;111755280;111756310;1030;0
18989;ENSG00000268364;SMC5-AS1;9;72808913;72873782;64869;1
18990;ENSG00000268397;;5;180682720;180684578;1858;0
18991;ENSG00000268578;;9;45441273;45441542;269;0
18992;ENSG00000268707;;9;131932713;131933219;506;0
18993;ENSG00000269293;ZSCAN16-AS1;6;28089573;28105071;15498;0
18994;ENSG00000269337;;9;70646589;70648956;2367;1
18995;ENSG00000269396;;7;302918;304070;1152;0
18996;ENSG00000269781;;7;6522922;6524873;1951;0
18997;ENSG00000269904;MAP2K4P1;X;72744111;72782921;38810;0
18998;ENSG00000269918;;8;10962201;10964214;2013;0
18999;ENSG00000269929;;9;96938740;96940174;1434;0
19000;ENSG00000269979;;9;125086887;125087594;707;0
19001;ENSG00000269988;;9;130870860;130871604;744;0
19002;ENSG00000269994;;9;89623370;89657041;33671;0
19003;ENSG00000270012;;X;49129517;49132231;2714;0
19004;ENSG00000270021;;5;134734970;134736986;2016;0
19005;ENSG00000270067;;5;112229030;112229698;668;0
19006;ENSG00000270069;;X;45604639;45629677;25038;0
19007;ENSG00000270074;LINC00965;8;12270336;12271882;1546;0
19008;ENSG00000270076;;8;11060474;11061180;706;0
19009;ENSG00000270133;;5;93947611;93953827;6216;0
19010;ENSG00000270157;;7;141362722;141363646;924;0
19011;ENSG00000270177;;5;133562101;133563518;1417;0
19012;ENSG00000270189;;X;53198279;53200096;1817;1
19013;ENSG00000270223;;X;73229224;73231303;2079;0
19014;ENSG00000270237;;5;137081340;137081840;500;0
19015;ENSG00000270332;;9;106842305;106855354;13049;0
19016;ENSG00000270346;;6;3020388;3022984;2596;0
19017;ENSG00000270362;HMGN3-AS1;6;79943435;79946514;3079;0
19018;ENSG00000270419;CAHM;6;163834097;163834992;895;1
19019;ENSG00000270504;;6;3751345;3754105;2760;0
19020;ENSG00000270604;HCG17;6;30201816;30293911;92095;0
19021;ENSG00000270638;;6;146056706;146058354;1648;0
19022;ENSG00000270655;;6;143707718;143708546;828;0
19023;ENSG00000270755;;9;132806992;132807360;368;0
19024;ENSG00000270810;;7;128327342;128327926;584;0
19025;ENSG00000270823;;7;130135635;130138268;2633;0
19026;ENSG00000270923;TAS2R6;7;141487615;141488440;825;0
19027;ENSG00000270933;;7;25988277;25989023;746;0
19028;ENSG00000270949;;6;160529406;160532536;3130;0
19029;ENSG00000270953;;7;130147501;130148123;622;0
19030;ENSG00000270988;;8;1922984;1923480;496;1
19031;ENSG00000271043;MTRNR2L2;5;79945819;79946855;1036;0
19032;ENSG00000271086;NAMA;9;102117619;102139522;21903;0
19033;ENSG00000271122;;7;35734824;35739023;4199;0
19034;ENSG00000271133;;7;20367922;20371370;3448;0
19035;ENSG00000271147;;X;101854440;101969599;115159;0
19036;ENSG00000271155;;9;98268517;98269918;1401;0
19037;ENSG00000271167;LINC01109;8;77316293;77319373;3080;0
19038;ENSG00000271234;;6;170606964;170607463;499;0
19039;ENSG00000271265;;6;157095351;157095796;445;1
19040;ENSG00000271344;;7;128330505;128331771;1266;0
19041;ENSG00000271414;;7;135335720;135336164;444;0
19042;ENSG00000271430;;X;73420064;73461983;41919;0
19043;ENSG00000271533;;X;73429811;73433495;3684;0
19044;ENSG00000271551;;6;157097494;157098211;717;1
19045;ENSG00000271553;;7;128307097;128308210;1113;0
19046;ENSG00000271659;;9;98276327;98276802;475;0
19047;ENSG00000271698;;8;145576888;145579269;2381;0
19048;ENSG00000271727;;6;711533;750729;39196;0
19049;ENSG00000271730;;6;109319685;109320328;643;0
19050;ENSG00000271734;;6;108351453;108351922;469;0
19051;ENSG00000271743;;8;6473125;6474719;1594;0
19052;ENSG00000271754;;6;43486918;43487462;544;0
19053;ENSG00000271755;;6;27371789;27374743;2954;0
19054;ENSG00000271789;;6;111618329;111619713;1384;0
19055;ENSG00000271795;;5;150889014;150892330;3316;0
19056;ENSG00000271815;;5;74659585;74660067;482;1
19057;ENSG00000271824;;5;135527156;135528822;1666;0
19058;ENSG00000271830;;8;104493494;104493847;353;0
19059;ENSG00000271833;;9;130129049;130129676;627;0
19060;ENSG00000271860;;6;98264585;98847748;583163;0
19061;ENSG00000271862;;5;82345195;82346783;1588;1
19062;ENSG00000271869;;8;30013346;30013748;402;0
19063;ENSG00000271871;;5;141331984;141332940;956;0
19064;ENSG00000271882;;8;102220376;102220786;410;0
19065;ENSG00000271888;;6;15244154;15245231;1077;0
19066;ENSG00000271904;;5;87729709;87794514;64805;0
19067;ENSG00000271911;;6;761675;780648;18973;0
19068;ENSG00000271912;;8;144683416;144685394;1978;0
19069;ENSG00000271913;;6;159409210;159485957;76747;0
19070;ENSG00000271918;;5;115419504;115421113;1609;0
19071;ENSG00000271927;;8;6503576;6506025;2449;0
19072;ENSG00000271948;;8;17082473;17082978;505;0
19073;ENSG00000271966;;8;68256210;68257322;1112;0
19074;ENSG00000271967;;6;71306141;71306683;542;0
19075;ENSG00000271971;;8;94727606;94728341;735;0
19076;ENSG00000271975;;8;125318430;125320617;2187;0
19077;ENSG00000271978;;6;5031990;5054657;22667;0
19078;ENSG00000272005;;8;424455;427966;3511;0
19079;ENSG00000272008;;6;87860877;87865003;4126;0
19080;ENSG00000272009;;6;28046570;28048908;2338;0
19081;ENSG00000272010;;8;66504085;66504707;622;0
19082;ENSG00000272024;;8;52862844;52863250;406;0
19083;ENSG00000272037;;8;103268620;103270049;1429;0
19084;ENSG00000272040;;5;74904642;74905808;1166;0
19085;ENSG00000272047;GTF2H5;6;158589384;158620376;30992;0
19086;ENSG00000272066;;X;82761031;82764222;3191;0
19087;ENSG00000272070;;5;140705777;140708924;3147;1
19088;ENSG00000272072;;7;106833004;106833745;741;0
19089;ENSG00000272076;;8;52722670;52723241;571;0
19090;ENSG00000272092;;8;38239882;38240979;1097;0
19091;ENSG00000272097;;6;10743557;10747896;4339;0
19092;ENSG00000272102;;6;105721095;105721635;540;0
19093;ENSG00000272108;;5;140498262;140500347;2085;0
19094;ENSG00000272112;;5;151104392;151104917;525;0
19095;ENSG00000272128;;8;37956989;37957449;460;0
19096;ENSG00000272129;;6;81065141;81066576;1435;0
19097;ENSG00000272137;;6;80270849;80271319;470;0
19098;ENSG00000272142;;6;5030206;5043683;13477;0
19099;ENSG00000272155;;8;66626569;66627013;444;0
19100;ENSG00000272157;;8;24814135;24814624;489;0
19101;ENSG00000272159;;8;38265566;38266260;694;0
19102;ENSG00000272163;;8;24769678;24772230;2552;0
19103;ENSG00000272168;CASC15;6;21665003;22214734;549731;0
19104;ENSG00000272170;;6;43042069;43042477;408;0
19105;ENSG00000272172;;8;144372569;144372791;222;0
19106;ENSG00000272189;;6;136871799;136873692;1893;0
19107;ENSG00000272192;;8;66754987;66755566;579;0
19108;ENSG00000272223;;6;43001635;43002143;508;0
19109;ENSG00000272232;;9;73194081;73194377;296;0
19110;ENSG00000272233;;8;42409933;42410336;403;0
19111;ENSG00000272256;;8;29940274;29940983;709;0
19112;ENSG00000272267;;8;9412656;9414030;1374;0
19113;ENSG00000272273;;6;30710706;30711369;663;0
19114;ENSG00000272277;;6;3068279;3069128;849;0
19115;ENSG00000272288;;6;34664094;34665247;1153;0
19116;ENSG00000272293;;8;400714;401343;629;0
19117;ENSG00000272294;;X;82766304;82767135;831;0
19118;ENSG00000272316;;6;58234838;58240189;5351;0
19119;ENSG00000272320;;6;3311896;3313884;1988;0
19120;ENSG00000272321;;8;99448897;99451518;2621;0
19121;ENSG00000272325;NUDT3;6;34247456;34360451;112995;0
19122;ENSG00000272327;;8;32623643;32625477;1834;0
19123;ENSG00000272338;;8;33218361;33218933;572;0
19124;ENSG00000272341;;6;16764577;16767114;2537;0
19125;ENSG00000272343;;8;57135247;57135732;485;0
19126;ENSG00000272345;;6;24701135;24702021;886;0
19127;ENSG00000272356;;6;111630406;111634720;4314;0
19128;ENSG00000272361;;7;16633253;16633849;596;0
19129;ENSG00000272367;;5;86672073;86672997;924;0
19130;ENSG00000272374;;6;35188147;35192407;4260;0
19131;ENSG00000272375;;8;30054920;30055564;644;0
19132;ENSG00000272377;;7;96251318;96293650;42332;0
19133;ENSG00000272379;;6;13290250;13290722;472;0
19134;ENSG00000272389;;5;112233720;112234068;348;0
19135;ENSG00000272425;;8;82187634;82189805;2171;0
19136;ENSG00000272459;;5;176981825;176982365;540;0
19137;ENSG00000272462;;6;25992890;26002003;9113;0
19138;ENSG00000272468;;6;27090436;27091000;564;0
19139;ENSG00000272476;;6;108278617;108281190;2573;0
19140;ENSG00000272479;;8;40377084;40377677;593;1
19141;ENSG00000272501;;6;31162977;31165814;2837;1
19142;ENSG00000272505;;8;10344317;10347176;2859;1
19143;ENSG00000272509;;8;95896837;95897298;461;0
19144;ENSG00000272514;;6;88117701;88174183;56482;0
19145;ENSG00000272540;;6;30690882;30691654;772;0
19146;ENSG00000272541;;6;58182169;58182746;577;0
19147;ENSG00000272549;;6;168067520;168079950;12430;0
19148;ENSG00000272556;;7;45854201;45854862;661;0
19149;ENSG00000272568;;7;29019583;29052983;33400;0
19150;ENSG00000272593;;9;131153740;131154295;555;0
19151;ENSG00000272604;;7;105211530;105214107;2577;0
19152;ENSG00000272619;;7;143060992;143061322;330;0
19153;ENSG00000272655;;7;44053161;44058769;5608;0
19154;ENSG00000272661;;7;150937485;150938058;573;0
19155;ENSG00000272686;;7;123389122;123391220;2098;0
19156;ENSG00000272696;;9;131078616;131079188;572;0
19157;ENSG00000272732;;7;7589735;7592071;2336;0
19158;ENSG00000272782;;7;97937257;97939753;2496;0
19159;ENSG00000272812;;8;183119;183692;573;0
19160;ENSG00000272831;;7;66204816;66205372;556;0
19161;ENSG00000272841;;6;161411350;161413374;2024;0
19162;ENSG00000272842;;9;19371384;19371943;559;0
19163;ENSG00000272843;;7;72394956;72395663;707;0
19164;ENSG00000272866;;9;5351796;5352410;614;0
19165;ENSG00000272869;;5;112196885;112228776;31891;0
19166;ENSG00000272871;;9;14588795;14590063;1268;1
19167;ENSG00000272894;;7;7592093;7606627;14534;0
19168;ENSG00000272899;;7;128510821;128512098;1277;0
19169;ENSG00000272905;;7;32885006;32885673;667;0
19170;ENSG00000272918;;7;104743285;104745930;2645;0
19171;ENSG00000272950;;7;97952165;97952742;577;0
19172;ENSG00000272953;;7;5465401;5466032;631;0
19173;ENSG00000272960;;9;131067440;131067794;354;0
19174;ENSG00000272980;;6;167412893;167552629;139736;0
19175;ENSG00000273014;;7;32798494;32798965;471;0
19176;ENSG00000273055;;7;107582561;107583185;624;0
19177;ENSG00000273056;;9;7786105;7786688;583;0
19178;ENSG00000273061;;9;4676600;4679502;2902;0
19179;ENSG00000273066;;9;139693675;139704494;10819;0
19180;ENSG00000273081;;7;140702410;140704649;2239;0
19181;ENSG00000273084;;7;5468362;5469303;941;0
19182;ENSG00000273117;;7;155087628;155089251;1623;0
19183;ENSG00000273142;;7;66367844;66371284;3440;0
19184;ENSG00000273151;;7;919427;926184;6757;0
19185;ENSG00000273186;;9;131193877;131194285;408;0
19186;ENSG00000273219;;7;135389285;135389589;304;0
19187;ENSG00000273226;;9;19375449;19375994;545;0
19188;ENSG00000273230;;7;1504133;1507158;3025;0
19189;ENSG00000273237;;7;26213153;26214565;1412;0
19190;ENSG00000273249;;9;136997364;137000894;3530;0
19191;ENSG00000273270;;7;128164070;128171123;7053;0
19192;ENSG00000273281;;9;131068269;131068629;360;0
19193;ENSG00000273297;;7;134101042;134117205;16163;0
19194;ENSG00000273314;;7;148393559;148395756;2197;0
19195;ENSG00000273320;;7;105925926;105926772;846;0
19196;ENSG00000273329;;7;129244389;129251471;7082;0
19197;ENSG00000273344;PAXIP1-AS1;7;154795158;154797413;2255;0
19198;ENSG00000273381;;9;93968457;93972581;4124;1
19199;ENSG00000273391;;7;139043778;139044312;534;0
19200;ENSG00000273399;;9;14586767;14587324;557;0
19201;ENSG00000273402;;8;187045;187669;624;0
19202;ENSG00000273419;;7;149555489;149559581;4092;0
19203;ENSG00000273432;;7;43991509;44058750;67241;0
19204;ENSG00000273448;;7;66798034;66799370;1336;0
19205;ENSG00000273473;;9;137033891;137034462;571;0
19206;ENSG00000273477;;7;16127152;16129275;2123;0
19207;ENSG00000273489;;7;131178723;131182453;3730;0
