"","ensembl_gene_id","hgnc_symbol","chromosome_name","start_position","end_position","gene_length"
"1","ENSG00000000003","TSPAN6","X",99883667,99894988,11321
"2","ENSG00000000419","DPM1","20",49551404,49575092,23688
"3","ENSG00000000457","SCYL3","1",169818772,169863408,44636
"4","ENSG00000000460","C1orf112","1",169631245,169823221,191976
"5","ENSG00000000971","CFH","1",196621008,196716634,95626
"6","ENSG00000001036","FUCA2","6",143815948,143832827,16879
"7","ENSG00000001084","GCLC","6",53362139,53481768,119629
"8","ENSG00000001167","NFYA","6",41040684,41067715,27031
"9","ENSG00000001460","STPG1","1",24683489,24743424,59935
"10","ENSG00000001461","NIPAL3","1",24742284,24799466,57182
"11","ENSG00000001497","LAS1L","X",64732462,64754655,22193
"12","ENSG00000001561","ENPP4","6",46097730,46114436,16706
"13","ENSG00000001626","CFTR","7",117105838,117356025,250187
"14","ENSG00000001629","ANKIB1","7",91875548,92030698,155150
"15","ENSG00000001630","CYP51A1","7",91741465,91772266,30801
"16","ENSG00000001631","KRIT1","7",91828283,91875480,47197
"17","ENSG00000002016","RAD52","12",1021243,1099219,77976
"18","ENSG00000002330","BAD","11",64037302,64052176,14874
"19","ENSG00000002549","LAP3","4",17578815,17609595,30780
"20","ENSG00000002586","CD99","X",2609220,2659350,50130
"21","ENSG00000002587","HS3ST1","4",11394774,11431389,36615
"22","ENSG00000002746","HECW1","7",43152198,43605600,453402
"23","ENSG00000002822","MAD1L1","7",1855429,2272878,417449
"24","ENSG00000002834","LASP1","17",37026112,37078023,51911
"25","ENSG00000002919","SNX11","17",46180719,46200436,19717
"26","ENSG00000003056","M6PR","12",9092959,9102551,9592
"27","ENSG00000003096","KLHL13","X",117031776,117251303,219527
"28","ENSG00000003137","CYP26B1","2",72356367,72375167,18800
"29","ENSG00000003147","ICA1","7",8152814,8302317,149503
"30","ENSG00000003249","DBNDD1","16",90071273,90086536,15263
"31","ENSG00000003393","ALS2","2",202565277,202645912,80635
"32","ENSG00000003402","CFLAR","2",201980827,202041410,60583
"33","ENSG00000003436","TFPI","2",188328957,188430487,101530
"34","ENSG00000003509","NDUFAF7","2",37458774,37480546,21772
"35","ENSG00000003756","RBM5","3",50126341,50156454,30113
"36","ENSG00000003987","MTMR7","8",17155539,17271037,115498
"37","ENSG00000003989","SLC7A2","8",17354597,17428082,73485
"38","ENSG00000004059","ARF5","7",127228399,127231759,3360
"39","ENSG00000004139","SARM1","17",26691378,26728065,36687
"40","ENSG00000004142","POLDIP2","17",26673659,26684545,10886
"41","ENSG00000004399","PLXND1","3",129274018,129325661,51643
"42","ENSG00000004455","AK2","1",33473585,33546597,73012
"43","ENSG00000004478","FKBP4","12",2904119,2914576,10457
"44","ENSG00000004487","KDM1A","1",23345941,23410182,64241
"45","ENSG00000004534","RBM6","3",49977440,50137478,160038
"46","ENSG00000004660","CAMKK1","17",3763609,3798185,34576
"47","ENSG00000004700","RECQL","12",21621845,21654603,32758
"48","ENSG00000004766","CCDC132","7",92861653,92988338,126685
"49","ENSG00000004777","ARHGAP33","19",36265434,36279724,14290
"50","ENSG00000004779","NDUFAB1","16",23592323,23607677,15354
"51","ENSG00000004799","PDK4","7",95212811,95225803,12992
"52","ENSG00000004838","ZMYND10","3",50378541,50384283,5742
"53","ENSG00000004864","SLC25A13","7",95749532,95951459,201927
"54","ENSG00000004866","ST7","7",116593292,116870157,276865
"55","ENSG00000004897","CDC27","17",45195069,45266788,71719
"56","ENSG00000004948","CALCR","7",93053799,93204042,150243
"57","ENSG00000004961","HCCS","X",11129421,11141198,11777
"58","ENSG00000004975","DVL2","17",7128660,7137864,9204
"59","ENSG00000005007","UPF1","19",18942747,18979045,36298
"60","ENSG00000005020","SKAP2","7",26706681,27034858,328177
"61","ENSG00000005022","SLC25A5","X",118602363,118605282,2919
"62","ENSG00000005059","CCDC109B","4",110481361,110609874,128513
"63","ENSG00000005075","POLR2J","7",102113565,102119354,5789
"64","ENSG00000005100","DHX33","17",5344232,5372380,28148
"65","ENSG00000005102","MEOX1","17",41717756,41739322,21566
"66","ENSG00000005108","THSD7A","7",11409984,11871824,461840
"67","ENSG00000005156","LIG3","17",33307513,33332083,24570
"68","ENSG00000005175","RPAP3","12",48057070,48099844,42774
"69","ENSG00000005187","ACSM3","16",20621565,20808903,187338
"70","ENSG00000005189","","16",20817751,20860987,43236
"71","ENSG00000005194","CIAPIN1","16",57462081,57481440,19359
"72","ENSG00000005206","SPPL2B","19",2328614,2355099,26485
"73","ENSG00000005238","FAM214B","9",35104109,35116338,12229
"74","ENSG00000005243","COPZ2","17",46103533,46115392,11859
"75","ENSG00000005249","PRKAR2B","7",106685094,106802256,117162
"76","ENSG00000005302","MSL3","X",11776278,11793870,17592
"77","ENSG00000005339","CREBBP","16",3775055,3930727,155672
"78","ENSG00000005379","BZRAP1","17",56378592,56406152,27560
"79","ENSG00000005436","GCFC2","2",75879126,75938115,58989
"80","ENSG00000005448","WDR54","2",74648805,74652882,4077
"81","ENSG00000005469","CROT","7",86974997,87029111,54114
"82","ENSG00000005471","ABCB4","7",87031013,87109751,78738
"83","ENSG00000005483","KMT2E","7",104654626,104754808,100182
"84","ENSG00000005486","RHBDD2","7",75471920,75518244,46324
"85","ENSG00000005513","SOX8","16",1031808,1036979,5171
"86","ENSG00000005700","IBTK","6",82879700,82957471,77771
"87","ENSG00000005801","ZNF195","11",3360491,3400448,39957
"88","ENSG00000005810","MYCBP2","13",77618792,77901185,282393
"89","ENSG00000005812","FBXL3","13",77566740,77601330,34590
"90","ENSG00000005882","PDK2","17",48172101,48189516,17415
"91","ENSG00000005884","ITGA3","17",48133332,48167845,34513
"92","ENSG00000005889","ZFX","X",24167290,24234372,67082
"93","ENSG00000005893","LAMP2","X",119561682,119603220,41538
"94","ENSG00000005955","GGNBP2","17",34900737,34946278,45541
"95","ENSG00000005961","ITGA2B","17",42449548,42466873,17325
"96","ENSG00000005981","ASB4","7",95107756,95169544,61788
"97","ENSG00000006007","GDE1","16",19513015,19533467,20452
"98","ENSG00000006015","C19orf60","19",18699495,18703146,3651
"99","ENSG00000006025","OSBPL7","17",45884738,45899200,14462
"100","ENSG00000006042","TMEM98","17",31254928,31272124,17196
"101","ENSG00000006062","MAP3K14","17",43340488,43394414,53926
"102","ENSG00000006071","ABCC8","11",17414432,17498449,84017
"103","ENSG00000006114","SYNRG","17",35874900,35969544,94644
"104","ENSG00000006118","TMEM132A","11",60691935,60704631,12696
"105","ENSG00000006125","AP2B1","17",33905065,34053436,148371
"106","ENSG00000006128","TAC1","7",97361220,97369784,8564
"107","ENSG00000006194","ZNF263","16",3313743,3351401,37658
"108","ENSG00000006210","CX3CL1","16",57406370,57418960,12590
"109","ENSG00000006282","SPATA20","17",48620419,48633213,12794
"110","ENSG00000006283","CACNA1G","17",48638429,48704835,66406
"111","ENSG00000006327","TNFRSF12A","16",3068446,3072384,3938
"112","ENSG00000006432","MAP3K9","14",71189243,71276251,87008
"113","ENSG00000006451","RALA","7",39663082,39747723,84641
"114","ENSG00000006453","BAIAP2L1","7",97920963,98030380,109417
"115","ENSG00000006459","KDM7A","7",139784546,139876835,92289
"116","ENSG00000006468","ETV1","7",13930853,14031050,100197
"117","ENSG00000006530","AGK","7",141250989,141355044,104055
"118","ENSG00000006534","ALDH3B1","11",67776048,67796744,20696
"119","ENSG00000006576","PHTF2","7",77428122,77586818,158696
"120","ENSG00000006607","FARP2","2",242295658,242434256,138598
"121","ENSG00000006625","GGCT","7",30536237,30591095,54858
"122","ENSG00000006634","DBF4","7",87505531,87538856,33325
"123","ENSG00000006652","IFRD1","7",112063023,112121072,58049
"124","ENSG00000006695","COX10","17",13972813,14111994,139181
"125","ENSG00000006704","GTF2IRD1","7",73868120,74016931,148811
"126","ENSG00000006712","PAF1","19",39876492,39881835,5343
"127","ENSG00000006715","VPS41","7",38762563,38971994,209431
"128","ENSG00000006740","ARHGAP44","17",12692856,12894960,202104
"129","ENSG00000006744","ELAC2","17",12895708,12921504,25796
"130","ENSG00000006756","ARSD","X",2822011,2847392,25381
"131","ENSG00000006757","PNPLA4","X",7866288,7895780,29492
"132","ENSG00000006831","ADIPOR2","12",1797740,1897844,100104
"133","ENSG00000006837","CDKL3","5",133541305,133706738,165433
"134","ENSG00000007047","MARK4","19",45582546,45808541,225995
"135","ENSG00000007062","PROM1","4",15964699,16086001,121302
"136","ENSG00000007080","CCDC124","19",18043825,18054800,10975
"137","ENSG00000007168","PAFAH1B1","17",2496504,2588909,92405
"138","ENSG00000007202","KIAA0100","17",26941458,26972472,31014
"139","ENSG00000007237","GAS7","17",9813926,10101868,287942
"140","ENSG00000007255","TRAPPC6A","19",45666186,45681495,15309
"141","ENSG00000007341","ST7L","1",113066140,113163447,97307
"142","ENSG00000007350","TKTL1","X",153524024,153558700,34676
"143","ENSG00000007372","PAX6","11",31806340,31839509,33169
"144","ENSG00000007376","RPUSD1","16",834974,838397,3423
"145","ENSG00000007384","RHBDF1","16",108058,126354,18296
"146","ENSG00000007392","LUC7L","16",238968,279462,40494
"147","ENSG00000007402","CACNA2D2","3",50400233,50541675,141442
"148","ENSG00000007516","BAIAP3","16",1383602,1399439,15837
"149","ENSG00000007520","TSR3","16",1399241,1401912,2671
"150","ENSG00000007541","PIGQ","16",616995,634136,17141
"151","ENSG00000007545","CRAMP1L","16",1662326,1727909,65583
"152","ENSG00000007866","TEAD3","6",35441374,35464853,23479
"153","ENSG00000007923","DNAJC11","1",6694228,6761984,67756
"154","ENSG00000007944","MYLIP","6",16129356,16148479,19123
"155","ENSG00000007968","E2F2","1",23832922,23857712,24790
"156","ENSG00000008018","PSMB1","6",170844205,170862429,18224
"157","ENSG00000008056","SYN1","X",47431303,47479252,47949
"158","ENSG00000008083","JARID2","6",15246527,15522252,275725
"159","ENSG00000008086","CDKL5","X",18443703,18671749,228046
"160","ENSG00000008118","CAMK1G","1",209757062,209787283,30221
"161","ENSG00000008130","NADK","1",1682671,1711896,29225
"162","ENSG00000008196","TFAP2B","6",50786436,50815326,28890
"163","ENSG00000008226","DLEC1","3",38080696,38165516,84820
"164","ENSG00000008256","CYTH3","7",6201407,6312275,110868
"165","ENSG00000008277","ADAM22","7",87563458,87832204,268746
"166","ENSG00000008282","SYPL1","7",105730949,105753022,22073
"167","ENSG00000008283","CYB561","17",61509665,61523739,14074
"168","ENSG00000008294","SPAG9","17",49039535,49198226,158691
"169","ENSG00000008300","CELSR3","3",48673902,48700348,26446
"170","ENSG00000008311","AASS","7",121715701,121784334,68633
"171","ENSG00000008323","PLEKHG6","12",6419602,6437672,18070
"172","ENSG00000008324","SS18L2","3",42623332,42636606,13274
"173","ENSG00000008382","MPND","19",4343524,4360083,16559
"174","ENSG00000008394","MGST1","12",16500076,16762193,262117
"175","ENSG00000008405","CRY1","12",107385142,107487607,102465
"176","ENSG00000008513","ST3GAL1","8",134467091,134584183,117092
"177","ENSG00000008710","PKD1","16",2138711,2185899,47188
"178","ENSG00000008735","MAPK8IP2","22",51039114,51052409,13295
"179","ENSG00000008838","MED24","17",38175350,38217468,42118
"180","ENSG00000008853","RHOBTB2","8",22844930,22877712,32782
"181","ENSG00000008869","HEATR5B","2",37195526,37311485,115959
"182","ENSG00000008952","SEC62","3",169684423,169716161,31738
"183","ENSG00000008988","RPS20","8",56979854,56987069,7215
"184","ENSG00000009307","CSDE1","1",115259534,115301297,41763
"185","ENSG00000009335","UBE3C","7",156931607,157062066,130459
"186","ENSG00000009413","REV3L","6",111620234,111804918,184684
"187","ENSG00000009694","TENM1","X",123509753,124097666,587913
"188","ENSG00000009709","PAX7","1",18957500,19075360,117860
"189","ENSG00000009780","FAM76A","1",28052490,28089633,37143
"190","ENSG00000009830","POMT2","14",77741299,77787227,45928
"191","ENSG00000009844","VTA1","6",142468367,142545826,77459
"192","ENSG00000009954","BAZ1B","7",72854728,72936608,81880
"193","ENSG00000010017","RANBP9","6",13621730,13711796,90066
"194","ENSG00000010072","SPRTN","1",231472850,231490769,17919
"195","ENSG00000010165","METTL13","1",171750788,171783163,32375
"196","ENSG00000010219","DYRK4","12",4671370,4723325,51955
"197","ENSG00000010244","ZNF207","17",30677136,30708905,31769
"198","ENSG00000010256","UQCRC1","3",48636435,48648409,11974
"199","ENSG00000010270","STARD3NL","7",38217824,38270272,52448
"200","ENSG00000010278","CD9","12",6308881,6347425,38544
"201","ENSG00000010292","NCAPD2","12",6602522,6641121,38599
"202","ENSG00000010295","IFFO1","12",6647541,6665239,17698
"203","ENSG00000010318","PHF7","3",52444673,52457657,12984
"204","ENSG00000010322","NISCH","3",52489134,52527087,37953
"205","ENSG00000010361","FUZ","19",50310126,50320633,10507
"206","ENSG00000010404","IDS","X",148558521,148615470,56949
"207","ENSG00000010539","ZNF200","16",3272325,3286221,13896
"208","ENSG00000010610","CD4","12",6896024,6929974,33950
"209","ENSG00000010626","LRRC23","12",6982733,7023407,40674
"210","ENSG00000010704","HFE","6",26087509,26098571,11062
"211","ENSG00000010803","SCMH1","1",41492872,41707826,214954
"212","ENSG00000010810","FYN","6",111981535,112194655,213120
"213","ENSG00000010818","HIVEP2","6",143072604,143266338,193734
"214","ENSG00000011007","TCEB3","1",24069645,24088549,18904
"215","ENSG00000011009","LYPLA2","1",24117460,24122029,4569
"216","ENSG00000011021","CLCN6","1",11866207,11903201,36994
"217","ENSG00000011028","MRC2","17",60704762,60770958,66196
"218","ENSG00000011105","TSPAN9","12",3186521,3395730,209209
"219","ENSG00000011114","BTBD7","14",93703896,93799438,95542
"220","ENSG00000011132","APBA3","19",3750817,3761697,10880
"221","ENSG00000011143","MKS1","17",56282803,56296966,14163
"222","ENSG00000011198","ABHD5","3",43731605,43775863,44258
"223","ENSG00000011201","KAL1","X",8496915,8700227,203312
"224","ENSG00000011243","AKAP8L","19",15490859,15529952,39093
"225","ENSG00000011258","MBTD1","17",49254786,49337524,82738
"226","ENSG00000011260","UTP18","17",49337889,49375297,37408
"227","ENSG00000011275","RNF216","7",5659678,5821370,161692
"228","ENSG00000011295","TTC19","17",15902694,15948329,45635
"229","ENSG00000011304","PTBP1","19",797075,812327,15252
"230","ENSG00000011332","DPF1","19",38701646,38720354,18708
"231","ENSG00000011347","SYT7","11",61282785,61348620,65835
"232","ENSG00000011376","LARS2","3",45429998,45590913,160915
"233","ENSG00000011405","PIK3C2A","11",17099277,17229530,130253
"234","ENSG00000011422","PLAUR","19",44150247,44174699,24452
"235","ENSG00000011426","ANLN","7",36429415,36493400,63985
"236","ENSG00000011451","WIZ","19",15532319,15560762,28443
"237","ENSG00000011454","RABGAP1","9",125703112,125867145,164033
"238","ENSG00000011465","DCN","12",91539025,91576900,37875
"239","ENSG00000011478","QPCTL","19",46195741,46207247,11506
"240","ENSG00000011485","PPP5C","19",46850251,46896238,45987
"241","ENSG00000011523","CEP68","2",65283500,65314138,30638
"242","ENSG00000011566","MAP4K3","2",39476407,39664453,188046
"243","ENSG00000011638","TMEM159","16",21169698,21191937,22239
"244","ENSG00000012048","BRCA1","17",41196312,41277500,81188
"245","ENSG00000012061","ERCC1","19",45910591,45982086,71495
"246","ENSG00000012171","SEMA3B","3",50304990,50314977,9987
"247","ENSG00000012174","MBTPS2","X",21857754,21903542,45788
"248","ENSG00000012232","EXTL3","8",28457986,28613116,155130
"249","ENSG00000012660","ELOVL5","6",53132196,53213947,81751
"250","ENSG00000012817","KDM5D","Y",21865751,21906825,41074
"251","ENSG00000012822","CALCOCO1","12",54104903,54121529,16626
"252","ENSG00000012963","UBR7","14",93673401,93695561,22160
"253","ENSG00000012983","MAP4K5","14",50885219,51027844,142625
"254","ENSG00000013016","EHD3","2",31456880,31492313,35433
"255","ENSG00000013275","PSMC4","19",40476912,40487348,10436
"256","ENSG00000013288","MAN2B2","4",6576902,6625089,48187
"257","ENSG00000013297","CLDN11","3",170136653,170578169,441516
"258","ENSG00000013306","SLC25A39","17",42396993,42402238,5245
"259","ENSG00000013364","MVP","16",29831715,29859355,27640
"260","ENSG00000013374","NUB1","7",151038785,151075535,36750
"261","ENSG00000013375","PGM3","6",83870869,83903655,32786
"262","ENSG00000013392","RWDD2A","6",83903098,83908651,5553
"263","ENSG00000013441","CLK1","2",201717732,201729422,11690
"264","ENSG00000013503","POLR3B","12",106751436,106903976,152540
"265","ENSG00000013523","ANGEL1","14",77253588,77292589,39001
"266","ENSG00000013561","RNF14","5",141337893,141369856,31963
"267","ENSG00000013563","DNASE1L1","X",153629579,153640449,10870
"268","ENSG00000013573","DDX11","12",31226779,31257725,30946
"269","ENSG00000013583","HEBP1","12",13127798,13153207,25409
"270","ENSG00000013619","MAMLD1","X",149529689,149682448,152759
"271","ENSG00000013810","TACC3","4",1723227,1746898,23671
"272","ENSG00000014123","UFL1","6",96969471,97003152,33681
"273","ENSG00000014138","POLA2","11",65029233,65073060,43827
"274","ENSG00000014164","ZC3H3","8",144519825,144623623,103798
"275","ENSG00000014216","CAPN1","11",64948037,64979477,31440
"276","ENSG00000014641","MDH1","2",63815743,63834331,18588
"277","ENSG00000014824","SLC30A9","4",41992489,42092474,99985
"278","ENSG00000014914","MTMR11","1",149900543,149908791,8248
"279","ENSG00000014919","COX15","10",101471601,101491857,20256
"280","ENSG00000015133","CCDC88C","14",91737667,91884188,146521
"281","ENSG00000015153","YAF2","12",42550906,42632151,81245
"282","ENSG00000015171","ZMYND11","10",180405,300577,120172
"283","ENSG00000015475","BID","22",18216906,18257536,40630
"284","ENSG00000015479","MATR3","5",138609441,138667360,57919
"285","ENSG00000015532","XYLT2","17",48423453,48440499,17046
"286","ENSG00000015592","STMN4","8",27092840,27115937,23097
"287","ENSG00000015676","NUDCD3","7",44418720,44530479,111759
"288","ENSG00000016391","CHDH","3",53846362,53880417,34055
"289","ENSG00000016864","GLT8D1","3",52728505,52740048,11543
"290","ENSG00000017260","ATP2C1","3",130569439,130735556,166117
"291","ENSG00000017373","SRCIN1","17",36686251,36762183,75932
"292","ENSG00000017797","RALBP1","18",9475007,9538114,63107
"293","ENSG00000018189","RUFY3","4",71569921,71673032,103111
"294","ENSG00000018236","CNTN1","12",41086244,41466220,379976
"295","ENSG00000018408","WWTR1","3",149235022,149454501,219479
"296","ENSG00000018510","AGPS","2",178257372,178408564,151192
"297","ENSG00000018610","CXorf56","X",118672112,118699397,27285
"298","ENSG00000018625","ATP1A2","1",160085549,160113381,27832
"299","ENSG00000018699","TTC27","2",32853099,33046118,193019
"300","ENSG00000018869","ZNF582","19",56887413,56904914,17501
"301","ENSG00000019144","PHLDB1","11",118477155,118528741,51586
"302","ENSG00000019485","PRDM11","11",45115564,45247734,132170
"303","ENSG00000019505","SYT13","11",45261852,45307870,46018
"304","ENSG00000019549","SNAI2","8",49830249,49834299,4050
"305","ENSG00000019991","HGF","7",81328322,81399754,71432
"306","ENSG00000019995","ZRANB1","10",126630692,126676758,46066
"307","ENSG00000020129","NCDN","1",36023074,36032875,9801
"308","ENSG00000020256","ZFP64","20",50668202,50820847,152645
"309","ENSG00000020426","MNAT1","14",61201460,61436671,235211
"310","ENSG00000020577","SAMD4A","14",55033815,55260033,226218
"311","ENSG00000020922","MRE11A","11",94152895,94227074,74179
"312","ENSG00000021300","PLEKHB1","11",73357223,73373864,16641
"313","ENSG00000021355","SERPINB1","6",2832566,2842240,9674
"314","ENSG00000021488","SLC7A9","19",33321415,33360672,39257
"315","ENSG00000021574","SPAST","2",32288680,32382706,94026
"316","ENSG00000021645","NRXN3","14",78708734,80330762,1622028
"317","ENSG00000021762","OSBPL5","11",3108346,3187969,79623
"318","ENSG00000021776","AQR","15",35147732,35262040,114308
"319","ENSG00000021826","CPS1","2",211342406,211543831,201425
"320","ENSG00000022267","FHL1","X",135229559,135293518,63959
"321","ENSG00000022277","RTFDC1","20",55043647,55093943,50296
"322","ENSG00000022556","NLRP2","19",55464498,55512510,48012
"323","ENSG00000022567","SLC45A4","8",142217265,142318404,101139
"324","ENSG00000022840","RNF10","12",120971283,121015397,44114
"325","ENSG00000022976","ZNF839","14",102783714,102809044,25330
"326","ENSG00000023041","ZDHHC6","10",114190058,114206672,16614
"327","ENSG00000023171","GRAMD1B","11",123396344,123498482,102138
"328","ENSG00000023191","RNH1","11",494512,507300,12788
"329","ENSG00000023228","NDUFS1","2",206979541,207024327,44786
"330","ENSG00000023287","RB1CC1","8",53535016,53658403,123387
"331","ENSG00000023318","ERP44","9",102741461,102861322,119861
"332","ENSG00000023330","ALAS1","3",52232102,52248343,16241
"333","ENSG00000023516","AKAP11","13",42846289,42897396,51107
"334","ENSG00000023572","GLRX2","1",193065598,193075244,9646
"335","ENSG00000023608","SNAPC1","14",62229075,62263146,34071
"336","ENSG00000023697","DERA","12",16064106,16190220,126114
"337","ENSG00000023734","STRAP","12",16035325,16056412,21087
"338","ENSG00000023839","ABCC2","10",101542489,101611949,69460
"339","ENSG00000023892","DEF6","6",35265595,35289548,23953
"340","ENSG00000023902","PLEKHO1","1",150121373,150136916,15543
"341","ENSG00000023909","GCLM","1",94350761,94374966,24205
"342","ENSG00000024048","UBR2","6",42531800,42661242,129442
"343","ENSG00000024526","DEPDC1","1",68939835,68962904,23069
"344","ENSG00000024862","CCDC28A","6",139094657,139114456,19799
"345","ENSG00000025039","RRAGD","6",90074355,90121989,47634
"346","ENSG00000025156","HSF2","6",122720691,122754264,33573
"347","ENSG00000025293","PHF20","20",34359896,34538303,178407
"348","ENSG00000025423","HSD17B6","12",57145945,57181574,35629
"349","ENSG00000025434","NR1H3","11",47269851,47290396,20545
"350","ENSG00000025770","NCAPH2","22",50946645,50961901,15256
"351","ENSG00000025772","TOMM34","20",43570771,43589127,18356
"352","ENSG00000025796","SEC63","6",108188960,108279393,90433
"353","ENSG00000025800","KPNA6","1",32573639,32642169,68530
"354","ENSG00000026025","VIM","10",17270258,17279592,9334
"355","ENSG00000026036","RTEL1-TNFRSF6B","20",62290653,62330037,39384
"356","ENSG00000026103","FAS","10",90750414,90775542,25128
"357","ENSG00000026297","RNASET2","6",167342992,167370679,27687
"358","ENSG00000026508","CD44","11",35160417,35253949,93532
"359","ENSG00000026559","KCNG1","20",49620193,49639666,19473
"360","ENSG00000026652","AGPAT4","6",161551011,161695093,144082
"361","ENSG00000026950","BTN3A1","6",26402465,26415444,12979
"362","ENSG00000027001","MIPEP","13",24304328,24463558,159230
"363","ENSG00000027697","IFNGR1","6",137518621,137540586,21965
"364","ENSG00000027847","B4GALT7","5",177027101,177037348,10247
"365","ENSG00000028116","VRK2","2",58134786,58387055,252269
"366","ENSG00000028137","TNFRSF1B","1",12227060,12269285,42225
"367","ENSG00000028203","VEZT","12",95611522,95696566,85044
"368","ENSG00000028277","POU2F2","19",42590263,42700737,110474
"369","ENSG00000028310","BRD9","5",850406,892939,42533
"370","ENSG00000028528","SNX1","15",64386322,64438289,51967
"371","ENSG00000028839","TBPL1","6",134273308,134311570,38262
"372","ENSG00000029153","ARNTL2","12",27485787,27576241,90454
"373","ENSG00000029363","BCLAF1","6",136578001,136610989,32988
"374","ENSG00000029364","SLC39A9","14",69864732,69929105,64373
"375","ENSG00000029534","ANK1","8",41510739,41754280,243541
"376","ENSG00000029639","TFB1M","6",155578643,155635627,56984
"377","ENSG00000029725","RABEP1","17",5185558,5289129,103571
"378","ENSG00000029993","HMGB3","X",150148982,150159248,10266
"379","ENSG00000030066","NUP160","11",47799639,47870107,70468
"380","ENSG00000030110","BAK1","6",33540329,33548019,7690
"381","ENSG00000030419","IKZF2","2",213864429,214017151,152722
"382","ENSG00000030582","GRN","17",42422614,42430470,7856
"383","ENSG00000031003","FAM13B","5",137273649,137387650,114001
"384","ENSG00000031081","ARHGAP31","3",119013220,119139561,126341
"385","ENSG00000031691","CENPQ","6",49431091,49460820,29729
"386","ENSG00000031698","SARS","1",109756540,109780791,24251
"387","ENSG00000031823","RANBP3","19",5916150,5978153,62003
"388","ENSG00000032219","ARID4A","14",58765103,58840605,75502
"389","ENSG00000032389","TSSC1","2",3192696,3381653,188957
"390","ENSG00000032444","PNPLA6","19",7598890,7626650,27760
"391","ENSG00000032742","IFT88","13",21140585,21265503,124918
"392","ENSG00000033011","ALG1","16",5083703,5137380,53677
"393","ENSG00000033030","ZCCHC8","12",122957417,122985518,28101
"394","ENSG00000033050","ABCF2","7",150904923,150924316,19393
"395","ENSG00000033100","CHPF2","7",150929575,150935908,6333
"396","ENSG00000033122","LRRC7","1",70034081,70617628,583547
"397","ENSG00000033170","FUT8","14",65877310,66210839,333529
"398","ENSG00000033178","UBA6","4",68478370,68566897,88527
"399","ENSG00000033327","GAB2","11",77926343,78129394,203051
"400","ENSG00000033627","ATP6V0A1","17",40610862,40674629,63767
"401","ENSG00000033800","PIAS1","15",68346517,68483096,136579
"402","ENSG00000033867","SLC4A7","3",27414214,27525911,111697
"403","ENSG00000034053","APBA2","15",29129629,29410518,280889
"404","ENSG00000034063","UHRF1","19",4903092,4962165,59073
"405","ENSG00000034152","MAP2K3","17",21187984,21218552,30568
"406","ENSG00000034239","EFCAB1","8",49623348,49647870,24522
"407","ENSG00000034510","TMSB10","2",85132749,85133795,1046
"408","ENSG00000034533","ASTE1","3",130732719,130746493,13774
"409","ENSG00000034677","RNF19A","8",101269288,101348446,79158
"410","ENSG00000034693","PEX3","6",143771944,143811147,39203
"411","ENSG00000034713","GABARAPL2","16",75600249,75611779,11530
"412","ENSG00000035115","SH3YL1","2",217730,266398,48668
"413","ENSG00000035141","FAM136A","2",70523107,70529222,6115
"414","ENSG00000035403","VCL","10",75757872,75879918,122046
"415","ENSG00000035499","DEPDC1B","5",59892739,59996017,103278
"416","ENSG00000035664","DAPK2","15",64199235,64364232,164997
"417","ENSG00000035681","NSMAF","8",59496063,59572403,76340
"418","ENSG00000035687","ADSS","1",244571796,244615436,43640
"419","ENSG00000035862","TIMP2","17",76849059,76921469,72410
"420","ENSG00000035928","RFC1","4",39289076,39367995,78919
"421","ENSG00000036054","TBC1D23","3",99979844,100044095,64251
"422","ENSG00000036257","CUL3","2",225334867,225450110,115243
"423","ENSG00000036448","MYOM2","8",1993155,2113475,120320
"424","ENSG00000036530","CYP46A1","14",100150641,100193638,42997
"425","ENSG00000036549","ZZZ3","1",78028101,78149104,121003
"426","ENSG00000036565","SLC18A1","8",20002366,20040717,38351
"427","ENSG00000037042","TUBG2","17",40811323,40819024,7701
"428","ENSG00000037241","RPL26L1","5",172385732,172396774,11042
"429","ENSG00000037280","FLT4","5",180028506,180076624,48118
"430","ENSG00000037474","NSUN2","5",6599352,6633404,34052
"431","ENSG00000037637","FBXO42","1",16573334,16678949,105615
"432","ENSG00000037749","MFAP3","5",153418466,153600038,181572
"433","ENSG00000037757","MRI1","19",13875346,13885096,9750
"434","ENSG00000037897","METTL1","12",58162254,58166576,4322
"435","ENSG00000038002","AGA","4",178351924,178363657,11733
"436","ENSG00000038210","PI4K2B","4",25162263,25280714,118451
"437","ENSG00000038219","BOD1L1","4",13570362,13629347,58985
"438","ENSG00000038274","MAT2B","5",162930120,162946342,16222
"439","ENSG00000038295","TLL1","4",166794410,167025047,230637
"440","ENSG00000038358","EDC4","16",67906926,67918406,11480
"441","ENSG00000038382","TRIO","5",14143811,14532235,388424
"442","ENSG00000038427","VCAN","5",82767284,82878122,110838
"443","ENSG00000038532","CLEC16A","16",11038345,11276046,237701
"444","ENSG00000039123","SKIV2L2","5",54603588,54721409,117821
"445","ENSG00000039139","DNAH5","5",13690440,13944652,254212
"446","ENSG00000039319","ZFYVE16","5",79703832,79775169,71337
"447","ENSG00000039523","FAM65A","16",67552321,67580691,28370
"448","ENSG00000039560","RAI14","5",34656342,34832732,176390
"449","ENSG00000039650","PNKP","19",50364461,50371166,6705
"450","ENSG00000040199","PHLPP2","16",71671738,71758604,86866
"451","ENSG00000040275","SPDL1","5",169010638,169031782,21144
"452","ENSG00000040341","STAU2","8",74332604,74659943,327339
"453","ENSG00000040487","PQLC2","1",19638820,19655794,16974
"454","ENSG00000040531","CTNS","17",3539762,3564836,25074
"455","ENSG00000040608","RTN4R","22",20228938,20270769,41831
"456","ENSG00000040633","PHF23","17",7138347,7143041,4694
"457","ENSG00000040731","CDH10","5",24487209,24645087,157878
"458","ENSG00000040933","INPP4A","2",99061317,99210853,149536
"459","ENSG00000041353","RAB27B","18",52385091,52562747,177656
"460","ENSG00000041357","PSMA4","15",78832747,78841604,8857
"461","ENSG00000041515","MYO16","13",109248500,109860355,611855
"462","ENSG00000041802","LSG1","3",194361517,194393206,31689
"463","ENSG00000041880","PARP3","3",51976361,51982883,6522
"464","ENSG00000041982","TNC","9",117782806,117880536,97730
"465","ENSG00000041988","THAP3","1",6684926,6695646,10720
"466","ENSG00000042062","FAM65C","20",49202645,49308065,105420
"467","ENSG00000042088","TDP1","14",90421283,90511106,89823
"468","ENSG00000042286","AIFM2","10",71857979,71892690,34711
"469","ENSG00000042317","SPATA7","14",88851268,88936694,85426
"470","ENSG00000042429","MED17","11",93517393,93547861,30468
"471","ENSG00000042445","RETSAT","2",85569211,85581743,12532
"472","ENSG00000042493","CAPG","2",85621871,85645555,23684
"473","ENSG00000042753","AP2S1","19",47341393,47354249,12856
"474","ENSG00000042781","USH2A","1",215796236,216596738,800502
"475","ENSG00000043093","DCUN1D1","3",182655862,182703741,47879
"476","ENSG00000043143","JADE2","5",133860003,133918918,58915
"477","ENSG00000043355","ZIC2","13",100634026,100639018,4992
"478","ENSG00000043514","TRIT1","1",40306723,40349183,42460
"479","ENSG00000044090","CUL7","6",43005355,43021683,16328
"480","ENSG00000044115","CTNNA1","5",137946656,138270723,324067
"481","ENSG00000044446","PHKA2","X",18910418,19002716,92298
"482","ENSG00000044459","CNTLN","9",17134980,17503921,368941
"483","ENSG00000044524","EPHA3","3",89156674,89531284,374610
"484","ENSG00000044574","HSPA5","9",127997132,128003609,6477
"485","ENSG00000046604","DSG2","18",29078006,29128971,50965
"486","ENSG00000046647","GEMIN8","X",14026398,14048012,21614
"487","ENSG00000046651","OFD1","X",13752832,13787480,34648
"488","ENSG00000046653","GPM6B","X",13789150,13956757,167607
"489","ENSG00000046889","PREX2","8",68864353,69149265,284912
"490","ENSG00000047056","WDR37","10",1095478,1178237,82759
"491","ENSG00000047188","YTHDC2","5",112849380,112930982,81602
"492","ENSG00000047230","CTPS2","X",16606126,16731059,124933
"493","ENSG00000047249","ATP6V1H","8",54628117,54756118,128001
"494","ENSG00000047315","POLR2B","4",57843888,57897334,53446
"495","ENSG00000047346","FAM214A","15",52873514,53002014,128500
"496","ENSG00000047365","ARAP2","4",35949843,36246131,296288
"497","ENSG00000047410","TPR","1",186280784,186344825,64041
"498","ENSG00000047457","CP","3",148880197,148939842,59645
"499","ENSG00000047578","KIAA0556","16",27561454,27791690,230236
"500","ENSG00000047579","DTNBP1","6",15523032,15663289,140257
"501","ENSG00000047597","XK","X",37545012,37591383,46371
"502","ENSG00000047617","ANO2","12",5641035,6055398,414363
"503","ENSG00000047621","C12orf4","12",4596894,4647674,50780
"504","ENSG00000047634","SCML1","X",17755588,17773105,17517
"505","ENSG00000047644","WWC3","X",9983602,10112518,128916
"506","ENSG00000047648","ARHGAP6","X",11136239,11683821,547582
"507","ENSG00000047662","FAM184B","4",17630929,17783135,152206
"508","ENSG00000047849","MAP4","3",47892182,48130769,238587
"509","ENSG00000047932","GOPC","6",117639374,117923691,284317
"510","ENSG00000048028","USP28","11",113668596,113746292,77696
"511","ENSG00000048052","HDAC9","7",18126572,19042039,915467
"512","ENSG00000048140","TSPAN17","5",176074388,176086058,11670
"513","ENSG00000048162","NOP16","5",175810949,175815976,5027
"514","ENSG00000048342","CC2D2A","4",15471489,15603180,131691
"515","ENSG00000048392","RRM2B","8",103216730,103251346,34616
"516","ENSG00000048405","ZNF800","7",126986844,127071978,85134
"517","ENSG00000048471","SNX29","16",12070594,12668146,597552
"518","ENSG00000048540","LMO3","12",16701307,16763528,62221
"519","ENSG00000048544","MRPS10","6",42174539,42185603,11064
"520","ENSG00000048649","RSF1","11",77371041,77532063,161022
"521","ENSG00000048707","VPS13D","1",12290124,12572099,281975
"522","ENSG00000048740","CELF2","10",11047259,11378674,331415
"523","ENSG00000048828","FAM120A","9",96214004,96328397,114393
"524","ENSG00000048991","R3HDM1","2",136289025,136482840,193815
"525","ENSG00000049089","COL9A2","1",40766159,40783488,17329
"526","ENSG00000049130","KITLG","12",88886570,88974628,88058
"527","ENSG00000049167","ERCC8","5",60169658,60240900,71242
"528","ENSG00000049192","ADAMTS6","5",64444563,64777747,333184
"529","ENSG00000049239","H6PD","1",9294834,9331396,36562
"530","ENSG00000049245","VAMP3","1",7831329,7841492,10163
"531","ENSG00000049246","PER3","1",7844380,7905237,60857
"532","ENSG00000049323","LTBP1","2",33172039,33624576,452537
"533","ENSG00000049449","RCN1","11",31833939,32127301,293362
"534","ENSG00000049540","ELN","7",73442119,73484237,42118
"535","ENSG00000049541","RFC2","7",73645829,73668774,22945
"536","ENSG00000049618","ARID1B","6",157099063,157531913,432850
"537","ENSG00000049656","CLPTM1L","5",1317859,1345214,27355
"538","ENSG00000049759","NEDD4L","18",55711599,56068772,357173
"539","ENSG00000049769","PPP1R3F","X",49126306,49157929,31623
"540","ENSG00000049860","HEXB","5",73935848,74018472,82624
"541","ENSG00000049883","PTCD2","5",71616194,71656052,39858
"542","ENSG00000050030","KIAA2022","X",73952684,74145282,192598
"543","ENSG00000050130","JKAMP","14",59951161,59972128,20967
"544","ENSG00000050165","DKK3","11",11984653,12031316,46663
"545","ENSG00000050344","NFE2L3","7",26191860,26226745,34885
"546","ENSG00000050393","MCUR1","6",13786789,13814800,28011
"547","ENSG00000050405","LIMA1","12",50569571,50677329,107758
"548","ENSG00000050426","LETMD1","12",51441745,51454207,12462
"549","ENSG00000050438","SLC4A8","12",51785101,51902980,117879
"550","ENSG00000050555","LAMC3","9",133884469,133969860,85391
"551","ENSG00000050748","MAPK9","5",179660143,179719099,58956
"552","ENSG00000050767","COL23A1","5",177664619,178017556,352937
"553","ENSG00000050820","BCAR1","16",75262928,75301951,39023
"554","ENSG00000051009","FAM160A2","11",6232565,6255941,23376
"555","ENSG00000051108","HERPUD1","16",56965960,56977798,11838
"556","ENSG00000051128","HOMER3","19",19040010,19052070,12060
"557","ENSG00000051180","RAD51","15",40986972,41024354,37382
"558","ENSG00000051341","POLQ","3",121150278,121264853,114575
"559","ENSG00000051382","PIK3CB","3",138372860,138553780,180920
"560","ENSG00000051523","CYBA","16",88709691,88717560,7869
"561","ENSG00000051596","THOC3","5",175344876,175461683,116807
"562","ENSG00000051620","HEBP2","6",138724668,138743334,18666
"563","ENSG00000051825","MPHOSPH9","12",123636867,123728561,91694
"564","ENSG00000052126","PLEKHA5","12",19282648,19529334,246686
"565","ENSG00000052723","SIKE1","1",115312100,115323306,11206
"566","ENSG00000052749","RRP12","10",99116115,99161127,45012
"567","ENSG00000052795","FNIP2","4",159690290,159829201,138911
"568","ENSG00000052802","MSMO1","4",166248775,166264312,15537
"569","ENSG00000052841","TTC17","11",43380482,43516483,136001
"570","ENSG00000053108","FSTL4","5",132532147,132948255,416108
"571","ENSG00000053254","FOXN3","14",89591215,90085493,494278
"572","ENSG00000053328","METTL24","6",110567131,110679475,112344
"573","ENSG00000053371","AKR7A2","1",19630459,19638640,8181
"574","ENSG00000053372","MRTO4","1",19578033,19586622,8589
"575","ENSG00000053438","NNAT","20",36149617,36152092,2475
"576","ENSG00000053501","USE1","19",17326155,17330638,4483
"577","ENSG00000053524","MCF2L2","3",182895831,183146566,250735
"578","ENSG00000053747","LAMA3","18",21269407,21535030,265623
"579","ENSG00000053770","AP5M1","14",57735627,57756797,21170
"580","ENSG00000053900","ANAPC4","4",25378835,25420120,41285
"581","ENSG00000054116","TRAPPC3","1",36602173,36615098,12925
"582","ENSG00000054118","THRAP3","1",36690017,36770958,80941
"583","ENSG00000054148","PHPT1","9",139743176,139745488,2312
"584","ENSG00000054267","ARID4B","1",235294949,235491534,196585
"585","ENSG00000054277","OPN3","1",241753404,241840678,87274
"586","ENSG00000054282","SDCCAG8","1",243419320,243663394,244074
"587","ENSG00000054392","HHAT","1",210501596,210849638,348042
"588","ENSG00000054523","KIF1B","1",10270863,10441661,170798
"589","ENSG00000054598","FOXC1","6",1610681,1614127,3446
"590","ENSG00000054611","TBC1D22A","22",47158518,47571336,412818
"591","ENSG00000054654","SYNE2","14",64319683,64693165,373482
"592","ENSG00000054690","PLEKHH1","14",68000018,68056329,56311
"593","ENSG00000054793","ATP9A","20",50213053,50385173,172120
"594","ENSG00000054965","FAM168A","11",73111532,73309234,197702
"595","ENSG00000054967","RELT","11",73087309,73108519,21210
"596","ENSG00000054983","GALC","14",88304164,88460009,155845
"597","ENSG00000055044","NOP58","2",203130439,203168389,37950
"598","ENSG00000055070","SZRD1","1",16679070,16724640,45570
"599","ENSG00000055118","KCNH2","7",150642049,150675403,33354
"600","ENSG00000055130","CUL1","7",148395006,148498128,103122
"601","ENSG00000055147","FAM114A2","5",153369688,153418496,48808
"602","ENSG00000055163","CYFIP2","5",156693089,156822606,129517
"603","ENSG00000055208","TAB2","6",149539777,149732749,192972
"604","ENSG00000055211","GINM1","6",149887430,149912884,25454
"605","ENSG00000055332","EIF2AK2","2",37326353,37384208,57855
"606","ENSG00000055483","USP36","17",76783463,76837523,54060
"607","ENSG00000055609","KMT2C","7",151832010,152133090,301080
"608","ENSG00000055917","PUM2","2",20448452,20551995,103543
"609","ENSG00000055950","MRPL43","10",102729215,102747272,18057
"610","ENSG00000055955","ITIH4","3",52846991,52865495,18504
"611","ENSG00000056050","C4orf27","4",170650616,170679104,28488
"612","ENSG00000056097","ZFR","5",32354456,32444867,90411
"613","ENSG00000056277","ZNF280C","X",129336685,129402873,66188
"614","ENSG00000056487","PHF21B","22",45277042,45405880,128838
"615","ENSG00000056558","TRAF1","9",123664671,123691451,26780
"616","ENSG00000056586","RC3H2","9",125606835,125667620,60785
"617","ENSG00000056661","PCGF2","17",36890150,36906070,15920
"618","ENSG00000056736","IL17RB","3",53880607,53899827,19220
"619","ENSG00000056972","TRAF3IP2","6",111877657,111927481,49824
"620","ENSG00000056998","GYG2","X",2746829,2800859,54030
"621","ENSG00000057019","DCBLD2","3",98514785,98620533,105748
"622","ENSG00000057252","SOAT1","1",179262925,179327815,64890
"623","ENSG00000057294","PKP2","12",32943679,33049774,106095
"624","ENSG00000057608","GDI2","10",5807186,5884095,76909
"625","ENSG00000057657","PRDM1","6",106534195,106557814,23619
"626","ENSG00000057663","ATG5","6",106632351,106773666,141315
"627","ENSG00000057704","TMCC3","12",94960900,95044338,83438
"628","ENSG00000057757","PITHD1","1",24104895,24114722,9827
"629","ENSG00000057935","MTA3","2",42721709,42984087,262378
"630","ENSG00000058056","USP13","3",179370543,179507189,136646
"631","ENSG00000058063","ATP11B","3",182511288,182639423,128135
"632","ENSG00000058091","CDK14","7",90095738,90839905,744167
"633","ENSG00000058262","SEC61A1","3",127770484,127790526,20042
"634","ENSG00000058272","PPP1R12A","12",80167343,80329240,161897
"635","ENSG00000058453","CROCC","1",17066768,17299474,232706
"636","ENSG00000058600","POLR3E","16",22308730,22346424,37694
"637","ENSG00000058668","ATP2B4","1",203595689,203713209,117520
"638","ENSG00000058673","ZC3H11A","1",203764782,203823252,58470
"639","ENSG00000058729","RIOK2","5",96496571,96518964,22393
"640","ENSG00000058799","YIPF1","1",54317392,54356407,39015
"641","ENSG00000058804","NDC1","1",54231133,54304533,73400
"642","ENSG00000059122","FLYWCH1","16",2961938,3001209,39271
"643","ENSG00000059145","UNKL","16",1413206,1464752,51546
"644","ENSG00000059377","TBXAS1","7",139476850,139720125,243275
"645","ENSG00000059378","PARP12","7",139723544,139763521,39977
"646","ENSG00000059573","ALDH18A1","10",97365696,97416463,50767
"647","ENSG00000059588","TARBP1","1",234527059,234614849,87790
"648","ENSG00000059691","PET112","4",152591656,152682175,90519
"649","ENSG00000059728","MXD1","2",70124820,70170077,45257
"650","ENSG00000059758","CDK17","12",96672039,96794338,122299
"651","ENSG00000059769","DNAJC25","9",114393632,114432508,38876
"652","ENSG00000059804","SLC2A3","12",8071826,8088871,17045
"653","ENSG00000059915","PSD","10",104162376,104181296,18920
"654","ENSG00000060069","CTDP1","18",77439801,77514510,74709
"655","ENSG00000060138","YBX3","12",10851683,10875911,24228
"656","ENSG00000060237","WNK1","12",861759,1020618,158859
"657","ENSG00000060339","CCAR1","10",70480769,70552134,71365
"658","ENSG00000060491","OGFR","20",61436187,61445352,9165
"659","ENSG00000060642","PIGV","1",27113963,27124889,10926
"660","ENSG00000060656","PTPRU","1",29563028,29653325,90297
"661","ENSG00000060688","SNRNP40","1",31732417,31769662,37245
"662","ENSG00000060709","RIMBP2","12",130880682,131200826,320144
"663","ENSG00000060718","COL11A1","1",103342023,103574052,232029
"664","ENSG00000060749","QSER1","11",32914724,33014862,100138
"665","ENSG00000060762","MPC1","6",166778407,166796486,18079
"666","ENSG00000060971","ACAA1","3",38144620,38178733,34113
"667","ENSG00000060982","BCAT1","12",24964295,25102393,138098
"668","ENSG00000061273","HDAC7","12",48176505,48226915,50410
"669","ENSG00000061337","LZTS1","8",20103676,20161474,57798
"670","ENSG00000061676","NCKAP1","2",183773843,183903586,129743
"671","ENSG00000061794","MRPS35","12",27863706,27909228,45522
"672","ENSG00000061918","GUCY1B3","4",156680144,156728743,48599
"673","ENSG00000061936","SFSWAP","12",132195626,132284282,88656
"674","ENSG00000061938","TNK2","3",195590235,195638816,48581
"675","ENSG00000061987","MON2","12",62860597,62991363,130766
"676","ENSG00000062038","CDH3","16",68670092,68756519,86427
"677","ENSG00000062194","GPBP1","5",56469775,56560506,90731
"678","ENSG00000062282","DGAT2","11",75470557,75512579,42022
"679","ENSG00000062370","ZNF112","19",44830708,44871377,40669
"680","ENSG00000062485","CS","12",56665483,56694176,28693
"681","ENSG00000062598","ELMO2","20",44994688,45061704,67016
"682","ENSG00000062650","WAPAL","10",88195013,88281572,86559
"683","ENSG00000062716","VMP1","17",57784553,57919616,135063
"684","ENSG00000062725","APPBP2","17",58520520,58603580,83060
"685","ENSG00000062822","POLD1","19",50887461,50921273,33812
"686","ENSG00000063015","SEZ6","17",27281919,27333458,51539
"687","ENSG00000063046","EIF4B","12",53399942,53435993,36051
"688","ENSG00000063127","SLC6A16","19",49792895,49828482,35587
"689","ENSG00000063169","GLTSCR1","19",48111453,48206533,95080
"690","ENSG00000063176","SPHK2","19",49122548,49133974,11426
"691","ENSG00000063177","RPL18","19",49118585,49122793,4208
"692","ENSG00000063180","CA11","19",49141199,49149569,8370
"693","ENSG00000063241","ISOC2","19",55964352,55973710,9358
"694","ENSG00000063244","U2AF2","19",56165512,56186081,20569
"695","ENSG00000063245","EPN1","19",56186592,56221224,34632
"696","ENSG00000063322","MED29","19",39881943,39891277,9334
"697","ENSG00000063438","AHRR","5",304291,438406,134115
"698","ENSG00000063587","ZNF275","X",152599613,152625568,25955
"699","ENSG00000063601","MTMR1","X",149861435,149933576,72141
"700","ENSG00000063660","GPC1","2",241375088,241407493,32405
"701","ENSG00000063761","ADCK1","14",78266426,78401355,134929
"702","ENSG00000063854","HAGH","16",1845621,1877195,31574
"703","ENSG00000063978","RNF4","4",2463947,2627047,163100
"704","ENSG00000064012","CASP8","2",202098166,202152434,54268
"705","ENSG00000064042","LIMCH1","4",41361624,41702061,340437
"706","ENSG00000064102","ASUN","12",27058114,27091259,33145
"707","ENSG00000064115","TM7SF3","12",27126128,27167367,41239
"708","ENSG00000064199","SPA17","11",124543694,124567414,23720
"709","ENSG00000064225","ST3GAL6","3",98451080,98540045,88965
"710","ENSG00000064270","ATP2C2","16",84402133,84497793,95660
"711","ENSG00000064300","NGFR","17",47572655,47592379,19724
"712","ENSG00000064309","CDON","11",125825691,125933230,107539
"713","ENSG00000064313","TAF2","8",120743015,120845103,102088
"714","ENSG00000064393","HIPK2","7",139246316,139477577,231261
"715","ENSG00000064419","TNPO3","7",128594948,128695198,100250
"716","ENSG00000064490","RFXANK","19",19303008,19312678,9670
"717","ENSG00000064545","TMEM161A","19",19229978,19249322,19344
"718","ENSG00000064547","LPAR2","19",19734477,19739739,5262
"719","ENSG00000064601","CTSA","20",44518783,44527459,8676
"720","ENSG00000064607","SUGP2","19",19101697,19144832,43135
"721","ENSG00000064651","SLC12A2","5",127419458,127525380,105922
"722","ENSG00000064652","SNX24","5",122179134,122365049,185915
"723","ENSG00000064655","EYA2","20",45523263,45817492,294229
"724","ENSG00000064666","CNN2","19",1026298,1039068,12770
"725","ENSG00000064687","ABCA7","19",1040102,1065571,25469
"726","ENSG00000064692","SNCAIP","5",121647049,121799914,152865
"727","ENSG00000064703","DDX20","1",112297867,112310638,12771
"728","ENSG00000064726","BTBD1","15",83685174,83736106,50932
"729","ENSG00000064763","FAR2","12",29302036,29493913,191877
"730","ENSG00000064932","SBNO2","19",1107636,1174282,66646
"731","ENSG00000064933","PMS1","2",190649107,190742355,93248
"732","ENSG00000064961","HMG20B","19",3572775,3579086,6311
"733","ENSG00000064989","CALCRL","2",188207856,188313187,105331
"734","ENSG00000064995","TAF11","6",34845555,34855866,10311
"735","ENSG00000064999","ANKS1A","6",34857042,35059179,202137
"736","ENSG00000065000","AP3D1","19",2100988,2164464,63476
"737","ENSG00000065029","ZNF76","6",35226686,35263762,37076
"738","ENSG00000065054","SLC9A3R2","16",2075357,2089027,13670
"739","ENSG00000065057","NTHL1","16",2089816,2097867,8051
"740","ENSG00000065060","UHRF1BP1","6",34759857,34850915,91058
"741","ENSG00000065135","GNAI3","1",110091233,110136975,45742
"742","ENSG00000065150","IPO5","13",98605912,98676551,70639
"743","ENSG00000065154","OAT","10",126085872,126107545,21673
"744","ENSG00000065183","WDR3","1",118472343,118509165,36822
"745","ENSG00000065243","PKN2","1",89149905,89301938,152033
"746","ENSG00000065268","WDR18","19",983174,994569,11395
"747","ENSG00000065308","TRAM2","6",52362200,52441713,79513
"748","ENSG00000065320","NTN1","17",8924859,9147317,222458
"749","ENSG00000065328","MCM10","10",13203554,13253104,49550
"750","ENSG00000065357","DGKA","12",56321103,56347811,26708
"751","ENSG00000065361","ERBB3","12",56473641,56497289,23648
"752","ENSG00000065413","ANKRD44","2",197831741,198175897,344156
"753","ENSG00000065427","KARS","16",75661622,75682541,20919
"754","ENSG00000065457","ADAT1","16",75630879,75657198,26319
"755","ENSG00000065485","PDIA5","3",122785909,122944074,158165
"756","ENSG00000065491","TBC1D22B","6",37225548,37300746,75198
"757","ENSG00000065518","NDUFB4","3",120315156,120321347,6191
"758","ENSG00000065526","SPEN","1",16174359,16266955,92596
"759","ENSG00000065534","MYLK","3",123328896,123603178,274282
"760","ENSG00000065548","ZC3H15","2",187350883,187374090,23207
"761","ENSG00000065559","MAP2K4","17",11924141,12047147,123006
"762","ENSG00000065600","TMEM206","1",212537273,212588243,50970
"763","ENSG00000065609","SNAP91","6",84262599,84419410,156811
"764","ENSG00000065613","SLK","10",105726959,105788991,62032
"765","ENSG00000065615","CYB5R4","6",84569362,84677143,107781
"766","ENSG00000065618","COL17A1","10",105791044,105845760,54716
"767","ENSG00000065621","GSTO2","10",106028631,106064703,36072
"768","ENSG00000065665","SEC61A2","10",12171636,12211960,40324
"769","ENSG00000065802","ASB1","2",239335383,239360891,25508
"770","ENSG00000065809","FAM107B","10",14560556,14816896,256340
"771","ENSG00000065833","ME1","6",83920108,84140797,220689
"772","ENSG00000065882","TBC1D1","4",37892708,38140796,248088
"773","ENSG00000065883","CDK13","7",39989636,40136733,147097
"774","ENSG00000065911","MTHFD2","2",74425689,74444692,19003
"775","ENSG00000065923","SLC9A7","X",46464753,46618490,153737
"776","ENSG00000065970","FOXJ2","12",8185299,8208099,22800
"777","ENSG00000065978","YBX1","1",43148098,43168020,19922
"778","ENSG00000066027","PPP2R5A","1",212458879,212535200,76321
"779","ENSG00000066032","CTNNA2","2",79412357,80875905,1463548
"780","ENSG00000066044","ELAVL1","19",8023463,8070543,47080
"781","ENSG00000066084","DIP2B","12",50898768,51142450,243682
"782","ENSG00000066117","SMARCD1","12",50478755,50494495,15740
"783","ENSG00000066135","KDM4A","1",44115829,44171186,55357
"784","ENSG00000066136","NFYC","1",41157320,41237275,79955
"785","ENSG00000066248","NGEF","2",233743396,233877982,134586
"786","ENSG00000066279","ASPM","1",197053258,197115824,62566
"787","ENSG00000066322","ELOVL1","1",43829068,43833696,4628
"788","ENSG00000066379","ZNRD1","6",30026676,30032686,6010
"789","ENSG00000066382","MPPED2","11",30406040,30608419,202379
"790","ENSG00000066422","ZBTB11","3",101367733,101396339,28606
"791","ENSG00000066427","ATXN3","14",92524896,92572965,48069
"792","ENSG00000066455","GOLGA5","14",93260576,93306308,45732
"793","ENSG00000066468","FGFR2","10",123237848,123357972,120124
"794","ENSG00000066557","LRRC40","1",70610488,70671303,60815
"795","ENSG00000066583","ISOC1","5",128430444,128449721,19277
"796","ENSG00000066629","EML1","14",100204030,100408397,204367
"797","ENSG00000066651","TRMT11","6",126307576,126360422,52846
"798","ENSG00000066654","THUMPD1","16",20744986,20753406,8420
"799","ENSG00000066697","MSANTD3","9",103189438,103213511,24073
"800","ENSG00000066735","KIF26A","14",104605060,104647231,42171
"801","ENSG00000066739","ATG2B","14",96747595,96830207,82612
"802","ENSG00000066777","ARFGEF1","8",68085747,68255912,170165
"803","ENSG00000066827","ZFAT","8",135490031,135725292,235261
"804","ENSG00000066855","MTFR1","8",66556969,66683496,126527
"805","ENSG00000066923","STAG3","7",99775186,99819111,43925
"806","ENSG00000066926","FECH","18",55215515,55254004,38489
"807","ENSG00000066933","MYO9A","15",72114632,72410918,296286
"808","ENSG00000067048","DDX3Y","Y",15016019,15032390,16371
"809","ENSG00000067057","PFKP","10",3108525,3179904,71379
"810","ENSG00000067064","IDI1","10",1085848,1095110,9262
"811","ENSG00000067066","SP100","2",231280657,231408805,128148
"812","ENSG00000067082","KLF6","10",3818188,3827473,9285
"813","ENSG00000067113","PPAP2A","5",54720682,54830878,110196
"814","ENSG00000067141","NEO1","15",73344051,73597547,253496
"815","ENSG00000067167","TRAM1","8",71485677,71520622,34945
"816","ENSG00000067177","PHKA1","X",71798664,71934167,135503
"817","ENSG00000067182","TNFRSF1A","12",6437923,6451280,13357
"818","ENSG00000067191","CACNB1","17",37329709,37353956,24247
"819","ENSG00000067208","EVI5","1",92974253,93257961,283708
"820","ENSG00000067221","STOML1","15",74275547,74286963,11416
"821","ENSG00000067225","PKM","15",72491370,72524164,32794
"822","ENSG00000067248","DHX29","5",54552073,54603550,51477
"823","ENSG00000067334","DNTTIP2","1",94333373,94345474,12101
"824","ENSG00000067365","METTL22","16",8715540,8740081,24541
"825","ENSG00000067369","TP53BP1","15",43699407,43802926,103519
"826","ENSG00000067445","TRO","X",54946895,54957864,10969
"827","ENSG00000067533","RRP15","1",218458629,218511325,52696
"828","ENSG00000067560","RHOA","3",49396578,49450431,53853
"829","ENSG00000067596","DHX8","17",41561233,41621831,60598
"830","ENSG00000067601","PMS2P4","7",66752528,66767894,15366
"831","ENSG00000067606","PRKCZ","1",1981909,2116834,134925
"832","ENSG00000067646","ZFY","Y",2803112,2850547,47435
"833","ENSG00000067704","IARS2","1",220267444,220321380,53936
"834","ENSG00000067715","SYT1","12",79257773,79845788,588015
"835","ENSG00000067798","NAV3","12",78224685,78606790,382105
"836","ENSG00000067829","IDH3G","X",153051221,153059978,8757
"837","ENSG00000067836","ROGDI","16",4846969,4852951,5982
"838","ENSG00000067840","PDZD4","X",153067621,153096020,28399
"839","ENSG00000067900","ROCK1","18",18526867,18691812,164945
"840","ENSG00000067955","CBFB","16",67063019,67134961,71942
"841","ENSG00000067992","PDK3","X",24483338,24557954,74616
"842","ENSG00000068001","HYAL2","3",50355221,50360337,5116
"843","ENSG00000068024","HDAC4","2",239969864,240323348,353484
"844","ENSG00000068028","RASSF1","3",50367219,50378411,11192
"845","ENSG00000068078","FGFR3","4",1795034,1810599,15565
"846","ENSG00000068097","HEATR6","17",58120555,58156292,35737
"847","ENSG00000068120","COASY","17",40713485,40718295,4810
"848","ENSG00000068137","PLEKHH3","17",40819932,40829048,9116
"849","ENSG00000068305","MEF2A","15",100017370,100256671,239301
"850","ENSG00000068308","OTUD5","X",48779305,48815648,36343
"851","ENSG00000068323","TFE3","X",48886242,48901012,14770
"852","ENSG00000068354","TBC1D25","X",48397845,48420997,23152
"853","ENSG00000068366","ACSL4","X",108867473,108976632,109159
"854","ENSG00000068383","INPP5A","10",134351324,134596979,245655
"855","ENSG00000068394","GPKOW","X",48970334,48980151,9817
"856","ENSG00000068400","GRIPAP1","X",48830134,48858675,28541
"857","ENSG00000068438","FTSJ1","X",48334541,48344752,10211
"858","ENSG00000068489","PRR11","17",57232860,57282066,49206
"859","ENSG00000068615","REEP1","2",86441116,86565206,124090
"860","ENSG00000068650","ATP11A","13",113344643,113541482,196839
"861","ENSG00000068654","POLR1A","2",86247339,86333278,85939
"862","ENSG00000068697","LAPTM4A","2",20232411,20251789,19378
"863","ENSG00000068724","TTC7A","2",47143296,47303276,159980
"864","ENSG00000068745","IP6K2","3",48725436,48777786,52350
"865","ENSG00000068781","STON1-GTF2A1L","2",48757064,49003654,246590
"866","ENSG00000068784","SRBD1","2",45615819,45839304,223485
"867","ENSG00000068793","CYFIP1","15",22892005,23006016,114011
"868","ENSG00000068796","KIF2A","5",61601989,61833076,231087
"869","ENSG00000068831","RASGRP2","11",64494383,64512928,18545
"870","ENSG00000068878","PSME4","2",54091204,54197977,106773
"871","ENSG00000068885","IFT80","3",159974774,160117668,142894
"872","ENSG00000068903","SIRT2","19",39369197,39390502,21305
"873","ENSG00000068912","ERLEC1","2",54014181,54045956,31775
"874","ENSG00000068971","PPP2R5B","11",64685025,64701945,16920
"875","ENSG00000068976","PYGM","11",64513861,64527769,13908
"876","ENSG00000069020","MAST4","5",65892176,66465423,573247
"877","ENSG00000069122","GPR116","6",46820249,46922680,102431
"878","ENSG00000069188","SDK2","17",71330523,71640228,309705
"879","ENSG00000069248","NUP133","1",229577045,229644103,67058
"880","ENSG00000069275","NUCKS1","1",205681947,205719404,37457
"881","ENSG00000069329","VPS35","16",46690054,46723430,33376
"882","ENSG00000069345","DNAJA2","16",46989299,47007699,18400
"883","ENSG00000069424","KCNAB2","1",6051526,6161253,109727
"884","ENSG00000069431","ABCC9","12",21950335,22094336,144001
"885","ENSG00000069493","CLEC2D","12",9817565,9848413,30848
"886","ENSG00000069509","FUNDC1","X",44382885,44402247,19362
"887","ENSG00000069667","RORA","15",60780483,61521518,741035
"888","ENSG00000069702","TGFBR3","1",92145902,92371892,225990
"889","ENSG00000069712","KIAA1107","1",92632542,92650280,17738
"890","ENSG00000069849","ATP1B3","3",141594966,141645356,50390
"891","ENSG00000069869","NEDD4","15",56119120,56285944,166824
"892","ENSG00000069943","PIGB","15",55611158,55647846,36688
"893","ENSG00000069956","MAPK6","15",52244303,52358462,114159
"894","ENSG00000069966","GNB5","15",52413117,52483566,70449
"895","ENSG00000069974","RAB27A","15",55495164,55611311,116147
"896","ENSG00000069998","CECR5","22",17618401,17646177,27776
"897","ENSG00000070010","UFD1L","22",19437433,19466738,29305
"898","ENSG00000070018","LRP6","12",12268959,12419946,150987
"899","ENSG00000070047","PHRF1","11",576486,612222,35736
"900","ENSG00000070061","IKBKAP","9",111629797,111696396,66599
"901","ENSG00000070081","NUCB2","11",17229700,17371521,141821
"902","ENSG00000070087","PFN2","3",149682691,149768575,85884
"903","ENSG00000070159","PTPN3","9",112137746,112260590,122844
"904","ENSG00000070193","FGF10","5",44303646,44389808,86162
"905","ENSG00000070214","SLC44A1","9",108006903,108201452,194549
"906","ENSG00000070269","TMEM260","14",56955072,57117324,162252
"907","ENSG00000070366","SMG6","17",1963133,2207065,243932
"908","ENSG00000070367","EXOC5","14",57670518,57735726,65208
"909","ENSG00000070371","CLTCL1","22",19166986,19279239,112253
"910","ENSG00000070404","FSTL3","19",676392,683385,6993
"911","ENSG00000070413","DGCR2","22",19023795,19109967,86172
"912","ENSG00000070423","RNF126","19",647526,663277,15751
"913","ENSG00000070444","MNT","17",2287354,2304412,17058
"914","ENSG00000070476","ZXDC","3",126156444,126194762,38318
"915","ENSG00000070495","JMJD6","17",74708919,74722866,13947
"916","ENSG00000070501","POLB","8",42195972,42229326,33354
"917","ENSG00000070540","WIPI1","17",66417089,66453654,36565
"918","ENSG00000070601","FRMPD1","9",37650997,37746901,95904
"919","ENSG00000070610","GBA2","9",35736863,35749983,13120
"920","ENSG00000070614","NDST1","5",149865381,149937773,72392
"921","ENSG00000070669","ASNS","7",97481430,97501854,20424
"922","ENSG00000070718","AP3M2","8",42010464,42029191,18727
"923","ENSG00000070731","ST6GALNAC2","17",74559792,74583038,23246
"924","ENSG00000070756","PABPC1","8",101698044,101735037,36993
"925","ENSG00000070759","TESK2","1",45809555,45956872,147317
"926","ENSG00000070761","C16orf80","16",58147496,58163354,15858
"927","ENSG00000070770","CSNK2A2","16",58191811,58231824,40013
"928","ENSG00000070778","PTPN21","14",88932122,89021077,88955
"929","ENSG00000070785","EIF2B3","1",45316450,45452282,135832
"930","ENSG00000070808","CAMK2A","5",149599054,149669854,70800
"931","ENSG00000070814","TCOF1","5",149737202,149779871,42669
"932","ENSG00000070831","CDC42","1",22379120,22419437,40317
"933","ENSG00000070882","OSBPL3","7",24836158,25021253,185095
"934","ENSG00000070950","RAD18","3",8817088,9005457,188369
"935","ENSG00000070961","ATP2B1","12",89981828,90103077,121249
"936","ENSG00000071051","NCK2","2",106361354,106510730,149376
"937","ENSG00000071054","MAP4K4","2",102313312,102511149,197837
"938","ENSG00000071073","MGAT4A","2",99235569,99347589,112020
"939","ENSG00000071082","RPL31","2",101618177,101640494,22317
"940","ENSG00000071127","WDR1","4",10075963,10118573,42610
"941","ENSG00000071189","SNX13","7",17830385,17980124,149739
"942","ENSG00000071205","ARHGAP10","4",148653214,148993931,340717
"943","ENSG00000071242","RPS6KA2","6",166822852,167319939,497087
"944","ENSG00000071243","ING3","7",120590803,120617270,26467
"945","ENSG00000071246","VASH1","14",77228532,77249354,20822
"946","ENSG00000071282","LMCD1","3",8543393,8609805,66412
"947","ENSG00000071462","WBSCR22","7",73097355,73119491,22136
"948","ENSG00000071537","SEL1L","14",81937893,82000205,62312
"949","ENSG00000071539","TRIP13","5",892758,919472,26714
"950","ENSG00000071553","ATP6AP1","X",153656978,153664862,7884
"951","ENSG00000071564","TCF3","19",1609291,1652604,43313
"952","ENSG00000071575","TRIB2","2",12857015,12882860,25845
"953","ENSG00000071626","DAZAP1","19",1407568,1435719,28151
"954","ENSG00000071655","MBD3","19",1576639,1592882,16243
"955","ENSG00000071794","HLTF","3",148747914,148804341,56427
"956","ENSG00000071859","FAM50A","X",153672473,153679002,6529
"957","ENSG00000071889","FAM3A","X",153733350,153744566,11216
"958","ENSG00000071894","CPSF1","8",145618444,145634753,16309
"959","ENSG00000071967","CYBRD1","2",172378757,172414643,35886
"960","ENSG00000071994","PDCD2","6",170884383,170893780,9397
"961","ENSG00000072041","SLC6A15","12",85253492,85307394,53902
"962","ENSG00000072042","RDH11","14",68143518,68162531,19013
"963","ENSG00000072062","PRKACA","19",14202500,14228896,26396
"964","ENSG00000072071","LPHN1","19",14260750,14316999,56249
"965","ENSG00000072110","ACTN1","14",69340860,69446157,105297
"966","ENSG00000072121","ZFYVE26","14",68194091,68283307,89216
"967","ENSG00000072133","RPS6KA6","X",83318984,83442933,123949
"968","ENSG00000072134","EPN2","17",19118928,19240028,121100
"969","ENSG00000072135","PTPN18","2",131113580,131132982,19402
"970","ENSG00000072163","LIMS2","2",128395956,128439360,43404
"971","ENSG00000072182","ASIC4","2",220378892,220403494,24602
"972","ENSG00000072195","SPEG","2",220299568,220363009,63441
"973","ENSG00000072201","LNX1","4",54325468,54567572,242104
"974","ENSG00000072210","ALDH3A2","17",19551449,19580911,29462
"975","ENSG00000072274","TFRC","3",195754054,195809060,55006
"976","ENSG00000072310","SREBF1","17",17713713,17740325,26612
"977","ENSG00000072364","AFF4","5",132211071,132299326,88255
"978","ENSG00000072401","UBE2D1","10",60094735,60130513,35778
"979","ENSG00000072415","MPP5","14",67707826,67802536,94710
"980","ENSG00000072422","RHOBTB1","10",62629196,62761198,132002
"981","ENSG00000072501","SMC1A","X",53401070,53449677,48607
"982","ENSG00000072506","HSD17B10","X",53458206,53461320,3114
"983","ENSG00000072518","MARK2","11",63606400,63678491,72091
"984","ENSG00000072571","HMMR","5",162887209,162918947,31738
"985","ENSG00000072609","CHFR","12",133398773,133532890,134117
"986","ENSG00000072657","TRHDE","12",72481046,73059422,578376
"987","ENSG00000072682","P4HA2","5",131527531,131631008,103477
"988","ENSG00000072736","NFATC3","16",68118654,68263162,144508
"989","ENSG00000072756","TRNT1","3",3168600,3192563,23963
"990","ENSG00000072778","ACADVL","17",7120444,7128592,8148
"991","ENSG00000072786","STK10","5",171469077,171615390,146313
"992","ENSG00000072803","FBXW11","5",171288553,171433877,145324
"993","ENSG00000072832","CRMP1","4",5749811,5894785,144974
"994","ENSG00000072840","EVC","4",5712924,5830772,117848
"995","ENSG00000072849","DERL2","17",5374571,5390131,15560
"996","ENSG00000072864","NDE1","16",15737124,15820210,83086
"997","ENSG00000072952","MRVI1","11",10594638,10715535,120897
"998","ENSG00000072954","TMEM38A","19",16771938,16800840,28902
"999","ENSG00000072958","AP1M1","19",16308389,16346160,37771
"1000","ENSG00000073008","PVR","19",45147098,45166850,19752
"1001","ENSG00000073009","IKBKG","X",153769414,153796782,27368
"1002","ENSG00000073050","XRCC1","19",44047192,44084625,37433
"1003","ENSG00000073060","SCARB1","12",125261402,125367214,105812
"1004","ENSG00000073111","MCM2","3",127317066,127341276,24210
"1005","ENSG00000073169","","22",50639408,50656045,16637
"1006","ENSG00000073331","ALPK1","4",113206665,113363776,157111
"1007","ENSG00000073417","PDE8A","15",85523671,85682376,158705
"1008","ENSG00000073464","CLCN4","X",10125024,10205700,80676
"1009","ENSG00000073536","NLE1","17",33455772,33469334,13562
"1010","ENSG00000073578","SDHA","5",218356,256815,38459
"1011","ENSG00000073584","SMARCE1","17",38781214,38804760,23546
"1012","ENSG00000073605","GSDMB","17",38060848,38076107,15259
"1013","ENSG00000073614","KDM5A","12",389295,498620,109325
"1014","ENSG00000073670","ADAM11","17",42836399,42859214,22815
"1015","ENSG00000073711","PPP2R3A","3",135684515,135866733,182218
"1016","ENSG00000073712","FERMT2","14",53323986,53419153,95167
"1017","ENSG00000073792","IGF2BP2","3",185361527,185542844,181317
"1018","ENSG00000073803","MAP3K13","3",185000729,185206885,206156
"1019","ENSG00000073849","ST6GAL1","3",186648274,186796341,148067
"1020","ENSG00000073910","FRY","13",32605437,32870794,265357
"1021","ENSG00000073921","PICALM","11",85668727,85780924,112197
"1022","ENSG00000073969","NSF","17",44668035,44834830,166795
"1023","ENSG00000074047","GLI2","2",121493199,121750229,257030
"1024","ENSG00000074054","CLASP1","2",122095352,122407163,311811
"1025","ENSG00000074071","MRPS34","16",1821891,1823156,1265
"1026","ENSG00000074181","NOTCH3","19",15270444,15311792,41348
"1027","ENSG00000074201","CLNS1A","11",77225981,77348850,122869
"1028","ENSG00000074219","TEAD2","19",49843852,49865714,21862
"1029","ENSG00000074266","EED","11",85955586,85989855,34269
"1030","ENSG00000074319","TSG101","11",18489883,18548779,58896
"1031","ENSG00000074356","C17orf85","17",3714460,3749545,35085
"1032","ENSG00000074370","ATP2A3","17",3827169,3867736,40567
"1033","ENSG00000074410","CA12","15",63613577,63674360,60783
"1034","ENSG00000074527","NTN4","12",96051583,96184930,133347
"1035","ENSG00000074582","BCS1L","2",219523487,219528166,4679
"1036","ENSG00000074590","NUAK1","12",106457118,106533811,76693
"1037","ENSG00000074603","DPP8","15",65734801,65810042,75241
"1038","ENSG00000074621","SLC24A1","15",65903704,65953333,49629
"1039","ENSG00000074657","ZNF532","18",56529832,56653712,123880
"1040","ENSG00000074695","LMAN1","18",56995055,57027194,32139
"1041","ENSG00000074696","PTPLAD1","15",65822756,65870687,47931
"1042","ENSG00000074706","IPCEF1","6",154475631,154677926,202295
"1043","ENSG00000074755","ZZEF1","17",3907739,4046314,138575
"1044","ENSG00000074800","ENO1","1",8921061,8939308,18247
"1045","ENSG00000074803","SLC12A1","15",48483861,48596275,112414
"1046","ENSG00000074842","C19orf10","19",4641386,4670382,28996
"1047","ENSG00000074855","ANO8","19",17434032,17445638,11606
"1048","ENSG00000074935","TUBE1","6",112391980,112408732,16752
"1049","ENSG00000074964","ARHGEF10L","1",17866330,18024369,158039
"1050","ENSG00000075035","WSCD2","12",108523248,108644314,121066
"1051","ENSG00000075043","KCNQ2","20",62037542,62103993,66451
"1052","ENSG00000075089","ACTR6","12",100592900,100635643,42743
"1053","ENSG00000075131","TIPIN","15",66628544,66679084,50540
"1054","ENSG00000075142","SRI","7",87834433,87856308,21875
"1055","ENSG00000075151","EIF4G3","1",21132963,21503377,370414
"1056","ENSG00000075188","NUP37","12",102467967,102513902,45935
"1057","ENSG00000075213","SEMA3A","7",83585093,84122040,536947
"1058","ENSG00000075218","GTSE1","22",46692638,46726707,34069
"1059","ENSG00000075223","SEMA3C","7",80371854,80551675,179821
"1060","ENSG00000075234","TTC38","22",46663858,46689905,26047
"1061","ENSG00000075239","ACAT1","11",107992243,108018503,26260
"1062","ENSG00000075240","GRAMD4","22",46971909,47075688,103779
"1063","ENSG00000075275","CELSR1","22",46756731,46933067,176336
"1064","ENSG00000075290","WNT8B","10",102222798,102243501,20703
"1065","ENSG00000075292","ZNF638","2",71503691,71662199,158508
"1066","ENSG00000075303","SLC25A40","7",87462883,87505672,42789
"1067","ENSG00000075336","TIMM21","18",71815746,71826197,10451
"1068","ENSG00000075340","ADD2","2",70834750,70995357,160607
"1069","ENSG00000075391","RASAL2","1",178062864,178448644,385780
"1070","ENSG00000075399","VPS9D1","16",89773542,89787394,13852
"1071","ENSG00000075407","ZNF37A","10",38383264,38414472,31208
"1072","ENSG00000075413","MARK3","14",103851729,103970168,118439
"1073","ENSG00000075415","SLC25A3","12",98987369,98995946,8577
"1074","ENSG00000075420","FNDC3B","3",171757418,172119455,362037
"1075","ENSG00000075426","FOSL2","2",28615315,28640179,24864
"1076","ENSG00000075429","CACNG5","17",64831235,64881603,50368
"1077","ENSG00000075461","CACNG4","17",64961026,65029514,68488
"1078","ENSG00000075539","FRYL","4",48499378,48782339,282961
"1079","ENSG00000075568","TMEM131","2",98372799,98612388,239589
"1080","ENSG00000075618","FSCN1","7",5632439,5646286,13847
"1081","ENSG00000075624","ACTB","7",5566782,5603415,36633
"1082","ENSG00000075643","MOCOS","18",33767482,33852120,84638
"1083","ENSG00000075651","PLD1","3",171318195,171528740,210545
"1084","ENSG00000075702","WDR62","19",36545783,36596008,50225
"1085","ENSG00000075711","DLG1","3",196769431,197026171,256740
"1086","ENSG00000075785","RAB7A","3",128444965,128533639,88674
"1087","ENSG00000075790","BCAP29","7",107220422,107269615,49193
"1088","ENSG00000075826","SEC31B","10",102246399,102289628,43229
"1089","ENSG00000075856","SART3","12",108916357,108955176,38819
"1090","ENSG00000075884","ARHGAP15","2",143848931,144525921,676990
"1091","ENSG00000075914","EXOSC7","3",45016733,45077558,60825
"1092","ENSG00000075945","KIFAP3","1",169890467,170054349,163882
"1093","ENSG00000075975","MKRN2","3",12598513,12625212,26699
"1094","ENSG00000076003","MCM6","2",136597196,136633996,36800
"1095","ENSG00000076043","REXO2","11",114310108,114321001,10893
"1096","ENSG00000076053","RBM7","11",114270752,114284925,14173
"1097","ENSG00000076067","RBMS2","12",56915713,56984745,69032
"1098","ENSG00000076108","BAZ2A","12",56989380,57030600,41220
"1099","ENSG00000076201","PTPN23","3",47422501,47454931,32430
"1100","ENSG00000076242","MLH1","3",37034823,37107380,72557
"1101","ENSG00000076248","UNG","12",109535379,109548797,13418
"1102","ENSG00000076258","FMO4","1",171283347,171311223,27876
"1103","ENSG00000076321","KLHL20","1",173684080,173755840,71760
"1104","ENSG00000076351","SLC46A1","17",26721661,26734215,12554
"1105","ENSG00000076356","PLXNA2","1",208195587,208417665,222078
"1106","ENSG00000076382","SPAG5","17",26904588,26926297,21709
"1107","ENSG00000076513","ANKRD13A","12",110436991,110477568,40577
"1108","ENSG00000076554","TPD52","8",80870571,81143467,272896
"1109","ENSG00000076555","ACACB","12",109554400,109706031,151631
"1110","ENSG00000076604","TRAF4","17",27071002,27077974,6972
"1111","ENSG00000076641","PAG1","8",81880045,82024303,144258
"1112","ENSG00000076650","GPATCH1","19",33571786,33621448,49662
"1113","ENSG00000076662","ICAM3","19",10444452,10450499,6047
"1114","ENSG00000076685","NT5C2","10",104845940,104953056,107116
"1115","ENSG00000076706","MCAM","11",119179241,119192231,12990
"1116","ENSG00000076716","GPC4","X",132434131,132549518,115387
"1117","ENSG00000076770","MBNL3","X",131503345,131623996,120651
"1118","ENSG00000076864","RAP1GAP","1",21922708,21995801,73093
"1119","ENSG00000076924","XAB2","19",7684411,7694451,10040
"1120","ENSG00000076928","ARHGEF1","19",42387228,42434302,47074
"1121","ENSG00000076984","MAP2K7","19",7968728,7979363,10635
"1122","ENSG00000077044","DGKD","2",234263153,234380750,117597
"1123","ENSG00000077063","CTTNBP2","7",117350705,117514193,163488
"1124","ENSG00000077080","ACTL6B","7",100240720,100254084,13364
"1125","ENSG00000077092","RARB","3",25215823,25639423,423600
"1126","ENSG00000077097","TOP2B","3",25639475,25706398,66923
"1127","ENSG00000077147","TM9SF3","10",98277866,98347209,69343
"1128","ENSG00000077150","NFKB2","10",104153867,104162281,8414
"1129","ENSG00000077152","UBE2T","1",202300785,202311108,10323
"1130","ENSG00000077157","PPP1R12B","1",202317827,202561834,244007
"1131","ENSG00000077232","DNAJC10","2",183580999,183659191,78192
"1132","ENSG00000077235","GTF3C1","16",27470876,27561234,90358
"1133","ENSG00000077238","IL4R","16",27324989,27376099,51110
"1134","ENSG00000077254","USP33","1",78161672,78225537,63865
"1135","ENSG00000077264","PAK3","X",110187513,110470589,283076
"1136","ENSG00000077279","DCX","X",110537007,110655603,118596
"1137","ENSG00000077312","SNRPA","19",41256542,41271294,14752
"1138","ENSG00000077348","EXOSC5","19",41892279,41903384,11105
"1139","ENSG00000077380","DYNC1I2","2",172543919,172604930,61011
"1140","ENSG00000077454","LRCH4","7",100169855,100183776,13921
"1141","ENSG00000077458","FAM76B","11",95502106,95523573,21467
"1142","ENSG00000077463","SIRT6","19",4174106,4182601,8495
"1143","ENSG00000077514","POLD3","11",74204896,74380162,175266
"1144","ENSG00000077549","CAPZB","1",19665267,19812066,146799
"1145","ENSG00000077585","GPR137B","1",236305832,236385165,79333
"1146","ENSG00000077616","NAALAD2","11",89864683,89926062,61379
"1147","ENSG00000077684","JADE1","4",129730779,129796379,65600
"1148","ENSG00000077713","SLC25A43","X",118533023,118588441,55418
"1149","ENSG00000077721","UBE2A","X",118708501,118718381,9880
"1150","ENSG00000077782","FGFR1","8",38268656,38326352,57696
"1151","ENSG00000077809","GTF2I","7",74071994,74175026,103032
"1152","ENSG00000077942","FBLN1","22",45898118,45997015,98897
"1153","ENSG00000078018","MAP2","2",210288782,210598842,310060
"1154","ENSG00000078043","PIAS2","18",44388353,44500123,111770
"1155","ENSG00000078053","AMPH","7",38423305,38671167,247862
"1156","ENSG00000078061","ARAF","X",47420516,47431307,10791
"1157","ENSG00000078070","MCCC1","3",182733006,182833863,100857
"1158","ENSG00000078114","NEBL","10",21068902,21463116,394214
"1159","ENSG00000078124","ACER3","11",76571911,76737841,165930
"1160","ENSG00000078140","UBE2K","4",39699664,39784412,84748
"1161","ENSG00000078142","PIK3C3","18",39535171,39667794,132623
"1162","ENSG00000078177","N4BP2","4",40058446,40159872,101426
"1163","ENSG00000078237","C12orf5","12",4430371,4462338,31967
"1164","ENSG00000078246","TULP3","12",2986389,3050306,63917
"1165","ENSG00000078269","SYNJ2","6",158402888,158520208,117320
"1166","ENSG00000078295","ADCY2","5",7396321,7830194,433873
"1167","ENSG00000078304","PPP2R5C","14",102228135,102394326,166191
"1168","ENSG00000078319","PMS2P1","7",99918615,99939531,20916
"1169","ENSG00000078369","GNB1","1",1716729,1822495,105766
"1170","ENSG00000078401","EDN1","6",12290596,12297427,6831
"1171","ENSG00000078403","MLLT10","10",21823094,22032559,209465
"1172","ENSG00000078487","ZCWPW1","7",99998449,100026615,28166
"1173","ENSG00000078549","ADCYAP1R1","7",31092076,31151089,59013
"1174","ENSG00000078618","NRD1","1",52254863,52344477,89614
"1175","ENSG00000078668","VDAC3","8",42249142,42263415,14273
"1176","ENSG00000078674","PCM1","8",17780349,17885478,105129
"1177","ENSG00000078687","TNRC6C","17",76000249,76104916,104667
"1178","ENSG00000078699","CBFA2T2","20",32077881,32237842,159961
"1179","ENSG00000078725","BRINP1","9",121915736,122131745,216009
"1180","ENSG00000078747","ITCH","20",32951041,33099198,148157
"1181","ENSG00000078804","TP53INP2","20",33292094,33301243,9149
"1182","ENSG00000078808","SDF4","1",1152288,1167411,15123
"1183","ENSG00000078902","TOLLIP","11",1295601,1330884,35283
"1184","ENSG00000078967","UBE2D4","7",43966037,43995735,29698
"1185","ENSG00000079102","RUNX1T1","8",92967203,93115514,148311
"1186","ENSG00000079134","THOC1","18",214520,268050,53530
"1187","ENSG00000079150","FKBP7","2",179328391,179343327,14936
"1188","ENSG00000079156","OSBPL6","2",179059208,179264160,204952
"1189","ENSG00000079215","SLC1A3","5",36606457,36688436,81979
"1190","ENSG00000079246","XRCC5","2",216972187,217071026,98839
"1191","ENSG00000079257","LXN","3",158363611,158390482,26871
"1192","ENSG00000079277","MKNK1","1",47023090,47082515,59425
"1193","ENSG00000079308","TNS1","2",218664512,218867718,203206
"1194","ENSG00000079313","REXO1","19",1815248,1848452,33204
"1195","ENSG00000079332","SAR1A","10",71907045,71930279,23234
"1196","ENSG00000079335","CDC14A","1",100810584,100985833,175249
"1197","ENSG00000079337","RAPGEF3","12",48128455,48164823,36368
"1198","ENSG00000079387","SENP1","12",48436681,48500091,63410
"1199","ENSG00000079432","CIC","19",42772689,42799949,27260
"1200","ENSG00000079435","LIPE","19",42905659,42931578,25919
"1201","ENSG00000079459","FDFT1","8",11653082,11696818,43736
"1202","ENSG00000079462","PAFAH1B3","19",42801185,42807698,6513
"1203","ENSG00000079482","OPHN1","X",67262186,67653755,391569
"1204","ENSG00000079616","KIF22","16",29802040,29816706,14666
"1205","ENSG00000079691","LRRC16A","6",25279306,25620758,341452
"1206","ENSG00000079739","PGM1","1",64058947,64125916,66969
"1207","ENSG00000079785","DDX1","2",15731302,15771235,39933
"1208","ENSG00000079805","DNM2","19",10828755,10944164,115409
"1209","ENSG00000079819","EPB41L2","6",131160487,131384462,223975
"1210","ENSG00000079841","RIMS1","6",72596406,73112845,516439
"1211","ENSG00000079931","MOXD1","6",132617194,132722684,105490
"1212","ENSG00000079950","STX7","6",132767006,132834337,67331
"1213","ENSG00000079974","RABL2B","22",51205929,51222091,16162
"1214","ENSG00000079999","KEAP1","19",10596796,10614417,17621
"1215","ENSG00000080166","DCT","13",95089558,95131936,42378
"1216","ENSG00000080189","SLC35C2","20",44978167,44993043,14876
"1217","ENSG00000080200","CRYBG3","3",97595819,97663810,67991
"1218","ENSG00000080224","EPHA6","3",96533425,97471304,937879
"1219","ENSG00000080298","RFX3","9",3218297,3526004,307707
"1220","ENSG00000080345","RIF1","2",152266397,152364527,98130
"1221","ENSG00000080371","RAB21","12",72148654,72184699,36045
"1222","ENSG00000080493","SLC4A4","4",72053003,72437804,384801
"1223","ENSG00000080503","SMARCA2","9",2015342,2193624,178282
"1224","ENSG00000080546","SESN1","6",109307640,109416022,108382
"1225","ENSG00000080561","MID2","X",107068985,107170423,101438
"1226","ENSG00000080603","SRCAP","16",30709530,30755602,46072
"1227","ENSG00000080608","KIAA0020","9",2720469,2844241,123772
"1228","ENSG00000080644","CHRNA3","15",78885394,78913637,28243
"1229","ENSG00000080802","CNOT4","7",135046547,135194875,148328
"1230","ENSG00000080815","PSEN1","14",73603126,73690399,87273
"1231","ENSG00000080819","CPOX","3",98239976,98312567,72591
"1232","ENSG00000080822","CLDND1","3",98216756,98241910,25154
"1233","ENSG00000080823","MOK","14",102690837,102771537,80700
"1234","ENSG00000080824","HSP90AA1","14",102547075,102606036,58961
"1235","ENSG00000080839","RBL1","20",35624752,35724398,99646
"1236","ENSG00000080845","DLGAP4","20",34894258,35157040,262782
"1237","ENSG00000080854","IGSF9B","11",133778459,133826880,48421
"1238","ENSG00000080947","CROCCP3","1",16793931,16825752,31821
"1239","ENSG00000080986","NDC80","18",2571510,2616634,45124
"1240","ENSG00000081014","AP4E1","15",51200869,51298097,97228
"1241","ENSG00000081019","RSBN1","1",114304454,114355098,50644
"1242","ENSG00000081026","MAGI3","1",113933371,114228545,295174
"1243","ENSG00000081041","CXCL2","4",74962752,74965010,2258
"1244","ENSG00000081051","AFP","4",74296855,74321891,25036
"1245","ENSG00000081059","TCF7","5",133450402,133487556,37154
"1246","ENSG00000081087","OSTM1","6",108362613,108487058,124445
"1247","ENSG00000081138","CDH7","18",63417488,63548638,131150
"1248","ENSG00000081148","IMPG2","3",100941390,101039404,98014
"1249","ENSG00000081154","PCNP","3",101292939,101313281,20342
"1250","ENSG00000081177","EXD2","14",69658228,69709075,50847
"1251","ENSG00000081181","ARG2","14",68086515,68118437,31922
"1252","ENSG00000081189","MEF2C","5",88013975,88199922,185947
"1253","ENSG00000081307","UBA5","3",132373290,132396941,23651
"1254","ENSG00000081320","STK17B","2",196998290,197041227,42937
"1255","ENSG00000081377","CDC14B","9",99252523,99382112,129589
"1256","ENSG00000081386","ZNF510","9",99518147,99540411,22264
"1257","ENSG00000081479","LRP2","2",169983619,170219195,235576
"1258","ENSG00000081665","ZNF506","19",19896648,19932560,35912
"1259","ENSG00000081692","JMJD4","1",227918126,227923112,4986
"1260","ENSG00000081721","DUSP12","1",161719548,161727028,7480
"1261","ENSG00000081760","AACS","12",125549925,125627873,77948
"1262","ENSG00000081791","KIAA0141","5",141303373,141321612,18239
"1263","ENSG00000081803","CADPS2","7",121958481,122526813,568332
"1264","ENSG00000081818","PCDHB4","5",140501581,140505201,3620
"1265","ENSG00000081842","PCDHA6","5",140207563,140391929,184366
"1266","ENSG00000081870","HSPB11","1",54382247,54411602,29355
"1267","ENSG00000081913","PHLPP1","18",60382672,60647666,264994
"1268","ENSG00000081923","ATP8B1","18",55313658,55470333,156675
"1269","ENSG00000082014","SMARCD3","7",150935850,150974982,39132
"1270","ENSG00000082068","WDR70","5",37379314,37753537,374223
"1271","ENSG00000082146","STRADB","2",202252581,202345569,92988
"1272","ENSG00000082153","BZW1","2",201675317,201688569,13252
"1273","ENSG00000082196","C1QTNF3","5",34019553,34043937,24384
"1274","ENSG00000082212","ME2","18",48405419,48474691,69272
"1275","ENSG00000082213","C5orf22","5",31532373,31555165,22792
"1276","ENSG00000082258","CCNT2","2",135675805,135716912,41107
"1277","ENSG00000082269","FAM135A","6",71122644,71270877,148233
"1278","ENSG00000082293","COL19A1","6",70576463,70919679,343216
"1279","ENSG00000082397","EPB41L3","18",5392383,5630699,238316
"1280","ENSG00000082438","COBLL1","2",165510134,165700189,190055
"1281","ENSG00000082458","DLG3","X",69664711,69725337,60626
"1282","ENSG00000082482","KCNK2","1",215179118,215410436,231318
"1283","ENSG00000082497","SERTAD4","1",210406144,210419976,13832
"1284","ENSG00000082512","TRAF5","1",211499957,211548288,48331
"1285","ENSG00000082515","MRPL22","5",154320630,154348971,28341
"1286","ENSG00000082516","GEMIN5","5",154266976,154317769,50793
"1287","ENSG00000082556","OPRK1","8",54138284,54164257,25973
"1288","ENSG00000082641","NFE2L1","17",46125691,46138849,13158
"1289","ENSG00000082684","SEMA5B","3",122628041,122747452,119411
"1290","ENSG00000082701","GSK3B","3",119540170,119813264,273094
"1291","ENSG00000082781","ITGB5","3",124480795,124620265,139470
"1292","ENSG00000082805","ERC1","12",1099675,1605099,505424
"1293","ENSG00000082898","XPO1","2",61704984,61765761,60777
"1294","ENSG00000082996","RNF13","3",149530495,149679926,149431
"1295","ENSG00000083067","TRPM3","9",73143979,74061820,917841
"1296","ENSG00000083093","PALB2","16",23614488,23652631,38143
"1297","ENSG00000083097","DOPEY1","6",83777385,83881069,103684
"1298","ENSG00000083099","LYRM2","6",90277863,90348472,70609
"1299","ENSG00000083123","BCKDHB","6",80816364,81055987,239623
"1300","ENSG00000083168","KAT6A","8",41786997,41909508,122511
"1301","ENSG00000083223","ZCCHC6","9",88902648,88969369,66721
"1302","ENSG00000083290","ULK2","17",19674142,19771249,97107
"1303","ENSG00000083312","TNPO1","5",72112139,72212560,100421
"1304","ENSG00000083444","PLOD1","1",11994262,12035595,41333
"1305","ENSG00000083457","ITGAE","17",3617922,3704537,86615
"1306","ENSG00000083520","DIS3","13",73329540,73356234,26694
"1307","ENSG00000083535","PIBF1","13",73356197,73590591,234394
"1308","ENSG00000083544","TDRD3","13",60970591,61148012,177421
"1309","ENSG00000083635","NUFIP1","13",45513384,45563618,50234
"1310","ENSG00000083642","PDS5B","13",33160564,33352157,191593
"1311","ENSG00000083720","OXCT1","5",41730167,41870621,140454
"1312","ENSG00000083750","RRAGB","X",55744172,55785207,41035
"1313","ENSG00000083799","CYLD","16",50775961,50835846,59885
"1314","ENSG00000083807","SLC27A5","19",58990879,59023780,32901
"1315","ENSG00000083812","ZNF324","19",58978423,58984945,6522
"1316","ENSG00000083814","ZNF671","19",58231119,58238992,7873
"1317","ENSG00000083817","ZNF416","19",58082934,58090295,7361
"1318","ENSG00000083828","ZNF586","19",58281023,58331307,50284
"1319","ENSG00000083838","ZNF446","19",58985384,58992597,7213
"1320","ENSG00000083844","ZNF264","19",57702868,57724724,21856
"1321","ENSG00000083845","RPS5","19",58897767,58906173,8406
"1322","ENSG00000083857","FAT1","4",187508937,187647876,138939
"1323","ENSG00000083896","YTHDC1","4",69176105,69215807,39702
"1324","ENSG00000083937","CHMP2B","3",87276421,87304698,28277
"1325","ENSG00000084070","SMAP2","1",40810522,40888998,78476
"1326","ENSG00000084072","PPIE","1",40157854,40229586,71732
"1327","ENSG00000084073","ZMPSTE24","1",40723779,40759856,36077
"1328","ENSG00000084090","STARD7","2",96850597,96874563,23966
"1329","ENSG00000084092","NOA1","4",57829536,57844989,15453
"1330","ENSG00000084093","REST","4",57774075,57802010,27935
"1331","ENSG00000084112","SSH1","12",109176466,109251366,74900
"1332","ENSG00000084207","GSTP1","11",67351066,67354131,3065
"1333","ENSG00000084234","APLP2","11",129939732,130014699,74967
"1334","ENSG00000084444","KIAA1467","12",13197218,13295455,98237
"1335","ENSG00000084453","SLCO1A2","12",21417534,21572528,154994
"1336","ENSG00000084463","WBP11","12",14939410,14956474,17064
"1337","ENSG00000084623","EIF3I","1",32687529,32697205,9676
"1338","ENSG00000084628","NKAIN1","1",31652592,31712401,59809
"1339","ENSG00000084652","TXLNA","1",32645287,32663886,18599
"1340","ENSG00000084674","APOB","2",21224301,21266945,42644
"1341","ENSG00000084676","NCOA1","2",24714783,24993571,278788
"1342","ENSG00000084693","AGBL5","2",27265232,27293490,28258
"1343","ENSG00000084710","EFR3B","2",25264999,25378243,113244
"1344","ENSG00000084731","KIF3C","2",26149471,26205618,56147
"1345","ENSG00000084733","RAB10","2",26256976,26360323,103347
"1346","ENSG00000084754","HADHA","2",26413504,26467594,54090
"1347","ENSG00000084764","MAPRE3","2",27193480,27250064,56584
"1348","ENSG00000084774","CAD","2",27440258,27466811,26553
"1349","ENSG00000085063","CD59","11",33719807,33757991,38184
"1350","ENSG00000085117","CD82","11",44585977,44641913,55936
"1351","ENSG00000085185","BCORL1","X",129115083,129192058,76975
"1352","ENSG00000085224","ATRX","X",76760356,77041702,281346
"1353","ENSG00000085231","TAF9","5",68646811,68665840,19029
"1354","ENSG00000085274","MYNN","3",169490619,169507504,16885
"1355","ENSG00000085276","MECOM","3",168801287,169381406,580119
"1356","ENSG00000085365","SCAMP1","5",77656339,77776562,120223
"1357","ENSG00000085377","PREP","6",105725440,105850959,125519
"1358","ENSG00000085382","HACE1","6",105175968,105307794,131826
"1359","ENSG00000085415","SEH1L","18",12947132,12987535,40403
"1360","ENSG00000085433","WDR47","1",109512836,109584850,72014
"1361","ENSG00000085449","WDFY1","2",224720433,224810104,89671
"1362","ENSG00000085465","OVGP1","1",111956936,111970399,13463
"1363","ENSG00000085491","SLC25A24","1",108676658,108743471,66813
"1364","ENSG00000085511","MAP3K4","6",161412759,161538417,125658
"1365","ENSG00000085514","PILRA","7",99965153,99997719,32566
"1366","ENSG00000085552","IGSF9","1",159896829,159915386,18557
"1367","ENSG00000085563","ABCB1","7",87133175,87342611,209436
"1368","ENSG00000085644","ZNF213","16",3179778,3192806,13028
"1369","ENSG00000085662","AKR1B1","7",134127102,134144036,16934
"1370","ENSG00000085719","CPNE3","8",87497059,87573726,76667
"1371","ENSG00000085721","RRN3","16",15153879,15188174,34295
"1372","ENSG00000085733","CTTN","11",70244510,70282690,38180
"1373","ENSG00000085760","MTIF2","2",55463731,55496483,32752
"1374","ENSG00000085788","DDHD2","8",38082736,38133076,50340
"1375","ENSG00000085832","EPS15","1",51819935,51985000,165065
"1376","ENSG00000085840","ORC1","1",52838501,52870131,31630
"1377","ENSG00000085871","MGST2","4",140586922,140661899,74977
"1378","ENSG00000085872","CHERP","19",16628700,16653341,24641
"1379","ENSG00000085978","ATG16L1","2",234118697,234204320,85623
"1380","ENSG00000085982","USP40","2",234384166,234475428,91262
"1381","ENSG00000085998","POMGNT1","1",46654354,46685977,31623
"1382","ENSG00000085999","RAD54L","1",46713360,46744145,30785
"1383","ENSG00000086015","MAST2","1",46252659,46501796,249137
"1384","ENSG00000086061","DNAJA1","9",33025209,33039905,14696
"1385","ENSG00000086062","B4GALT1","9",33104080,33167354,63274
"1386","ENSG00000086065","CHMP5","9",33264940,33281977,17037
"1387","ENSG00000086102","NFX1","9",33290509,33371155,80646
"1388","ENSG00000086189","DIMT1","5",61683081,61699766,16685
"1389","ENSG00000086200","IPO11","5",61699799,61924409,224610
"1390","ENSG00000086205","FOLH1","11",49168187,49230222,62035
"1391","ENSG00000086232","EIF2AK1","7",6061881,6098861,36980
"1392","ENSG00000086289","EPDR1","7",37723446,37991543,268097
"1393","ENSG00000086300","SNX10","7",26331541,26413949,82408
"1394","ENSG00000086475","SEPHS1","10",13359424,13390297,30873
"1395","ENSG00000086504","MRPL28","16",417384,420527,3143
"1396","ENSG00000086544","ITPKC","19",41223008,41246765,23757
"1397","ENSG00000086589","RBM22","5",150070356,150080669,10313
"1398","ENSG00000086598","TMED2","12",124069078,124083116,14038
"1399","ENSG00000086619","ERO1LB","1",236378855,236445319,66464
"1400","ENSG00000086666","ZFAND6","15",80351910,80430735,78825
"1401","ENSG00000086696","HSD17B2","16",82068609,82132139,63530
"1402","ENSG00000086712","TXLNG","X",16804550,16862642,58092
"1403","ENSG00000086717","PPEF1","X",18694029,18846039,152010
"1404","ENSG00000086758","HUWE1","X",53559057,53713673,154616
"1405","ENSG00000086827","ZW10","11",113603909,113644533,40624
"1406","ENSG00000086848","ALG9","11",111652919,111742305,89386
"1407","ENSG00000086991","NOX4","11",89057524,89322779,265255
"1408","ENSG00000087008","ACOX3","4",8368009,8442450,74441
"1409","ENSG00000087053","MTMR2","11",95566046,95658479,92433
"1410","ENSG00000087074","PPP1R15A","19",49375649,49379314,3665
"1411","ENSG00000087076","HSD17B14","19",49316274,49339935,23661
"1412","ENSG00000087077","TRIP6","7",100464760,100471076,6316
"1413","ENSG00000087086","FTL","19",49468558,49470135,1577
"1414","ENSG00000087087","SRRT","7",100472733,100486285,13552
"1415","ENSG00000087088","BAX","19",49458072,49465055,6983
"1416","ENSG00000087095","NLK","17",26368763,26523407,154644
"1417","ENSG00000087111","PIGS","17",26880401,26898890,18489
"1418","ENSG00000087152","ATXN7L3","17",42269173,42277481,8308
"1419","ENSG00000087157","PGS1","17",76374721,76421195,46474
"1420","ENSG00000087191","PSMC5","17",61904512,61909379,4867
"1421","ENSG00000087206","UIMC1","5",176332006,176449634,117628
"1422","ENSG00000087245","MMP2","16",55423612,55540603,116991
"1423","ENSG00000087253","LPCAT2","16",55542910,55620582,77672
"1424","ENSG00000087258","GNAO1","16",56225302,56391356,166054
"1425","ENSG00000087263","OGFOD1","16",56485402,56513012,27610
"1426","ENSG00000087266","SH3BP2","4",2794750,2842825,48075
"1427","ENSG00000087269","NOP14","4",2939660,2965112,25452
"1428","ENSG00000087274","ADD1","4",2845584,2931803,86219
"1429","ENSG00000087299","L2HGDH","14",50704281,50779266,74985
"1430","ENSG00000087301","TXNDC16","14",52897308,53019240,121932
"1431","ENSG00000087302","C14orf166","14",52456193,52471420,15227
"1432","ENSG00000087303","NID2","14",52471521,52535712,64191
"1433","ENSG00000087338","GMCL1","2",70056774,70108528,51754
"1434","ENSG00000087365","SF3B2","11",65818200,65836779,18579
"1435","ENSG00000087448","KLHL42","12",27932953,27955973,23020
"1436","ENSG00000087460","GNAS","20",57414773,57486247,71474
"1437","ENSG00000087470","DNM1L","12",32832134,32898486,66352
"1438","ENSG00000087502","ERGIC2","12",29490285,29534122,43837
"1439","ENSG00000087510","TFAP2C","20",55204358,55214339,9981
"1440","ENSG00000087586","AURKA","20",54944445,54967393,22948
"1441","ENSG00000087842","PIR","X",15402921,15511687,108766
"1442","ENSG00000087884","AAMDC","11",77532155,77629478,97323
"1443","ENSG00000087903","RFX2","19",5993175,6199583,206408
"1444","ENSG00000087995","METTL2A","17",60501228,60527454,26226
"1445","ENSG00000088035","ALG6","1",63833261,63904233,70972
"1446","ENSG00000088038","CNOT3","19",54641444,54659419,17975
"1447","ENSG00000088179","PTPN4","2",120517207,120741394,224187
"1448","ENSG00000088205","DDX18","2",118572226,118589955,17729
"1449","ENSG00000088247","KHSRP","19",6413359,6424805,11446
"1450","ENSG00000088256","GNA11","19",3094408,3124002,29594
"1451","ENSG00000088280","ASAP3","1",23755056,23811061,56005
"1452","ENSG00000088298","EDEM2","20",33703167,33865928,162761
"1453","ENSG00000088305","DNMT3B","20",31350191,31397162,46971
"1454","ENSG00000088325","TPX2","20",30327074,30389608,62534
"1455","ENSG00000088340","FER1L4","20",34146507,34195484,48977
"1456","ENSG00000088356","PDRG1","20",30532758,30539895,7137
"1457","ENSG00000088367","EPB41L1","20",34679426,34820721,141295
"1458","ENSG00000088387","DOCK9","13",99445741,99738879,293138
"1459","ENSG00000088448","ANKRD10","13",111530887,111567416,36529
"1460","ENSG00000088451","TGDS","13",95226308,95248511,22203
"1461","ENSG00000088538","DOCK3","3",50712672,51421629,708957
"1462","ENSG00000088543","C3orf18","3",50595462,50608458,12996
"1463","ENSG00000088682","COQ9","16",57481337,57495187,13850
"1464","ENSG00000088727","KIF9","3",47269516,47324941,55425
"1465","ENSG00000088756","ARHGAP28","18",6729717,6915715,185998
"1466","ENSG00000088766","CRLS1","20",5986736,6020699,33963
"1467","ENSG00000088808","PPP1R13B","14",104200089,104313927,113838
"1468","ENSG00000088812","ATRN","20",3451687,3631769,180082
"1469","ENSG00000088826","SMOX","20",4101627,4168394,66767
"1470","ENSG00000088832","FKBP1A","20",1349622,1373806,24184
"1471","ENSG00000088833","NSFL1C","20",1422807,1454487,31680
"1472","ENSG00000088836","SLC4A11","20",3208063,3219836,11773
"1473","ENSG00000088854","C20orf194","20",3229951,3388272,158321
"1474","ENSG00000088876","ZNF343","20",2462463,2505348,42885
"1475","ENSG00000088881","EBF4","20",2673524,2740753,67229
"1476","ENSG00000088882","CPXM1","20",2774715,2781283,6568
"1477","ENSG00000088888","MAVS","20",3827487,3849280,21793
"1478","ENSG00000088899","","20",3143263,3154192,10929
"1479","ENSG00000088930","XRN2","20",21283942,21370463,86521
"1480","ENSG00000088970","PLK1S1","20",21106624,21227260,120636
"1481","ENSG00000088986","DYNLL1","12",120907653,120936296,28643
"1482","ENSG00000089006","SNX5","20",17922241,17949623,27382
"1483","ENSG00000089009","RPL6","12",112842994,112856642,13648
"1484","ENSG00000089022","MAPKAPK5","12",112279782,112334343,54561
"1485","ENSG00000089048","ESF1","20",13694969,13765532,70563
"1486","ENSG00000089050","RBBP9","20",18467184,18477887,10703
"1487","ENSG00000089053","ANAPC5","12",121746048,121837699,91651
"1488","ENSG00000089057","SLC23A2","20",4833002,4990939,157937
"1489","ENSG00000089060","SLC8B1","12",113736564,113797298,60734
"1490","ENSG00000089063","TMEM230","20",5080486,5093749,13263
"1491","ENSG00000089091","DZANK1","20",18364011,18447925,83914
"1492","ENSG00000089094","KDM2B","12",121866900,122018920,152020
"1493","ENSG00000089101","C20orf26","20",20033158,20341346,308188
"1494","ENSG00000089123","TASP1","20",13246709,13619587,372878
"1495","ENSG00000089154","GCN1L1","12",120565007,120632513,67506
"1496","ENSG00000089157","RPLP0","12",120634489,120639038,4549
"1497","ENSG00000089159","PXN","12",120648250,120703574,55324
"1498","ENSG00000089163","SIRT4","12",120740119,120751052,10933
"1499","ENSG00000089177","KIF16B","20",16252749,16554078,301329
"1500","ENSG00000089195","TRMT6","20",5917881,5931182,13301
"1501","ENSG00000089199","CHGB","20",5892076,5906007,13931
"1502","ENSG00000089220","PEBP1","12",118573663,118583389,9726
"1503","ENSG00000089234","BRAP","12",112079950,112123790,43840
"1504","ENSG00000089248","ERP29","12",112451120,112461255,10135
"1505","ENSG00000089280","FUS","16",31191431,31203127,11696
"1506","ENSG00000089289","IGBP1","X",69353299,69386174,32875
"1507","ENSG00000089335","ZNF302","19",35168544,35177302,8758
"1508","ENSG00000089351","GRAMD1A","19",35485688,35517375,31687
"1509","ENSG00000089472","HEPH","X",65382391,65488709,106318
"1510","ENSG00000089486","CDIP1","16",4560676,4588829,28153
"1511","ENSG00000089505","CMTM1","16",66600294,66613040,12746
"1512","ENSG00000089597","GANAB","11",62392298,62414104,21806
"1513","ENSG00000089639","GMIP","19",19740285,19754476,14191
"1514","ENSG00000089682","RBM41","X",106307650,106362057,54407
"1515","ENSG00000089685","BIRC5","17",76210267,76221717,11450
"1516","ENSG00000089693","MLF2","12",6857170,6876641,19471
"1517","ENSG00000089723","OTUB2","14",94492675,94515276,22601
"1518","ENSG00000089737","DDX24","14",94517266,94547591,30325
"1519","ENSG00000089775","ZBTB25","14",64915824,64971931,56107
"1520","ENSG00000089818","NECAP1","12",8234807,8250367,15560
"1521","ENSG00000089820","ARHGAP4","X",153172821,153200452,27631
"1522","ENSG00000089876","DHX32","10",127524906,127585005,60099
"1523","ENSG00000089902","RCOR1","14",103058998,103196913,137915
"1524","ENSG00000089916","GPATCH2L","14",76618259,76720685,102426
"1525","ENSG00000090006","LTBP4","19",41098789,41135725,36936
"1526","ENSG00000090013","BLVRB","19",40953696,40971747,18051
"1527","ENSG00000090020","SLC9A1","1",27425306,27493472,68166
"1528","ENSG00000090054","SPTLC1","9",94794281,94877666,83385
"1529","ENSG00000090060","PAPOLA","14",96967770,97033448,65678
"1530","ENSG00000090061","CCNK","14",99947506,100001381,53875
"1531","ENSG00000090097","PCBP4","3",51991470,52002426,10956
"1532","ENSG00000090104","RGS1","1",192544857,192549161,4304
"1533","ENSG00000090238","YPEL3","16",30103635,30108236,4601
"1534","ENSG00000090263","MRPS33","7",140705854,140715028,9174
"1535","ENSG00000090266","NDUFB2","7",140390577,140422590,32013
"1536","ENSG00000090273","NUDC","1",27226729,27273353,46624
"1537","ENSG00000090316","MAEA","4",1283639,1333935,50296
"1538","ENSG00000090339","ICAM1","19",10381511,10397291,15780
"1539","ENSG00000090372","STRN4","19",47222764,47250251,27487
"1540","ENSG00000090376","IRAK3","12",66582659,66648402,65743
"1541","ENSG00000090432","MUL1","1",20825943,20834654,8711
"1542","ENSG00000090447","TFAP4","16",4307187,4323076,15889
"1543","ENSG00000090470","PDCD7","15",65409717,65426174,16457
"1544","ENSG00000090487","SPG21","15",65255362,65282648,27286
"1545","ENSG00000090520","DNAJB11","3",186285192,186315061,29869
"1546","ENSG00000090530","LEPREL1","3",189674517,189840226,165709
"1547","ENSG00000090565","RAB11FIP3","16",475619,573011,97392
"1548","ENSG00000090581","GNPTG","16",1401924,1413352,11428
"1549","ENSG00000090612","ZNF268","12",133707570,133783698,76128
"1550","ENSG00000090615","GOLGA3","12",133345495,133405444,59949
"1551","ENSG00000090621","PABPC4","1",40026488,40042462,15974
"1552","ENSG00000090661","CERS4","19",8271620,8327305,55685
"1553","ENSG00000090674","MCOLN1","19",7587512,7598895,11383
"1554","ENSG00000090686","USP48","1",22004791,22110099,105308
"1555","ENSG00000090776","EFNB1","X",68048840,68061990,13150
"1556","ENSG00000090857","PDPR","16",70147529,70195203,47674
"1557","ENSG00000090861","AARS","16",70286198,70323446,37248
"1558","ENSG00000090863","GLG1","16",74485856,74641012,155156
"1559","ENSG00000090889","KIF4A","X",69509879,69640682,130803
"1560","ENSG00000090905","TNRC6A","16",24741016,24838953,97937
"1561","ENSG00000090920","FCGBP","19",40353963,40440533,86570
"1562","ENSG00000090924","PLEKHG2","19",39903225,39919054,15829
"1563","ENSG00000090932","DLL3","19",39989535,39999121,9586
"1564","ENSG00000090971","NAT14","19",55996371,55998935,2564
"1565","ENSG00000090975","PITPNM2","12",123468027,123634562,166535
"1566","ENSG00000090989","EXOC1","4",56719782,56771200,51418
"1567","ENSG00000091009","RBM27","5",145583113,145718814,135701
"1568","ENSG00000091039","OSBPL8","12",76745577,76953589,208012
"1569","ENSG00000091073","DTX2","7",76090993,76135312,44319
"1570","ENSG00000091127","PUS7","7",105080108,105162714,82606
"1571","ENSG00000091128","LAMB4","7",107663993,107770801,106808
"1572","ENSG00000091129","NRCAM","7",107788068,108097161,309093
"1573","ENSG00000091136","LAMB1","7",107564244,107643700,79456
"1574","ENSG00000091137","SLC26A4","7",107301080,107358254,57174
"1575","ENSG00000091140","DLD","7",107531415,107572175,40760
"1576","ENSG00000091157","WDR7","18",54318574,54698828,380254
"1577","ENSG00000091164","TXNL1","18",54264439,54318831,54392
"1578","ENSG00000091262","ABCC6","16",16242785,16317379,74594
"1579","ENSG00000091317","CMTM6","3",32522804,32544900,22096
"1580","ENSG00000091409","ITGA6","2",173292082,173371181,79099
"1581","ENSG00000091428","RAPGEF4","2",173600002,173917621,317619
"1582","ENSG00000091436","","2",173940163,174132738,192575
"1583","ENSG00000091483","FH","1",241660903,241683061,22158
"1584","ENSG00000091490","SEL1L3","4",25749055,25865382,116327
"1585","ENSG00000091513","TF","3",133464800,133497850,33050
"1586","ENSG00000091527","CDV3","3",133292574,133309105,16531
"1587","ENSG00000091536","MYO15A","17",18012020,18083116,71096
"1588","ENSG00000091542","ALKBH5","17",18086392,18113268,26876
"1589","ENSG00000091592","NLRP1","17",5402747,5522744,119997
"1590","ENSG00000091622","PITPNM3","17",6354584,6459814,105230
"1591","ENSG00000091640","SPAG7","17",4862521,4871167,8646
"1592","ENSG00000091651","ORC6","16",46723555,46732306,8751
"1593","ENSG00000091656","ZFHX4","8",77593454,77779521,186067
"1594","ENSG00000091664","SLC17A6","11",22359643,22401049,41406
"1595","ENSG00000091732","ZC3HC1","7",129658126,129691291,33165
"1596","ENSG00000091844","RGS17","6",153325594,153452384,126790
"1597","ENSG00000091947","TMEM101","17",42088556,42101314,12758
"1598","ENSG00000091972","CD200","3",112051194,112081659,30465
"1599","ENSG00000091986","CCDC80","3",112323407,112368377,44970
"1600","ENSG00000092010","PSME1","14",24605367,24608176,2809
"1601","ENSG00000092020","PPP2R3C","14",35554673,35591723,37050
"1602","ENSG00000092036","HAUS4","14",23415437,23426370,10933
"1603","ENSG00000092051","JPH4","14",24037244,24048009,10765
"1604","ENSG00000092068","SLC7A8","14",23594504,23652883,58379
"1605","ENSG00000092094","OSGEP","14",20914570,20923264,8694
"1606","ENSG00000092096","SLC22A17","14",23815515,23822121,6606
"1607","ENSG00000092098","RNF31","14",24615892,24629870,13978
"1608","ENSG00000092108","SCFD1","14",31091318,31205018,113700
"1609","ENSG00000092140","G2E3","14",31028329,31089269,60940
"1610","ENSG00000092148","HECTD1","14",31569318,31677010,107692
"1611","ENSG00000092199","HNRNPC","14",21677295,21737653,60358
"1612","ENSG00000092201","SUPT16H","14",21819631,21852425,32794
"1613","ENSG00000092203","TOX4","14",21944756,21967319,22563
"1614","ENSG00000092208","GEMIN2","14",39583427,39606177,22750
"1615","ENSG00000092330","TINF2","14",24708849,24711880,3031
"1616","ENSG00000092377","TBL1Y","Y",6778727,6959724,180997
"1617","ENSG00000092421","SEMA6A","5",115779312,115910630,131318
"1618","ENSG00000092439","TRPM7","15",50844670,50979012,134342
"1619","ENSG00000092445","TYRO3","15",41849873,41871536,21663
"1620","ENSG00000092470","WDR76","15",44119161,44160617,41456
"1621","ENSG00000092531","SNAP23","15",42783431,42837547,54116
"1622","ENSG00000092607","TBX15","1",119425669,119532179,106510
"1623","ENSG00000092621","PHGDH","1",120202421,120286838,84417
"1624","ENSG00000092820","EZR","6",159186773,159240444,53671
"1625","ENSG00000092841","MYL6","12",56551945,56557280,5335
"1626","ENSG00000092847","AGO1","1",36335409,36395211,59802
"1627","ENSG00000092850","TEKT2","1",36549676,36553876,4200
"1628","ENSG00000092853","CLSPN","1",36185819,36235568,49749
"1629","ENSG00000092871","RFFL","17",33333009,33416338,83329
"1630","ENSG00000092931","MFSD11","17",74731947,74777531,45584
"1631","ENSG00000092964","DPYSL2","8",26371791,26515694,143903
"1632","ENSG00000092969","TGFB2","1",218519577,218617961,98384
"1633","ENSG00000092978","GPATCH2","1",217600334,217804424,204090
"1634","ENSG00000093000","NUP50","22",45559722,45583896,24174
"1635","ENSG00000093009","CDC45","22",19466982,19508135,41153
"1636","ENSG00000093010","COMT","22",19929130,19957498,28368
"1637","ENSG00000093072","CECR1","22",17660194,17702879,42685
"1638","ENSG00000093144","ECHDC1","6",127609855,127664754,54899
"1639","ENSG00000093167","LRRFIP2","3",37094117,37225180,131063
"1640","ENSG00000093183","SEC22C","3",42589461,42642572,53111
"1641","ENSG00000093217","XYLB","3",38388251,38462839,74588
"1642","ENSG00000094631","HDAC6","X",48659784,48683392,23608
"1643","ENSG00000094755","GABRP","5",170190354,170241051,50697
"1644","ENSG00000094804","CDC6","17",38443885,38459171,15286
"1645","ENSG00000094841","UPRT","X",74493920,74524435,30515
"1646","ENSG00000094880","CDC23","5",137523339,137549032,25693
"1647","ENSG00000094914","AAAS","12",53701240,53718648,17408
"1648","ENSG00000094916","CBX5","12",54624724,54673886,49162
"1649","ENSG00000094975","SUCO","1",172501489,172580971,79482
"1650","ENSG00000095002","MSH2","2",47630108,47789450,159342
"1651","ENSG00000095015","MAP3K1","5",56111401,56191979,80578
"1652","ENSG00000095059","DHPS","19",12786531,12792716,6185
"1653","ENSG00000095066","HOOK2","19",12873817,12983554,109737
"1654","ENSG00000095139","ARCN1","11",118443105,118473748,30643
"1655","ENSG00000095203","EPB41L4B","9",111934255,112083244,148989
"1656","ENSG00000095209","TMEM38B","9",108456825,108538893,82068
"1657","ENSG00000095261","PSMD5","9",123577774,123605262,27488
"1658","ENSG00000095303","PTGS1","9",125132824,125157982,25158
"1659","ENSG00000095319","NUP188","9",131709978,131769375,59397
"1660","ENSG00000095321","CRAT","9",131857089,131873468,16379
"1661","ENSG00000095370","SH2D3C","9",130500596,130541020,40424
"1662","ENSG00000095380","NANS","9",100819021,100845357,26336
"1663","ENSG00000095383","TBC1D2","9",100961311,101017915,56604
"1664","ENSG00000095397","DFNB31","9",117164360,117267730,103370
"1665","ENSG00000095485","CWF19L1","10",101992055,102027437,35382
"1666","ENSG00000095539","SEMA4G","10",102729275,102745628,16353
"1667","ENSG00000095564","BTAF1","10",93683526,93790082,106556
"1668","ENSG00000095574","IKZF5","10",124750322,124768333,18011
"1669","ENSG00000095587","TLL2","10",98124363,98273675,149312
"1670","ENSG00000095596","CYP26A1","10",94833232,94837647,4415
"1671","ENSG00000095637","SORBS1","10",97071528,97321171,249643
"1672","ENSG00000095739","BAMBI","10",28966271,28971868,5597
"1673","ENSG00000095777","MYO3A","10",26223196,26501456,278260
"1674","ENSG00000095787","WAC","10",28821422,28912041,90619
"1675","ENSG00000095794","CREM","10",35415719,35501886,86167
"1676","ENSG00000095906","NUBP2","16",1832902,1839192,6290
"1677","ENSG00000095951","HIVEP1","6",12008995,12165232,156237
"1678","ENSG00000096060","FKBP5","6",35541362,35696360,154998
"1679","ENSG00000096063","SRPK1","6",35800743,35889119,88376
"1680","ENSG00000096070","BRPF3","6",36164521,36200567,36046
"1681","ENSG00000096080","MRPS18A","6",43639040,43655528,16488
"1682","ENSG00000096092","TMEM14A","6",52535907,52551386,15479
"1683","ENSG00000096093","EFHC1","6",52285106,52387892,102786
"1684","ENSG00000096384","HSP90AB1","6",44214824,44221620,6796
"1685","ENSG00000096401","CDC5L","6",44355262,44418163,62901
"1686","ENSG00000096433","ITPR3","6",33588142,33664351,76209
"1687","ENSG00000096654","ZNF184","6",27418522,27440897,22375
"1688","ENSG00000096717","SIRT1","10",69644427,69678147,33720
"1689","ENSG00000096746","HNRNPH3","10",70090931,70102948,12017
"1690","ENSG00000096872","IFT74","9",26947037,27062928,115891
"1691","ENSG00000096968","JAK2","9",4985033,5128183,143150
"1692","ENSG00000097007","ABL1","9",133589333,133763062,173729
"1693","ENSG00000097021","ACOT7","1",6324329,6454451,130122
"1694","ENSG00000097033","SH3GLB1","1",87170259,87213867,43608
"1695","ENSG00000097046","CDC7","1",91966408,91991321,24913
"1696","ENSG00000097096","SYDE2","1",85622556,85666729,44173
"1697","ENSG00000099139","PCSK5","9",78505560,78977255,471695
"1698","ENSG00000099194","SCD","10",102106881,102124591,17710
"1699","ENSG00000099203","TMED1","19",10943114,10946994,3880
"1700","ENSG00000099204","ABLIM1","10",116190872,116444762,253890
"1701","ENSG00000099219","ERMP1","9",5765076,5833117,68041
"1702","ENSG00000099246","RAB18","10",27793197,27831143,37946
"1703","ENSG00000099250","NRP1","10",33466420,33625190,158770
"1704","ENSG00000099251","HSD17B7P2","10",38645305,38667433,22128
"1705","ENSG00000099256","PRTFDC1","10",25137536,25241533,103997
"1706","ENSG00000099260","PALMD","1",100111499,100160097,48598
"1707","ENSG00000099282","TSPAN15","10",71211229,71267425,56196
"1708","ENSG00000099284","H2AFY2","10",71812552,71872036,59484
"1709","ENSG00000099290","FAM21A","10",51827648,51893269,65621
"1710","ENSG00000099308","MAST3","19",18208603,18262502,53899
"1711","ENSG00000099326","MZF1","19",59073298,59084942,11644
"1712","ENSG00000099330","OCEL1","19",17337013,17340028,3015
"1713","ENSG00000099331","MYO9B","19",17186591,17325346,138755
"1714","ENSG00000099338","CATSPERG","19",38826415,38861589,35174
"1715","ENSG00000099341","PSMD8","19",38865176,38874464,9288
"1716","ENSG00000099364","FBXL19","16",30934376,30960104,25728
"1717","ENSG00000099365","STX1B","16",31000577,31021949,21372
"1718","ENSG00000099377","HSD3B7","16",30996519,31000473,3954
"1719","ENSG00000099381","SETD1A","16",30968615,30996437,27822
"1720","ENSG00000099385","BCL7C","16",30844947,30906281,61334
"1721","ENSG00000099617","EFNA2","19",1286153,1301430,15277
"1722","ENSG00000099622","CIRBP","19",1259384,1274879,15495
"1723","ENSG00000099624","ATP5D","19",1241749,1244824,3075
"1724","ENSG00000099625","C19orf26","19",1228286,1238026,9740
"1725","ENSG00000099715","PCDH11Y","Y",4868267,5610265,741998
"1726","ENSG00000099725","PRKY","Y",7142013,7249589,107576
"1727","ENSG00000099783","HNRNPM","19",8509651,8553998,44347
"1728","ENSG00000099785","MARCH2","19",8478154,8503901,25747
"1729","ENSG00000099795","NDUFB7","19",14676890,14682874,5984
"1730","ENSG00000099797","TECR","19",14627897,14676792,48895
"1731","ENSG00000099800","TIMM13","19",2425622,2427892,2270
"1732","ENSG00000099804","CDC34","19",531714,542097,10383
"1733","ENSG00000099810","MTAP","9",21802542,21931646,129104
"1734","ENSG00000099814","CEP170B","14",105331617,105363107,31490
"1735","ENSG00000099817","POLR2E","19",1086594,1095598,9004
"1736","ENSG00000099821","POLRMT","19",617223,633597,16374
"1737","ENSG00000099840","IZUMO4","19",2096380,2099592,3212
"1738","ENSG00000099849","RASSF7","11",560404,564021,3617
"1739","ENSG00000099860","GADD45B","19",2476120,2478257,2137
"1740","ENSG00000099864","PALM","19",708953,748329,39376
"1741","ENSG00000099875","MKNK2","19",2037470,2051243,13773
"1742","ENSG00000099889","ARVCF","22",19957419,20004331,46912
"1743","ENSG00000099899","TRMT2A","22",20099389,20104915,5526
"1744","ENSG00000099901","RANBP1","22",20103461,20114878,11417
"1745","ENSG00000099904","ZDHHC8","22",20116979,20135530,18551
"1746","ENSG00000099910","KLHL22","22",20783528,20850170,66642
"1747","ENSG00000099917","MED15","22",20850200,20941919,91719
"1748","ENSG00000099940","SNAP29","22",21213271,21245506,32235
"1749","ENSG00000099942","CRKL","22",21271714,21308037,36323
"1750","ENSG00000099949","LZTR1","22",21333751,21353327,19576
"1751","ENSG00000099953","MMP11","22",24110413,24126503,16090
"1752","ENSG00000099954","CECR2","22",17840837,18037850,197013
"1753","ENSG00000099956","SMARCB1","22",24129150,24176703,47553
"1754","ENSG00000099957","P2RX6","22",21364097,21383119,19022
"1755","ENSG00000099958","DERL3","22",24176690,24181315,4625
"1756","ENSG00000099968","BCL2L13","22",18111621,18213388,101767
"1757","ENSG00000099977","DDT","22",24313554,24322660,9106
"1758","ENSG00000099991","CABIN1","22",24407642,24574596,166954
"1759","ENSG00000099992","TBC1D10A","22",30687979,30723035,35056
"1760","ENSG00000099994","SUSD2","22",24577227,24585078,7851
"1761","ENSG00000099995","SF3A1","22",30727977,30752936,24959
"1762","ENSG00000099999","RNF215","22",30773835,30817760,43925
"1763","ENSG00000100003","SEC14L2","22",30792846,30821305,28459
"1764","ENSG00000100014","SPECC1L","22",24666786,24813708,146922
"1765","ENSG00000100023","PPIL2","22",22006559,22054304,47745
"1766","ENSG00000100027","YPEL1","22",22051833,22090123,38290
"1767","ENSG00000100028","SNRPD3","22",24951471,25005947,54476
"1768","ENSG00000100029","PES1","22",30972612,31003070,30458
"1769","ENSG00000100030","MAPK1","22",22108789,22221970,113181
"1770","ENSG00000100033","PRODH","22",18900294,18924066,23772
"1771","ENSG00000100034","PPM1F","22",22273793,22307209,33416
"1772","ENSG00000100036","SLC35E4","22",31031639,31065003,33364
"1773","ENSG00000100038","TOP3B","22",22311397,22337213,25816
"1774","ENSG00000100056","DGCR14","22",19117792,19132197,14405
"1775","ENSG00000100058","CRYBB2P1","22",25844072,25916821,72749
"1776","ENSG00000100060","MFNG","22",37865101,37882439,17338
"1777","ENSG00000100065","CARD10","22",37886400,37915549,29149
"1778","ENSG00000100068","LRP5L","22",25747385,25801344,53959
"1779","ENSG00000100075","SLC25A1","22",19163095,19166343,3248
"1780","ENSG00000100077","ADRBK2","22",25960816,26125261,164445
"1781","ENSG00000100078","PLA2G3","22",31530795,31536593,5798
"1782","ENSG00000100083","GGA1","22",38004481,38029571,25090
"1783","ENSG00000100084","HIRA","22",19318221,19435224,117003
"1784","ENSG00000100092","SH3BP1","22",38030661,38062939,32278
"1785","ENSG00000100095","SEZ6L","22",26565440,26779562,214122
"1786","ENSG00000100097","LGALS1","22",38071615,38075813,4198
"1787","ENSG00000100099","HPS4","22",26839389,26879803,40414
"1788","ENSG00000100100","PIK3IP1","22",31677579,31688520,10941
"1789","ENSG00000100101","NOL12","22",38077680,38170137,92457
"1790","ENSG00000100104","SRRD","22",26879843,26890624,10781
"1791","ENSG00000100105","PATZ1","22",31721790,31742218,20428
"1792","ENSG00000100106","TRIOBP","22",38093011,38172563,79552
"1793","ENSG00000100109","TFIP11","22",26887191,26908471,21280
"1794","ENSG00000100116","GCAT","22",38203912,38213183,9271
"1795","ENSG00000100124","ANKRD54","22",38226862,38245334,18472
"1796","ENSG00000100129","EIF3L","22",38244875,38285414,40539
"1797","ENSG00000100138","NHP2L1","22",42069934,42086508,16574
"1798","ENSG00000100139","MICALL1","22",38301664,38338829,37165
"1799","ENSG00000100142","POLR2F","22",38348614,38437922,89308
"1800","ENSG00000100147","CCDC134","22",42196683,42222303,25620
"1801","ENSG00000100150","DEPDC5","22",32149944,32303012,153068
"1802","ENSG00000100151","PICK1","22",38452318,38471708,19390
"1803","ENSG00000100154","TTC28","22",28374004,29075853,701849
"1804","ENSG00000100162","CENPM","22",42334725,42343168,8443
"1805","ENSG00000100167","SEPT3","22",42372276,42394225,21949
"1806","ENSG00000100196","KDELR3","22",38864067,38879452,15385
"1807","ENSG00000100201","DDX17","22",38879445,38903665,24220
"1808","ENSG00000100206","DMC1","22",38914954,38966291,51337
"1809","ENSG00000100207","TCF20","22",42556019,42739622,183603
"1810","ENSG00000100209","HSCB","22",29138019,29153503,15484
"1811","ENSG00000100211","CBY1","22",39052641,39069859,17218
"1812","ENSG00000100216","TOMM22","22",39077953,39080818,2865
"1813","ENSG00000100218","RTDR1","22",23401593,23487208,85615
"1814","ENSG00000100219","XBP1","22",29190543,29196585,6042
"1815","ENSG00000100220","RTCB","22",32783569,32808242,24673
"1816","ENSG00000100221","JOSD1","22",39081548,39097561,16013
"1817","ENSG00000100225","FBXO7","22",32870663,32894818,24155
"1818","ENSG00000100226","GTPBP1","22",39101728,39134304,32576
"1819","ENSG00000100227","POLDIP3","22",42979727,43010968,31241
"1820","ENSG00000100228","RAB36","22",23487513,23506537,19024
"1821","ENSG00000100234","TIMP3","22",33197687,33259030,61343
"1822","ENSG00000100239","PPP6R2","22",50781733,50883514,101781
"1823","ENSG00000100241","SBF1","22",50883429,50913454,30025
"1824","ENSG00000100242","SUN2","22",39130730,39190148,59418
"1825","ENSG00000100243","CYB5R3","22",43013846,43045574,31728
"1826","ENSG00000100246","DNAL4","22",39174513,39190203,15690
"1827","ENSG00000100258","LMF2","22",50941376,50946135,4759
"1828","ENSG00000100263","RHBDD3","22",29655841,29664198,8357
"1829","ENSG00000100266","PACSIN2","22",43231418,43411151,179733
"1830","ENSG00000100271","TTLL1","22",43435522,43485434,49912
"1831","ENSG00000100280","AP1B1","22",29723669,29819168,95499
"1832","ENSG00000100281","HMGXB4","22",35653445,35691800,38355
"1833","ENSG00000100284","TOM1","22",35695268,35743985,48717
"1834","ENSG00000100285","NEFH","22",29876219,29887379,11160
"1835","ENSG00000100288","CHKB","22",51017378,51039884,22506
"1836","ENSG00000100292","HMOX1","22",35776354,35790207,13853
"1837","ENSG00000100294","MCAT","22",43528212,43539400,11188
"1838","ENSG00000100296","THOC5","22",29901868,29951205,49337
"1839","ENSG00000100297","MCM5","22",35796056,35821423,25367
"1840","ENSG00000100299","ARSA","22",51061182,51066607,5425
"1841","ENSG00000100300","TSPO","22",43547520,43559248,11728
"1842","ENSG00000100304","TTLL12","22",43562628,43583139,20511
"1843","ENSG00000100307","CBX7","22",39516172,39548679,32507
"1844","ENSG00000100311","PDGFB","22",39619364,39640756,21392
"1845","ENSG00000100314","CABP7","22",30116073,30127828,11755
"1846","ENSG00000100316","RPL3","22",39708887,39716394,7507
"1847","ENSG00000100319","ZMAT5","22",30126945,30163000,36055
"1848","ENSG00000100320","RBFOX2","22",36134783,36424473,289690
"1849","ENSG00000100321","SYNGR1","22",39745930,39781593,35663
"1850","ENSG00000100324","TAB1","22",39795746,39833065,37319
"1851","ENSG00000100325","ASCC2","22",30184597,30234271,49674
"1852","ENSG00000100330","MTMR3","22",30279144,30426855,147711
"1853","ENSG00000100335","MIEF1","22",39895437,39914137,18700
"1854","ENSG00000100344","PNPLA3","22",44319619,44360368,40749
"1855","ENSG00000100345","MYH9","22",36677327,36784063,106736
"1856","ENSG00000100347","SAMM50","22",44351301,44406411,55110
"1857","ENSG00000100348","TXN2","22",36863083,36878077,14994
"1858","ENSG00000100350","FOXRED2","22",36883237,36903148,19911
"1859","ENSG00000100353","EIF3D","22",36906897,36925483,18586
"1860","ENSG00000100354","TNRC6B","22",40440821,40731812,290991
"1861","ENSG00000100359","SGSM3","22",40766595,40806293,39698
"1862","ENSG00000100360","IFT27","22",37154246,37172300,18054
"1863","ENSG00000100364","KIAA0930","22",45586219,45636650,50431
"1864","ENSG00000100372","SLC25A17","22",41165634,41215403,49769
"1865","ENSG00000100376","FAM118A","22",45704849,45737836,32987
"1866","ENSG00000100379","KCTD17","22",37447779,37459430,11651
"1867","ENSG00000100380","ST13","22",41220539,41253026,32487
"1868","ENSG00000100387","RBX1","22",41347351,41369313,21962
"1869","ENSG00000100393","EP300","22",41487790,41576081,88291
"1870","ENSG00000100395","L3MBTL2","22",41601209,41627275,26066
"1871","ENSG00000100401","RANGAP1","22",41641615,41682255,40640
"1872","ENSG00000100403","ZC3H7B","22",41697526,41756151,58625
"1873","ENSG00000100410","PHF5A","22",41855721,41864729,9008
"1874","ENSG00000100412","ACO2","22",41865129,41924993,59864
"1875","ENSG00000100413","POLR3H","22",41921808,41940610,18802
"1876","ENSG00000100416","TRMU","22",46726772,46753237,26465
"1877","ENSG00000100417","PMM1","22",41972898,41985894,12996
"1878","ENSG00000100418","DESI1","22",41994032,42017100,23068
"1879","ENSG00000100422","CERK","22",47080308,47134158,53850
"1880","ENSG00000100425","BRD1","22",50166931,50221160,54229
"1881","ENSG00000100426","ZBED4","22",50247490,50283726,36236
"1882","ENSG00000100427","MLC1","22",50497820,50524331,26511
"1883","ENSG00000100433","KCNK10","14",88649113,88793251,144138
"1884","ENSG00000100439","ABHD4","14",23067146,23081265,14119
"1885","ENSG00000100441","KHNYN","14",24898492,24910540,12048
"1886","ENSG00000100442","FKBP3","14",45584803,45604522,19719
"1887","ENSG00000100445","SDR39U1","14",24908972,24912111,3139
"1888","ENSG00000100461","RBM23","14",23369854,23388393,18539
"1889","ENSG00000100462","PRMT5","14",23389720,23398794,9074
"1890","ENSG00000100473","COCH","14",31343720,31364271,20551
"1891","ENSG00000100478","AP4S1","14",31494312,31562818,68506
"1892","ENSG00000100479","POLE2","14",50110273,50155140,44867
"1893","ENSG00000100483","VCPKMT","14",50575350,50583318,7968
"1894","ENSG00000100485","SOS2","14",50583847,50698276,114429
"1895","ENSG00000100490","CDKL1","14",50796310,50883179,86869
"1896","ENSG00000100503","NIN","14",51186481,51297839,111358
"1897","ENSG00000100504","PYGL","14",51324609,51411454,86845
"1898","ENSG00000100505","TRIM9","14",51441980,51562779,120799
"1899","ENSG00000100519","PSMC6","14",53173890,53195305,21415
"1900","ENSG00000100522","GNPNAT1","14",53241912,53258386,16474
"1901","ENSG00000100523","DDHD1","14",53510686,53620000,109314
"1902","ENSG00000100526","CDKN3","14",54863567,54886936,23369
"1903","ENSG00000100528","CNIH1","14",54893654,54908149,14495
"1904","ENSG00000100532","CGRRF1","14",54976530,55005567,29037
"1905","ENSG00000100554","ATP6V1D","14",67761088,67826982,65894
"1906","ENSG00000100564","PIGH","14",68048672,68067004,18332
"1907","ENSG00000100567","PSMA3","14",58711549,58738730,27181
"1908","ENSG00000100568","VTI1B","14",68113792,68141548,27756
"1909","ENSG00000100575","TIMM9","14",58875212,58894332,19120
"1910","ENSG00000100577","GSTZ1","14",77787227,77797940,10713
"1911","ENSG00000100578","KIAA0586","14",58894103,59015216,121113
"1912","ENSG00000100580","TMED8","14",77801364,77843452,42088
"1913","ENSG00000100583","SAMD15","14",77843032,77857840,14808
"1914","ENSG00000100591","AHSA1","14",77924213,77935817,11604
"1915","ENSG00000100592","DAAM1","14",59655364,59838123,182759
"1916","ENSG00000100596","SPTLC2","14",77972340,78083116,110776
"1917","ENSG00000100599","RIN3","14",92980118,93155339,175221
"1918","ENSG00000100600","LGMN","14",93170152,93215047,44895
"1919","ENSG00000100601","ALKBH1","14",78138747,78174363,35616
"1920","ENSG00000100603","SNW1","14",78183942,78227550,43608
"1921","ENSG00000100604","CHGA","14",93389425,93401638,12213
"1922","ENSG00000100605","ITPK1","14",93403259,93582665,179406
"1923","ENSG00000100612","DHRS7","14",60610838,60636574,25736
"1924","ENSG00000100614","PPM1A","14",60712470,60765805,53335
"1925","ENSG00000100625","SIX4","14",61176246,61191066,14820
"1926","ENSG00000100626","GALNT16","14",69725994,69821183,95189
"1927","ENSG00000100629","CEP128","14",80943330,81425861,482531
"1928","ENSG00000100632","ERH","14",69846848,69865344,18496
"1929","ENSG00000100644","HIF1A","14",62162231,62214976,52745
"1930","ENSG00000100647","KIAA0247","14",70078313,70181859,103546
"1931","ENSG00000100650","SRSF5","14",70193617,70238722,45105
"1932","ENSG00000100664","EIF5","14",103799881,103811362,11481
"1933","ENSG00000100678","SLC8A3","14",70510934,70655787,144853
"1934","ENSG00000100697","DICER1","14",95552565,95624347,71782
"1935","ENSG00000100711","ZFYVE21","14",104182067,104200005,17938
"1936","ENSG00000100714","MTHFD1","14",64854749,64926722,71973
"1937","ENSG00000100722","ZC3H14","14",89029253,89079853,50600
"1938","ENSG00000100726","TELO2","16",1543345,1560458,17113
"1939","ENSG00000100731","PCNX","14",71374122,71582099,207977
"1940","ENSG00000100744","GSKIP","14",96829814,96853625,23811
"1941","ENSG00000100749","VRK1","14",97263641,97398059,134418
"1942","ENSG00000100764","PSMC1","14",90722839,90738968,16129
"1943","ENSG00000100767","PAPLN","14",73704205,73741348,37143
"1944","ENSG00000100784","RPS6KA5","14",91336799,91526980,190181
"1945","ENSG00000100796","SMEK1","14",91923955,91976898,52943
"1946","ENSG00000100802","C14orf93","14",23456110,23479375,23265
"1947","ENSG00000100804","PSMB5","14",23485752,23504439,18687
"1948","ENSG00000100811","YY1","14",100704635,100749129,44494
"1949","ENSG00000100813","ACIN1","14",23527773,23564823,37050
"1950","ENSG00000100814","CCNB1IP1","14",20779527,20801471,21944
"1951","ENSG00000100815","TRIP11","14",92432335,92507240,74905
"1952","ENSG00000100823","APEX1","14",20923350,20925927,2577
"1953","ENSG00000100836","PABPN1","14",23790498,23795394,4896
"1954","ENSG00000100842","EFS","14",23825611,23834961,9350
"1955","ENSG00000100852","ARHGAP5","14",32545320,32628934,83614
"1956","ENSG00000100865","CINP","14",102808956,102829253,20297
"1957","ENSG00000100883","SRP54","14",35451163,35498773,47610
"1958","ENSG00000100888","CHD8","14",21853353,21924285,70932
"1959","ENSG00000100889","PCK2","14",24563262,24579807,16545
"1960","ENSG00000100890","KIAA0391","14",35591052,35743271,152219
"1961","ENSG00000100897","DCAF11","14",24583404,24594451,11047
"1962","ENSG00000100902","PSMA6","14",35747839,35786699,38860
"1963","ENSG00000100906","NFKBIA","14",35870717,35873955,3238
"1964","ENSG00000100908","EMC9","14",24608174,24610797,2623
"1965","ENSG00000100911","PSME2","14",24612574,24616779,4205
"1966","ENSG00000100916","BRMS1L","14",36295524,36401531,106007
"1967","ENSG00000100918","REC8","14",24641062,24649463,8401
"1968","ENSG00000100926","TM9SF1","14",24658349,24682679,24330
"1969","ENSG00000100934","SEC23A","14",39501123,39578850,77727
"1970","ENSG00000100938","GMPR2","14",24701628,24708448,6820
"1971","ENSG00000100941","PNN","14",39644387,39652422,8035
"1972","ENSG00000100949","RABGGTA","14",24734744,24740945,6201
"1973","ENSG00000100968","NFATC4","14",24834879,24848810,13931
"1974","ENSG00000100979","PLTP","20",44527399,44540794,13395
"1975","ENSG00000100982","PCIF1","20",44563267,44576662,13395
"1976","ENSG00000100983","GSS","20",33516236,33543620,27384
"1977","ENSG00000100987","VSX1","20",25051521,25062996,11475
"1978","ENSG00000100991","TRPC4AP","20",33590207,33680674,90467
"1979","ENSG00000100994","PYGB","20",25228705,25278650,49945
"1980","ENSG00000100997","ABHD12","20",25275379,25371619,96240
"1981","ENSG00000101003","GINS1","20",25388363,25433264,44901
"1982","ENSG00000101004","NINL","20",25433341,25566153,132812
"1983","ENSG00000101019","UQCC1","20",33890369,33999944,109575
"1984","ENSG00000101040","ZMYND8","20",45837859,45985567,147708
"1985","ENSG00000101052","IFT52","20",42219571,42275936,56365
"1986","ENSG00000101057","MYBL2","20",42295754,42345136,49382
"1987","ENSG00000101079","NDRG3","20",35280169,35374481,94312
"1988","ENSG00000101084","C20orf24","20",35234137,35240960,6823
"1989","ENSG00000101098","RIMS4","20",43380449,43438979,58530
"1990","ENSG00000101104","PABPC1L","20",43538703,43587676,48973
"1991","ENSG00000101109","STK4","20",43595115,43708600,113485
"1992","ENSG00000101115","SALL4","20",50400581,50419059,18478
"1993","ENSG00000101126","ADNP","20",49505585,49547958,42373
"1994","ENSG00000101132","PFDN4","20",52824386,52844591,20205
"1995","ENSG00000101134","DOK5","20",53092136,53267710,175574
"1996","ENSG00000101138","CSTF1","20",54967427,54979518,12091
"1997","ENSG00000101144","BMP7","20",55743804,55841685,97881
"1998","ENSG00000101146","RAE1","20",55926066,55954267,28201
"1999","ENSG00000101150","TPD52L2","20",62496596,62522898,26302
"2000","ENSG00000101152","DNAJC5","20",62526518,62567384,40866
"2001","ENSG00000101158","NELFCD","20",57556263,57570188,13925
"2002","ENSG00000101160","CTSZ","20",57570240,57582302,12062
"2003","ENSG00000101161","PRPF6","20",62612488,62664453,51965
"2004","ENSG00000101166","SLMO2","20",57608200,57617964,9764
"2005","ENSG00000101181","MTG2","20",60758085,60778624,20539
"2006","ENSG00000101182","PSMA7","20",60711791,60718496,6705
"2007","ENSG00000101188","NTSR1","20",61340189,61394123,53934
"2008","ENSG00000101189","MRGBP","20",61427805,61431945,4140
"2009","ENSG00000101190","TCFL5","20",61472467,61493115,20648
"2010","ENSG00000101191","DIDO1","20",61509090,61569304,60214
"2011","ENSG00000101193","GID8","20",61569471,61576996,7525
"2012","ENSG00000101198","NKAIN4","20",61872136,61904046,31910
"2013","ENSG00000101199","ARFGAP1","20",61904137,61921142,17005
"2014","ENSG00000101210","EEF1A2","20",62119366,62130505,11139
"2015","ENSG00000101216","GMEB2","20",62218955,62258394,39439
"2016","ENSG00000101220","C20orf27","20",3734155,3749034,14879
"2017","ENSG00000101224","CDC25B","20",3767578,3786762,19184
"2018","ENSG00000101236","RNF24","20",3907956,3996229,88273
"2019","ENSG00000101246","ARFRP1","20",62329996,62339377,9381
"2020","ENSG00000101247","NDUFAF5","20",13765596,13799067,33471
"2021","ENSG00000101255","TRIB3","20",361261,378203,16942
"2022","ENSG00000101265","RASSF2","20",4760669,4804291,43622
"2023","ENSG00000101266","CSNK2A1","20",459116,524465,65349
"2024","ENSG00000101290","CDS2","20",5107432,5178533,71101
"2025","ENSG00000101294","HM13","20",30102231,30157370,55139
"2026","ENSG00000101298","SNPH","20",1246960,1289972,43012
"2027","ENSG00000101306","MYLK2","20",30407111,30422492,15381
"2028","ENSG00000101310","SEC23B","20",18488137,18542059,53922
"2029","ENSG00000101333","PLCB4","20",9049410,9461889,412479
"2030","ENSG00000101335","MYL9","20",35169887,35178228,8341
"2031","ENSG00000101337","TM9SF4","20",30697309,30755061,57752
"2032","ENSG00000101343","CRNKL1","20",20015012,20036690,21678
"2033","ENSG00000101346","POFUT1","20",30795683,30826470,30787
"2034","ENSG00000101347","SAMHD1","20",35518632,35580246,61614
"2035","ENSG00000101349","PAK7","20",9518036,9819689,301653
"2036","ENSG00000101350","KIF3B","20",30865467,30922814,57347
"2037","ENSG00000101353","MROH8","20",35729629,35807991,78362
"2038","ENSG00000101361","NOP56","20",2632791,2639039,6248
"2039","ENSG00000101363","MANBAL","20",35918041,35945663,27622
"2040","ENSG00000101365","IDH3B","20",2639041,2644865,5824
"2041","ENSG00000101367","MAPRE1","20",31407699,31438211,30512
"2042","ENSG00000101384","JAG1","20",10618332,10654694,36362
"2043","ENSG00000101391","CDK5RAP1","20",31946645,31989367,42722
"2044","ENSG00000101400","SNTA1","20",31995761,32031698,35937
"2045","ENSG00000101407","TTI1","20",36611409,36661870,50461
"2046","ENSG00000101412","E2F1","20",32263489,32274210,10721
"2047","ENSG00000101413","RPRD1B","20",36661948,36720768,58820
"2048","ENSG00000101417","PXMP4","20",32294512,32308125,13613
"2049","ENSG00000101421","CHMP4B","20",32399110,32442172,43062
"2050","ENSG00000101439","CST3","20",23608534,23619110,10576
"2051","ENSG00000101442","ACTR5","20",37377085,37400834,23749
"2052","ENSG00000101444","AHCY","20",32868074,32899608,31534
"2053","ENSG00000101445","PPP1R16B","20",37434348,37551667,117319
"2054","ENSG00000101447","FAM83D","20",37554955,37581703,26748
"2055","ENSG00000101452","DHX35","20",37590942,37668366,77424
"2056","ENSG00000101457","DNTTIP1","20",44420576,44440066,19490
"2057","ENSG00000101460","MAP1LC3A","20",33134658,33148149,13491
"2058","ENSG00000101463","SYNDIG1","20",24449835,24647252,197417
"2059","ENSG00000101464","PIGU","20",33148346,33264910,116564
"2060","ENSG00000101473","ACOT8","20",44470360,44486045,15685
"2061","ENSG00000101474","APMAP","20",24943561,24973615,30054
"2062","ENSG00000101489","CELF4","18",34823010,35146000,322990
"2063","ENSG00000101493","ZNF516","18",74069644,74207146,137502
"2064","ENSG00000101542","CDH20","18",59000815,59223006,222191
"2065","ENSG00000101544","ADNP2","18",77866915,77905406,38491
"2066","ENSG00000101546","RBFA","18",77794358,77806397,12039
"2067","ENSG00000101557","USP14","18",158383,214629,56246
"2068","ENSG00000101558","VAPA","18",9913999,9960018,46019
"2069","ENSG00000101574","METTL4","18",2537524,2571508,33984
"2070","ENSG00000101577","LPIN2","18",2916992,3013313,96321
"2071","ENSG00000101596","SMCHD1","18",2655737,2805015,149278
"2072","ENSG00000101605","MYOM1","18",3066805,3220106,153301
"2073","ENSG00000101608","MYL12A","18",3247479,3256234,8755
"2074","ENSG00000101624","CEP76","18",12661832,12702776,40944
"2075","ENSG00000101639","CEP192","18",12991361,13125051,133690
"2076","ENSG00000101654","RNMT","18",13726659,13764557,37898
"2077","ENSG00000101665","SMAD7","18",46446223,46477081,30858
"2078","ENSG00000101670","LIPG","18",47087069,47119272,32203
"2079","ENSG00000101680","LAMA1","18",6941743,7117813,176070
"2080","ENSG00000101695","RNF125","18",29598335,29653176,54841
"2081","ENSG00000101745","ANKRD12","18",9136226,9285983,149757
"2082","ENSG00000101746","NOL4","18",31431064,31804916,373852
"2083","ENSG00000101751","POLI","18",51795774,51847636,51862
"2084","ENSG00000101752","MIB1","18",19284918,19450918,166000
"2085","ENSG00000101773","RBBP8","18",20378224,20606451,228227
"2086","ENSG00000101782","RIOK3","18",21032787,21066567,33780
"2087","ENSG00000101811","CSTF2","X",100075384,100095921,20537
"2088","ENSG00000101825","MXRA5","X",3226606,3264682,38076
"2089","ENSG00000101843","PSMD10","X",107327437,107334848,7411
"2090","ENSG00000101844","ATG4A","X",107334898,107397901,63003
"2091","ENSG00000101846","STS","X",7137497,7272851,135354
"2092","ENSG00000101849","TBL1X","X",9431335,9687780,256445
"2093","ENSG00000101856","PGRMC1","X",118370216,118378429,8213
"2094","ENSG00000101868","POLA1","X",24712036,25015103,303067
"2095","ENSG00000101871","MID1","X",10413350,10851773,438423
"2096","ENSG00000101882","NKAP","X",119059014,119077735,18721
"2097","ENSG00000101888","NXT2","X",108779010,108787919,8909
"2098","ENSG00000101890","GUCY2F","X",108616135,108725301,109166
"2099","ENSG00000101898","","20",30135307,30135852,545
"2100","ENSG00000101901","ALG13","X",110909043,111003877,94834
"2101","ENSG00000101911","PRPS2","X",12809474,12842341,32867
"2102","ENSG00000101928","MOSPD1","X",134021656,134049297,27641
"2103","ENSG00000101935","AMMECR1","X",109437414,109683461,246047
"2104","ENSG00000101938","CHRDL1","X",109917084,110039286,122202
"2105","ENSG00000101940","WDR13","X",48448430,48463581,15151
"2106","ENSG00000101945","SUV39H1","X",48553945,48567403,13458
"2107","ENSG00000101955","SRPX","X",38008589,38080696,72107
"2108","ENSG00000101958","GLRA2","X",14547420,14749934,202514
"2109","ENSG00000101966","XIAP","X",122993574,123047829,54255
"2110","ENSG00000101972","STAG2","X",123094062,123556514,462452
"2111","ENSG00000101974","ATP11C","X",138808505,139027435,218930
"2112","ENSG00000101977","MCF2","X",138663929,138790386,126457
"2113","ENSG00000101986","ABCD1","X",152990323,153010216,19893
"2114","ENSG00000101997","CCDC22","X",49091927,49106987,15060
"2115","ENSG00000102003","SYP","X",49044269,49056718,12449
"2116","ENSG00000102007","PLP2","X",49028273,49031588,3315
"2117","ENSG00000102024","PLS3","X",114795501,114885181,89680
"2118","ENSG00000102030","NAA10","X",153194695,153200676,5981
"2119","ENSG00000102032","RENBP","X",153200716,153210232,9516
"2120","ENSG00000102034","ELF4","X",129198849,129244691,45842
"2121","ENSG00000102038","SMARCA1","X",128580480,128657477,76997
"2122","ENSG00000102043","MTMR8","X",63444187,63615333,171146
"2123","ENSG00000102053","ZC3H12B","X",64708615,64727767,19152
"2124","ENSG00000102054","RBBP7","X",16857406,16888537,31131
"2125","ENSG00000102078","SLC25A14","X",129473874,129507335,33461
"2126","ENSG00000102081","FMR1","X",146993469,147032645,39176
"2127","ENSG00000102096","PIM2","X",48770459,48776301,5842
"2128","ENSG00000102098","SCML2","X",18257434,18372847,115413
"2129","ENSG00000102100","SLC35A2","X",48760459,48769235,8776
"2130","ENSG00000102103","PQBP1","X",48755195,48760420,5225
"2131","ENSG00000102119","EMD","X",153607557,153609883,2326
"2132","ENSG00000102125","TAZ","X",153639854,153650065,10211
"2133","ENSG00000102144","PGK1","X",77320685,77384793,64108
"2134","ENSG00000102158","MAGT1","X",77081861,77151090,69229
"2135","ENSG00000102172","SMS","X",21958691,22025798,67107
"2136","ENSG00000102174","PHEX","X",22050559,22269427,218868
"2137","ENSG00000102178","UBL4A","X",153712056,153715009,2953
"2138","ENSG00000102181","CD99L2","X",149934810,150067289,132479
"2139","ENSG00000102189","EEA1","12",93164413,93323107,158694
"2140","ENSG00000102218","RP2","X",46696375,46741793,45418
"2141","ENSG00000102221","JADE3","X",46771711,46920641,148930
"2142","ENSG00000102225","CDK16","X",47077259,47089396,12137
"2143","ENSG00000102226","USP11","X",47092089,47107727,15638
"2144","ENSG00000102230","PCYT1B","X",24576204,24690794,114590
"2145","ENSG00000102241","HTATSF1","X",135579238,135594505,15267
"2146","ENSG00000102265","TIMP1","X",47441712,47446188,4476
"2147","ENSG00000102271","KLHL4","X",86772752,86925050,152298
"2148","ENSG00000102287","GABRE","X",151121596,151143152,21556
"2149","ENSG00000102290","PCDH11X","X",91034260,91878229,843969
"2150","ENSG00000102302","FGD1","X",54471887,54522599,50712
"2151","ENSG00000102309","PIN4","X",71401203,71522776,121573
"2152","ENSG00000102312","PORCN","X",48367350,48379202,11852
"2153","ENSG00000102316","MAGED2","X",54834032,54842445,8413
"2154","ENSG00000102317","RBM3","X",48432837,48437454,4617
"2155","ENSG00000102359","SRPX2","X",99899215,99926296,27081
"2156","ENSG00000102362","SYTL4","X",99929488,99987110,57622
"2157","ENSG00000102383","ZDHHC15","X",74588262,74743337,155075
"2158","ENSG00000102384","CENPI","X",100353178,100418670,65492
"2159","ENSG00000102385","DRP2","X",100474758,100519486,44728
"2160","ENSG00000102390","PBDC1","X",75392771,75398039,5268
"2161","ENSG00000102393","GLA","X",100652791,100662913,10122
"2162","ENSG00000102401","ARMCX3","X",100877787,100882833,5046
"2163","ENSG00000102409","BEX4","X",102470020,102472174,2154
"2164","ENSG00000102452","NALCN","13",101706130,102068843,362713
"2165","ENSG00000102466","FGF14","13",102372134,103054124,681990
"2166","ENSG00000102471","NDFIP2","13",80055287,80130210,74923
"2167","ENSG00000102524","TNFSF13B","13",108903588,108960832,57244
"2168","ENSG00000102531","FNDC3A","13",49550048,49783915,233867
"2169","ENSG00000102543","CDADC1","13",49822047,49867618,45571
"2170","ENSG00000102547","CAB39L","13",49882786,50018262,135476
"2171","ENSG00000102554","KLF5","13",73629114,73651676,22562
"2172","ENSG00000102572","STK24","13",99102455,99230194,127739
"2173","ENSG00000102580","DNAJC3","13",96329393,96447243,117850
"2174","ENSG00000102595","UGGT2","13",96453834,96705736,251902
"2175","ENSG00000102606","ARHGEF7","13",111766906,111958084,191178
"2176","ENSG00000102678","FGF9","13",22245522,22278637,33115
"2177","ENSG00000102683","SGCG","13",23755091,23899304,144213
"2178","ENSG00000102699","PARP4","13",24995064,25086948,91884
"2179","ENSG00000102710","SUPT20H","13",37583449,37633850,50401
"2180","ENSG00000102738","MRPS31","13",41303432,41345309,41877
"2181","ENSG00000102743","SLC25A15","13",41363548,41384247,20699
"2182","ENSG00000102753","KPNA3","13",50273447,50367057,93610
"2183","ENSG00000102760","RGCC","13",42031695,42045018,13323
"2184","ENSG00000102763","VWA8","13",42140973,42535256,394283
"2185","ENSG00000102780","DGKH","13",42614176,42830714,216538
"2186","ENSG00000102781","KATNAL1","13",30776767,30881621,104854
"2187","ENSG00000102786","INTS6","13",51928213,52028400,100187
"2188","ENSG00000102796","DHRS12","13",52342129,52378293,36164
"2189","ENSG00000102804","TSC22D1","13",45007655,45151283,143628
"2190","ENSG00000102805","CLN5","13",77564795,77576652,11857
"2191","ENSG00000102837","OLFM4","13",53602894,53626192,23298
"2192","ENSG00000102858","MGRN1","16",4666494,4740975,74481
"2193","ENSG00000102870","ZNF629","16",30789778,30798523,8745
"2194","ENSG00000102879","CORO1A","16",30194148,30200397,6249
"2195","ENSG00000102882","MAPK3","16",30125426,30134827,9401
"2196","ENSG00000102886","GDPD3","16",30116131,30125177,9046
"2197","ENSG00000102890","ELMO3","16",67233014,67237932,4918
"2198","ENSG00000102893","PHKB","16",47495034,47735434,240400
"2199","ENSG00000102897","LYRM1","16",20911190,20936328,25138
"2200","ENSG00000102898","NUTF2","16",67880635,67906470,25835
"2201","ENSG00000102900","NUP93","16",56764017,56878797,114780
"2202","ENSG00000102901","CENPT","16",67862060,67881714,19654
"2203","ENSG00000102904","TSNAXIP1","16",67840668,67866051,25383
"2204","ENSG00000102908","NFAT5","16",69598997,69738569,139572
"2205","ENSG00000102910","LONP2","16",48278207,48397033,118826
"2206","ENSG00000102921","N4BP1","16",48572637,48654059,81422
"2207","ENSG00000102931","ARL2BP","16",57279010,57287516,8506
"2208","ENSG00000102935","ZNF423","16",49521435,49891830,370395
"2209","ENSG00000102967","DHODH","16",72042487,72058954,16467
"2210","ENSG00000102974","CTCF","16",67596310,67673086,76776
"2211","ENSG00000102977","ACD","16",67691415,67694713,3298
"2212","ENSG00000102978","POLR2C","16",57496299,57505922,9623
"2213","ENSG00000102981","PARD6A","16",67694849,67696681,1832
"2214","ENSG00000102984","ZNF821","16",71893583,71929239,35656
"2215","ENSG00000102996","MMP15","16",58059470,58080805,21335
"2216","ENSG00000103005","USB1","16",58033450,58055522,22072
"2217","ENSG00000103018","CYB5B","16",69458428,69500169,41741
"2218","ENSG00000103021","CCDC113","16",58265061,58317740,52679
"2219","ENSG00000103024","NME3","16",1820287,1821731,1444
"2220","ENSG00000103034","NDRG4","16",58496750,58547532,50782
"2221","ENSG00000103035","PSMD7","16",74330673,74340186,9513
"2222","ENSG00000103037","SETD6","16",58549383,58554431,5048
"2223","ENSG00000103042","SLC38A7","16",58699013,58719008,19995
"2224","ENSG00000103043","VAC14","16",70721342,70835064,113722
"2225","ENSG00000103047","TANGO6","16",68877507,69119083,241576
"2226","ENSG00000103051","COG4","16",70514471,70557468,42997
"2227","ENSG00000103056","SMPD3","16",68392231,68482591,90360
"2228","ENSG00000103061","SLC7A6OS","16",68318406,68344849,26443
"2229","ENSG00000103064","SLC7A6","16",68298433,68335722,37289
"2230","ENSG00000103066","PLA2G15","16",68279207,68294961,15754
"2231","ENSG00000103091","WDR59","16",74907468,75034071,126603
"2232","ENSG00000103111","MON1B","16",77224732,77236302,11570
"2233","ENSG00000103121","CMC2","16",81009698,81053875,44177
"2234","ENSG00000103126","AXIN1","16",337440,402673,65233
"2235","ENSG00000103145","HCFC1R1","16",3072621,3074287,1666
"2236","ENSG00000103148","NPRL3","16",134273,188859,54586
"2237","ENSG00000103150","MLYCD","16",83932731,83949787,17056
"2238","ENSG00000103152","MPG","16",127006,135852,8846
"2239","ENSG00000103154","NECAB2","16",84002237,84036381,34144
"2240","ENSG00000103160","HSDL1","16",84155886,84178797,22911
"2241","ENSG00000103168","TAF1C","16",84211458,84220669,9211
"2242","ENSG00000103174","NAGPA","16",5074845,5084142,9297
"2243","ENSG00000103175","WFDC1","16",84328252,84363450,35198
"2244","ENSG00000103187","COTL1","16",84599200,84651683,52483
"2245","ENSG00000103194","USP10","16",84733584,84813528,79944
"2246","ENSG00000103196","CRISPLD2","16",84853590,84954374,100784
"2247","ENSG00000103197","TSC2","16",2097466,2138716,41250
"2248","ENSG00000103199","ZNF500","16",4798240,4817625,19385
"2249","ENSG00000103202","NME4","16",446725,460367,13642
"2250","ENSG00000103222","ABCC1","16",16043434,16236931,193497
"2251","ENSG00000103226","NOMO3","16",16326352,16388668,62316
"2252","ENSG00000103227","LMF1","16",903634,1031318,127684
"2253","ENSG00000103245","NARFL","16",779753,791329,11576
"2254","ENSG00000103248","MTHFSD","16",86563782,86588841,25059
"2255","ENSG00000103249","CLCN7","16",1494935,1525581,30646
"2256","ENSG00000103253","HAGHL","16",776936,785525,8589
"2257","ENSG00000103254","FAM173A","16",770581,772601,2020
"2258","ENSG00000103257","SLC7A5","16",87863629,87903094,39465
"2259","ENSG00000103260","METRN","16",765115,769655,4540
"2260","ENSG00000103264","FBXO31","16",87360593,87425748,65155
"2261","ENSG00000103266","STUB1","16",730224,732870,2646
"2262","ENSG00000103274","NUBP1","16",10837643,10863208,25565
"2263","ENSG00000103275","UBE2I","16",1355548,1377019,21471
"2264","ENSG00000103319","EEF2K","16",22217603,22298554,80951
"2265","ENSG00000103326","CAPN15","16",577717,604636,26919
"2266","ENSG00000103335","PIEZO1","16",88781751,88851619,69868
"2267","ENSG00000103342","GSPT1","16",11961985,12009939,47954
"2268","ENSG00000103343","ZNF174","16",3451235,3459370,8135
"2269","ENSG00000103351","CLUAP1","16",3550924,3589048,38124
"2270","ENSG00000103353","UBFD1","16",23568392,23585710,17318
"2271","ENSG00000103356","EARS2","16",23533335,23569052,35717
"2272","ENSG00000103363","TCEB2","16",2821415,2827298,5883
"2273","ENSG00000103365","GGA2","16",23474863,23533316,58453
"2274","ENSG00000103381","CPPED1","16",12756919,12897874,140955
"2275","ENSG00000103404","USP31","16",23072727,23160591,87864
"2276","ENSG00000103415","HMOX2","16",4524691,4560348,35657
"2277","ENSG00000103423","DNAJA3","16",4475806,4506776,30970
"2278","ENSG00000103429","BFAR","16",14726672,14763093,36421
"2279","ENSG00000103449","SALL1","16",51169886,51185278,15392
"2280","ENSG00000103460","TOX3","16",52471917,52581714,109797
"2281","ENSG00000103479","RBL2","16",53467889,53525561,57672
"2282","ENSG00000103485","QPRT","16",29674600,29710020,35420
"2283","ENSG00000103489","XYLT1","16",17195626,17564738,369112
"2284","ENSG00000103494","RPGRIP1L","16",53631595,53737850,106255
"2285","ENSG00000103495","MAZ","16",29817427,29823649,6222
"2286","ENSG00000103496","STX4","16",31044210,31054296,10086
"2287","ENSG00000103502","CDIPT","16",29869678,29875057,5379
"2288","ENSG00000103507","BCKDK","16",31117428,31124110,6682
"2289","ENSG00000103510","KAT8","16",31127075,31142714,15639
"2290","ENSG00000103512","NOMO1","16",14927538,14990017,62479
"2291","ENSG00000103528","SYT17","16",19179293,19279652,100359
"2292","ENSG00000103540","CCP110","16",19535133,19564730,29597
"2293","ENSG00000103544","C16orf62","16",19566562,19718115,151553
"2294","ENSG00000103549","RNF40","16",30773066,30787628,14562
"2295","ENSG00000103550","KNOP1","16",19714902,19729557,14655
"2296","ENSG00000103591","AAGAB","15",67493371,67547533,54162
"2297","ENSG00000103599","IQCH","15",67547138,67794598,247460
"2298","ENSG00000103642","LACTB","15",63413999,63434260,20261
"2299","ENSG00000103647","CORO2B","15",68871308,69020145,148837
"2300","ENSG00000103653","CSK","15",75074398,75095539,21141
"2301","ENSG00000103657","HERC1","15",63900817,64126141,225324
"2302","ENSG00000103671","TRIP4","15",64679947,64747502,67555
"2303","ENSG00000103707","MTFMT","15",65294845,65321977,27132
"2304","ENSG00000103723","AP3B2","15",83328033,83378666,50633
"2305","ENSG00000103740","ACSBG1","15",78459810,78538030,78220
"2306","ENSG00000103742","IGDCC4","15",65673802,65715410,41608
"2307","ENSG00000103769","RAB11A","15",66018392,66184329,165937
"2308","ENSG00000103811","CTSH","15",79213400,79241916,28516
"2309","ENSG00000103852","TTC23","15",99676528,99791428,114900
"2310","ENSG00000103855","CD276","15",73976307,74006859,30552
"2311","ENSG00000103876","FAH","15",80444832,80479288,34456
"2312","ENSG00000103888","KIAA1199","15",81071684,81244117,172433
"2313","ENSG00000103932","RPAP1","15",41809374,41836467,27093
"2314","ENSG00000103942","HOMER2","15",83509838,83654661,144823
"2315","ENSG00000103966","EHD4","15",42190950,42264776,73826
"2316","ENSG00000103978","TMEM87A","15",42502730,42565861,63131
"2317","ENSG00000103994","ZNF106","15",42705021,42783321,78300
"2318","ENSG00000103995","CEP152","15",49005125,49103343,98218
"2319","ENSG00000104047","DTWD1","15",49913177,49937333,24156
"2320","ENSG00000104059","FAM189A1","15",29412457,29862927,450470
"2321","ENSG00000104064","GABPB1","15",50569389,50647605,78216
"2322","ENSG00000104067","TJP1","15",29991571,30261068,269497
"2323","ENSG00000104081","BMF","15",40380091,40401093,21002
"2324","ENSG00000104093","DMXL2","15",51739908,51915030,175122
"2325","ENSG00000104112","SCG3","15",51973550,52013223,39673
"2326","ENSG00000104129","DNAJC17","15",41060067,41099675,39608
"2327","ENSG00000104131","EIF3J","15",44829255,44855227,25972
"2328","ENSG00000104133","SPG11","15",44854894,44955876,100982
"2329","ENSG00000104142","VPS18","15",41186628,41196173,9545
"2330","ENSG00000104147","OIP5","15",41601466,41624819,23353
"2331","ENSG00000104154","SLC30A4","15",45771809,45815005,43196
"2332","ENSG00000104164","BLOC1S6","15",45879321,45908197,28876
"2333","ENSG00000104177","MYEF2","15",48431625,48470714,39089
"2334","ENSG00000104205","SGK3","8",67624653,67774257,149604
"2335","ENSG00000104218","CSPP1","8",67974661,68108498,133837
"2336","ENSG00000104219","ZDHHC2","8",17013538,17082308,68770
"2337","ENSG00000104221","BRF2","8",37700786,37707422,6636
"2338","ENSG00000104228","TRIM35","8",27142404,27168836,26432
"2339","ENSG00000104231","ZFAND1","8",82613569,82645138,31569
"2340","ENSG00000104267","CA2","8",86376081,86393722,17641
"2341","ENSG00000104290","FZD3","8",28351729,28431775,80046
"2342","ENSG00000104299","INTS9","8",28625178,28747759,122581
"2343","ENSG00000104312","RIPK2","8",90769975,90803291,33316
"2344","ENSG00000104313","EYA1","8",72109668,72274467,164799
"2345","ENSG00000104320","NBN","8",90945564,91015456,69892
"2346","ENSG00000104324","CPQ","8",97657455,98161882,504427
"2347","ENSG00000104325","DECR1","8",91013633,91064320,50687
"2348","ENSG00000104327","CALB1","8",91070836,91107703,36867
"2349","ENSG00000104331","IMPAD1","8",57870492,57906403,35911
"2350","ENSG00000104332","SFRP1","8",41119481,41167016,47535
"2351","ENSG00000104341","LAPTM4B","8",98787285,98865241,77956
"2352","ENSG00000104343","UBE2W","8",74692332,74791145,98813
"2353","ENSG00000104356","POP1","8",99129525,99172062,42537
"2354","ENSG00000104361","NIPAL2","8",99202061,99306621,104560
"2355","ENSG00000104365","IKBKB","8",42128820,42189973,61153
"2356","ENSG00000104368","PLAT","8",42032236,42065242,33006
"2357","ENSG00000104369","JPH1","8",75146935,75233563,86628
"2358","ENSG00000104375","STK3","8",99413631,99955055,541424
"2359","ENSG00000104381","GDAP1","8",75233365,75401107,167742
"2360","ENSG00000104388","RAB2A","8",61429416,61536186,106770
"2361","ENSG00000104408","EIF3E","8",109213445,109447562,234117
"2362","ENSG00000104412","EMC2","8",109455830,109499145,43315
"2363","ENSG00000104419","NDRG1","8",134249414,134314265,64851
"2364","ENSG00000104427","ZC2HC1A","8",79578282,79632000,53718
"2365","ENSG00000104435","STMN2","8",80523049,80578410,55361
"2366","ENSG00000104442","ARMC1","8",66514694,66546442,31748
"2367","ENSG00000104447","TRPS1","8",116420724,116821899,401175
"2368","ENSG00000104450","SPAG1","8",101170134,101271506,101372
"2369","ENSG00000104472","CHRAC1","8",141521397,141527236,5839
"2370","ENSG00000104490","NCALD","8",102698771,103137135,438364
"2371","ENSG00000104497","SNX16","8",82711816,82755101,43285
"2372","ENSG00000104517","UBR5","8",103265240,103425069,159829
"2373","ENSG00000104518","GSDMD","8",144635377,144645232,9855
"2374","ENSG00000104522","TSTA3","8",144694788,144700218,5430
"2375","ENSG00000104524","PYCRL","8",144686083,144691943,5860
"2376","ENSG00000104529","EEF1D","8",144661867,144681711,19844
"2377","ENSG00000104549","SQLE","8",126010739,126034525,23786
"2378","ENSG00000104611","SH2D4A","8",19171128,19253729,82601
"2379","ENSG00000104613","INTS10","8",19674651,19709594,34943
"2380","ENSG00000104626","ERI1","8",8859657,8974256,114599
"2381","ENSG00000104635","SLC39A14","8",22224762,22291642,66880
"2382","ENSG00000104643","MTMR9","8",11141925,11185646,43721
"2383","ENSG00000104660","LEPROTL1","8",29952914,30034724,81810
"2384","ENSG00000104671","DCTN6","8",30013813,30041156,27343
"2385","ENSG00000104679","R3HCC1","8",23127633,23153792,26159
"2386","ENSG00000104687","GSR","8",30535583,30585443,49860
"2387","ENSG00000104689","TNFRSF10A","8",23047965,23082639,34674
"2388","ENSG00000104691","UBXN8","8",30589764,30624522,34758
"2389","ENSG00000104695","PPP2CB","8",30631973,30671830,39857
"2390","ENSG00000104714","ERICH1","8",564746,688106,123360
"2391","ENSG00000104722","NEFM","8",24770525,24776607,6082
"2392","ENSG00000104723","TUSC3","8",15274724,15624158,349434
"2393","ENSG00000104725","NEFL","8",24808468,24814624,6156
"2394","ENSG00000104728","ARHGEF10","8",1772142,1906807,134665
"2395","ENSG00000104731","KLHDC4","16",87730091,87799598,69507
"2396","ENSG00000104738","MCM4","8",48872745,48890720,17975
"2397","ENSG00000104756","KCTD9","8",25285366,25315992,30626
"2398","ENSG00000104763","ASAH1","8",17913934,17942494,28560
"2399","ENSG00000104765","BNIP3L","8",26240414,26363152,122738
"2400","ENSG00000104774","MAN2B1","19",12757325,12777556,20231
"2401","ENSG00000104805","NUCB1","19",49403307,49426629,23322
"2402","ENSG00000104812","GYS1","19",49471382,49496567,25185
"2403","ENSG00000104823","ECH1","19",39306062,39322645,16583
"2404","ENSG00000104824","HNRNPL","19",39327028,39342987,15959
"2405","ENSG00000104825","NFKBIB","19",39390340,39399533,9193
"2406","ENSG00000104835","SARS2","19",39405906,39440495,34589
"2407","ENSG00000104852","SNRNP70","19",49588676,49611862,23186
"2408","ENSG00000104853","CLPTM1","19",45457842,45496599,38757
"2409","ENSG00000104856","RELB","19",45504688,45541452,36764
"2410","ENSG00000104859","CLASRP","19",45542298,45574214,31916
"2411","ENSG00000104863","LIN7B","19",49617581,49621717,4136
"2412","ENSG00000104866","PPP1R37","19",45594654,45651335,56681
"2413","ENSG00000104870","FCGRT","19",50010073,50029590,19517
"2414","ENSG00000104872","PIH1D1","19",49949555,49956754,7199
"2415","ENSG00000104880","ARHGEF18","19",7459999,7537363,77364
"2416","ENSG00000104881","PPP1R13L","19",45882892,45909607,26715
"2417","ENSG00000104883","PEX11G","19",7541761,7562335,20574
"2418","ENSG00000104884","ERCC2","19",45853095,45874176,21081
"2419","ENSG00000104885","DOT1L","19",2164148,2232577,68429
"2420","ENSG00000104886","PLEKHJ1","19",2230002,2237703,7701
"2421","ENSG00000104889","RNASEH2A","19",12917394,12924452,7058
"2422","ENSG00000104897","SF3A2","19",2236520,2248678,12158
"2423","ENSG00000104899","AMH","19",2249308,2252072,2764
"2424","ENSG00000104901","DKKL1","19",49865040,49878373,13333
"2425","ENSG00000104904","OAZ1","19",2269485,2273487,4002
"2426","ENSG00000104907","TRMT1","19",13215716,13228381,12665
"2427","ENSG00000104915","STX10","19",13254872,13261197,6325
"2428","ENSG00000104936","DMPK","19",46272975,46285810,12835
"2429","ENSG00000104946","TBC1D17","19",50380682,50392005,11323
"2430","ENSG00000104957","CCDC130","19",13842574,13874110,31536
"2431","ENSG00000104960","PTOV1","19",50353992,50364001,10009
"2432","ENSG00000104964","AES","19",3052908,3063105,10197
"2433","ENSG00000104967","NOVA2","19",46436992,46476804,39812
"2434","ENSG00000104969","SGTA","19",2754712,2783369,28657
"2435","ENSG00000104973","MED25","19",50321539,50342073,20534
"2436","ENSG00000104976","SNAPC2","19",7985201,7988135,2934
"2437","ENSG00000104979","C19orf53","19",13884982,13889276,4294
"2438","ENSG00000104980","TIMM44","19",7991603,8008805,17202
"2439","ENSG00000104983","CCDC61","19",46498339,46524576,26237
"2440","ENSG00000104998","IL27RA","19",14142560,14163743,21183
"2441","ENSG00000105011","ASF1B","19",14230321,14247768,17447
"2442","ENSG00000105053","VRK3","19",50479724,50529203,49479
"2443","ENSG00000105058","FAM32A","19",16296191,16302857,6666
"2444","ENSG00000105063","PPP6R1","19",55741148,55770363,29215
"2445","ENSG00000105072","C19orf44","19",16607122,16632163,25041
"2446","ENSG00000105085","MED26","19",16685718,16739873,54155
"2447","ENSG00000105088","OLFM2","19",9964394,10047228,82834
"2448","ENSG00000105127","AKAP8","19",15464196,15490609,26413
"2449","ENSG00000105135","ILVBL","19",15225795,15236596,10801
"2450","ENSG00000105136","ZNF419","19",57999079,58006048,6969
"2451","ENSG00000105137","SYDE1","19",15218214,15225799,7585
"2452","ENSG00000105171","POP4","19",30094924,30108144,13220
"2453","ENSG00000105173","CCNE1","19",30302805,30315215,12410
"2454","ENSG00000105176","URI1","19",30414551,30506611,92060
"2455","ENSG00000105185","PDCD5","19",33071974,33078358,6384
"2456","ENSG00000105186","ANKRD27","19",33087913,33167503,79590
"2457","ENSG00000105193","RPS16","19",39923847,39926588,2741
"2458","ENSG00000105197","TIMM50","19",39971052,39984422,13370
"2459","ENSG00000105202","FBL","19",40325098,40337054,11956
"2460","ENSG00000105204","DYRK1B","19",40315990,40324841,8851
"2461","ENSG00000105220","GPI","19",34850385,34893061,42676
"2462","ENSG00000105221","AKT2","19",40736224,40791443,55219
"2463","ENSG00000105223","PLD3","19",40854363,40886346,31983
"2464","ENSG00000105227","PRX","19",40899675,40919273,19598
"2465","ENSG00000105229","PIAS4","19",4007644,4039384,31740
"2466","ENSG00000105245","NUMBL","19",41172596,41196877,24281
"2467","ENSG00000105248","CCDC94","19",4247076,4269087,22011
"2468","ENSG00000105251","SHD","19",4278598,4290721,12123
"2469","ENSG00000105254","TBCB","19",36605191,36616849,11658
"2470","ENSG00000105255","FSD1","19",4304597,4323840,19243
"2471","ENSG00000105258","POLR2I","19",36604612,36606248,1636
"2472","ENSG00000105270","CLIP3","19",36505562,36524245,18683
"2473","ENSG00000105278","ZFR2","19",3804022,3869030,65008
"2474","ENSG00000105281","SLC1A5","19",47278140,47291851,13711
"2475","ENSG00000105287","PRKD2","19",47177532,47220384,42852
"2476","ENSG00000105290","APLP1","19",36358801,36370693,11892
"2477","ENSG00000105298","CACTIN","19",3610639,3626813,16174
"2478","ENSG00000105321","CCDC9","19",47759237,47775210,15973
"2479","ENSG00000105323","HNRNPUL1","19",41768401,41813503,45102
"2480","ENSG00000105325","FZR1","19",3506271,3538328,32057
"2481","ENSG00000105327","BBC3","19",47724081,47736023,11942
"2482","ENSG00000105329","TGFB1","19",41807492,41859816,52324
"2483","ENSG00000105339","DENND3","8",142127377,142205907,78530
"2484","ENSG00000105341","ATP5SL","19",41937223,41946622,9399
"2485","ENSG00000105355","PLIN3","19",4838353,4867780,29427
"2486","ENSG00000105364","MRPL4","19",10362577,10370721,8144
"2487","ENSG00000105372","RPS19","19",42363988,42376994,13006
"2488","ENSG00000105373","GLTSCR2","19",48248779,48260315,11536
"2489","ENSG00000105379","ETFB","19",51848423,51869672,21249
"2490","ENSG00000105393","BABAM1","19",17378159,17392058,13899
"2491","ENSG00000105397","TYK2","19",10461209,10491352,30143
"2492","ENSG00000105401","CDC37","19",10501810,10530797,28987
"2493","ENSG00000105402","NAPA","19",47990894,48018497,27603
"2494","ENSG00000105404","RABAC1","19",42460833,42463542,2709
"2495","ENSG00000105409","ATP1A3","19",42470734,42501649,30915
"2496","ENSG00000105419","MEIS3","19",47906381,47922780,16399
"2497","ENSG00000105426","PTPRS","19",5158506,5340814,182308
"2498","ENSG00000105429","MEGF8","19",42829761,42882921,53160
"2499","ENSG00000105438","KDELR1","19",48885827,48894810,8983
"2500","ENSG00000105443","CYTH2","19",48972289,48985571,13282
"2501","ENSG00000105447","GRWD1","19",48949030,48960279,11249
"2502","ENSG00000105483","CARD8","19",48684027,48759203,75176
"2503","ENSG00000105486","LIG1","19",48618702,48673860,55158
"2504","ENSG00000105497","ZNF175","19",52074551,52092991,18440
"2505","ENSG00000105514","RAB3D","19",11432722,11456946,24224
"2506","ENSG00000105516","DBP","19",49133287,49140695,7408
"2507","ENSG00000105518","TMEM205","19",11453452,11457194,3742
"2508","ENSG00000105519","CAPS","19",5911718,5915888,4170
"2509","ENSG00000105520","","19",11466062,11476374,10312
"2510","ENSG00000105552","BCAT2","19",49298319,49314286,15967
"2511","ENSG00000105556","MIER2","19",305575,344798,39223
"2512","ENSG00000105559","PLEKHA4","19",49340354,49371889,31535
"2513","ENSG00000105568","PPP2R1A","19",52693292,52730687,37395
"2514","ENSG00000105576","TNPO2","19",12810008,12834825,24817
"2515","ENSG00000105583","WDR83OS","19",12778885,12782170,3285
"2516","ENSG00000105605","CACNG7","19",54412589,54447195,34606
"2517","ENSG00000105607","GCDH","19",13001840,13025021,23181
"2518","ENSG00000105612","DNASE2","19",12986025,12992282,6257
"2519","ENSG00000105613","MAST1","19",12944765,12985765,41000
"2520","ENSG00000105617","LENG1","19",54658899,54663620,4721
"2521","ENSG00000105618","PRPF31","19",54618837,54635140,16303
"2522","ENSG00000105619","TFPT","19",54610320,54619055,8735
"2523","ENSG00000105639","JAK3","19",17935589,17958880,23291
"2524","ENSG00000105640","RPL18A","19",17970685,17974962,4277
"2525","ENSG00000105642","KCNN1","19",18062102,18110889,48787
"2526","ENSG00000105649","RAB3A","19",18307594,18314884,7290
"2527","ENSG00000105655","ISYNA1","19",18545198,18549111,3913
"2528","ENSG00000105656","ELL","19",18553473,18632937,79464
"2529","ENSG00000105662","CRTC1","19",18794487,18893004,98517
"2530","ENSG00000105663","KMT2B","19",36208921,36229779,20858
"2531","ENSG00000105669","COPE","19",19010323,19030206,19883
"2532","ENSG00000105671","DDX49","19",19030484,19039436,8952
"2533","ENSG00000105676","ARMC6","19",19144384,19170563,26179
"2534","ENSG00000105677","TMEM147","19",36036497,36038428,1931
"2535","ENSG00000105698","USF2","19",35759881,35770724,10843
"2536","ENSG00000105700","KXD1","19",18668572,18680197,11625
"2537","ENSG00000105701","FKBP8","19",18642561,18654887,12326
"2538","ENSG00000105705","SUGP1","19",19386827,19431653,44826
"2539","ENSG00000105708","ZNF14","19",19821280,19843906,22626
"2540","ENSG00000105717","PBX4","19",19672522,19729725,57203
"2541","ENSG00000105722","ERF","19",42751724,42759309,7585
"2542","ENSG00000105723","GSK3A","19",42734338,42746777,12439
"2543","ENSG00000105726","ATP13A1","19",19756007,19774502,18495
"2544","ENSG00000105732","ZNF574","19",42572629,42585701,13072
"2545","ENSG00000105737","GRIK5","19",42502473,42573650,71177
"2546","ENSG00000105738","SIPA1L3","19",38397868,38699012,301144
"2547","ENSG00000105750","ZNF85","19",21106028,21133503,27475
"2548","ENSG00000105755","ETHE1","19",44010871,44031396,20525
"2549","ENSG00000105767","CADM4","19",44126520,44143991,17471
"2550","ENSG00000105771","SMG9","19",44235301,44259142,23841
"2551","ENSG00000105778","AVL9","7",32535038,33078516,543478
"2552","ENSG00000105784","RUNDC3B","7",87256864,87461611,204747
"2553","ENSG00000105792","C7orf63","7",89874488,89940377,65889
"2554","ENSG00000105793","GTPBP10","7",89964537,90020769,56232
"2555","ENSG00000105808","RASA4","7",102220093,102257204,37111
"2556","ENSG00000105810","CDK6","7",92234235,92465908,231673
"2557","ENSG00000105819","PMPCB","7",102937869,102969958,32089
"2558","ENSG00000105821","DNAJC2","7",102952921,102985320,32399
"2559","ENSG00000105825","TFPI2","7",93514709,93520303,5594
"2560","ENSG00000105829","BET1","7",93592074,93633694,41620
"2561","ENSG00000105835","NAMPT","7",105888731,105926772,38041
"2562","ENSG00000105849","TWISTNB","7",19735085,19748710,13625
"2563","ENSG00000105854","PON2","7",95034175,95064510,30335
"2564","ENSG00000105855","ITGB8","7",20370325,20455377,85052
"2565","ENSG00000105856","HBP1","7",106809406,106842974,33568
"2566","ENSG00000105865","DUS4L","7",107203929,107218906,14977
"2567","ENSG00000105866","SP4","7",21467652,21554440,86788
"2568","ENSG00000105875","WDR91","7",134868590,134896316,27726
"2569","ENSG00000105879","CBLL1","7",107384142,107402112,17970
"2570","ENSG00000105887","MTPN","7",135611509,135662101,50592
"2571","ENSG00000105889","STEAP1B","7",22459063,22672544,213481
"2572","ENSG00000105894","PTN","7",136912088,137028611,116523
"2573","ENSG00000105926","MPP6","7",24612887,24733812,120925
"2574","ENSG00000105928","DFNA5","7",24737972,24809244,71272
"2575","ENSG00000105939","ZC3HAV1","7",138728266,138794465,66199
"2576","ENSG00000105948","TTC26","7",138818490,138876732,58242
"2577","ENSG00000105953","OGDH","7",44646171,44748665,102494
"2578","ENSG00000105967","TFEC","7",115575202,115799950,224748
"2579","ENSG00000105968","H2AFV","7",44866390,44887682,21292
"2580","ENSG00000105971","CAV2","7",115927434,116148595,221161
"2581","ENSG00000105974","CAV1","7",116164839,116201233,36394
"2582","ENSG00000105982","RNF32","7",156432975,156469824,36849
"2583","ENSG00000105983","LMBR1","7",156461646,156685924,224278
"2584","ENSG00000105993","DNAJB6","7",157128075,157210133,82058
"2585","ENSG00000105996","HOXA2","7",27139721,27142430,2709
"2586","ENSG00000106003","LFNG","7",2552163,2568811,16648
"2587","ENSG00000106009","BRAT1","7",2577511,2595361,17850
"2588","ENSG00000106012","IQCE","7",2598632,2654368,55736
"2589","ENSG00000106018","VIPR2","7",158820866,158937649,116783
"2590","ENSG00000106025","TSPAN12","7",120427376,120498456,71080
"2591","ENSG00000106028","SSBP1","7",141438121,141487722,49601
"2592","ENSG00000106049","HIBADH","7",27565061,27702614,137553
"2593","ENSG00000106052","TAX1BP1","7",27778950,27884183,105233
"2594","ENSG00000106066","CPVL","7",29034847,29235067,200220
"2595","ENSG00000106069","CHN2","7",29161890,29553944,392054
"2596","ENSG00000106070","GRB10","7",50657760,50861159,203399
"2597","ENSG00000106077","ABHD11","7",73150424,73153197,2773
"2598","ENSG00000106078","COBL","7",51083909,51384515,300606
"2599","ENSG00000106080","FKBP14","7",30050203,30066300,16097
"2600","ENSG00000106086","PLEKHA8","7",30067020,30170096,103076
"2601","ENSG00000106089","STX1A","7",73113536,73134002,20466
"2602","ENSG00000106100","NOD1","7",30464143,30518400,54257
"2603","ENSG00000106105","GARS","7",30634297,30673649,39352
"2604","ENSG00000106125","FAM188B","7",30811033,30932002,120969
"2605","ENSG00000106133","NSUN5P2","7",72418120,72425329,7209
"2606","ENSG00000106144","CASP2","7",142985308,143004789,19481
"2607","ENSG00000106153","CHCHD2","7",56169262,56174269,5007
"2608","ENSG00000106211","HSPB1","7",75931861,75933612,1751
"2609","ENSG00000106236","NPTX2","7",98246609,98259180,12571
"2610","ENSG00000106244","PDAP1","7",98989671,99006452,16781
"2611","ENSG00000106245","BUD31","7",99006264,99017239,10975
"2612","ENSG00000106246","PTCD1","7",99014362,99063787,49425
"2613","ENSG00000106261","ZKSCAN1","7",99613204,99639312,26108
"2614","ENSG00000106263","EIF3B","7",2393721,2420380,26659
"2615","ENSG00000106266","SNX8","7",2291405,2393953,102548
"2616","ENSG00000106268","NUDT1","7",2281857,2290781,8924
"2617","ENSG00000106278","PTPRZ1","7",121513143,121702090,188947
"2618","ENSG00000106290","TAF6","7",99704693,99717464,12771
"2619","ENSG00000106299","WASL","7",123321989,123389121,67132
"2620","ENSG00000106305","AIMP2","7",6048876,6063465,14589
"2621","ENSG00000106330","MOSPD3","7",100209725,100213007,3282
"2622","ENSG00000106333","PCOLCE","7",100199800,100205798,5998
"2623","ENSG00000106344","RBM28","7",127937738,127983962,46224
"2624","ENSG00000106346","USP42","7",6144515,6201195,56680
"2625","ENSG00000106348","IMPDH1","7",128032331,128050306,17975
"2626","ENSG00000106351","AGFG2","7",100136834,100165842,29008
"2627","ENSG00000106355","LSM5","7",32524951,32534895,9944
"2628","ENSG00000106366","SERPINE1","7",100770370,100782547,12177
"2629","ENSG00000106367","AP1S1","7",100797678,100804877,7199
"2630","ENSG00000106392","C1GALT1","7",7196565,7288282,91717
"2631","ENSG00000106397","PLOD3","7",100849258,100861701,12443
"2632","ENSG00000106399","RPA3","7",7676149,7758238,82089
"2633","ENSG00000106400","ZNHIT1","7",100860949,100867471,6522
"2634","ENSG00000106404","CLDN15","7",100875373,100882101,6728
"2635","ENSG00000106415","GLCCI1","7",8008425,8133902,125477
"2636","ENSG00000106443","PHF14","7",11013499,11209250,195751
"2637","ENSG00000106459","NRF1","7",129251555,129396922,145367
"2638","ENSG00000106460","TMEM106B","7",12250867,12282993,32126
"2639","ENSG00000106462","EZH2","7",148504475,148581413,76938
"2640","ENSG00000106477","CEP41","7",130033612,130082274,48662
"2641","ENSG00000106479","ZNF862","7",149535456,149564568,29112
"2642","ENSG00000106483","SFRP4","7",37945543,38065297,119754
"2643","ENSG00000106484","MEST","7",130126012,130146133,20121
"2644","ENSG00000106524","ANKMY2","7",16639401,16685442,46041
"2645","ENSG00000106536","POU6F2","7",39017598,39532694,515096
"2646","ENSG00000106537","TSPAN13","7",16793160,16824161,31001
"2647","ENSG00000106538","RARRES2","7",150035408,150038763,3355
"2648","ENSG00000106546","AHR","7",17338246,17385776,47530
"2649","ENSG00000106554","CHCHD3","7",132469629,132766848,297219
"2650","ENSG00000106571","GLI3","7",42000548,42277469,276921
"2651","ENSG00000106588","PSMA2","7",42956460,42971822,15362
"2652","ENSG00000106591","MRPL32","7",42971799,42988557,16758
"2653","ENSG00000106603","COA1","7",43648055,43769316,121261
"2654","ENSG00000106605","BLVRA","7",43798279,43846939,48660
"2655","ENSG00000106608","URGCP","7",43915493,43966010,50517
"2656","ENSG00000106609","TMEM248","7",66386212,66423538,37326
"2657","ENSG00000106610","STAG3L4","7",66767608,66786513,18905
"2658","ENSG00000106615","RHEB","7",151163098,151217206,54108
"2659","ENSG00000106617","PRKAG2","7",151253197,151574210,321013
"2660","ENSG00000106624","AEBP1","7",44143960,44154161,10201
"2661","ENSG00000106628","POLD2","7",44154286,44163957,9671
"2662","ENSG00000106635","BCL7B","7",72950686,72972332,21646
"2663","ENSG00000106636","YKT6","7",44240567,44253893,13326
"2664","ENSG00000106638","TBL2","7",72983262,72993121,9859
"2665","ENSG00000106665","CLIP2","7",73703805,73820273,116468
"2666","ENSG00000106682","EIF4H","7",73588575,73611431,22856
"2667","ENSG00000106683","LIMK1","7",73497263,73536855,39592
"2668","ENSG00000106686","SPATA6L","9",4553386,4666674,113288
"2669","ENSG00000106688","SLC1A1","9",4490444,4587469,97025
"2670","ENSG00000106692","FKTN","9",108320411,108403399,82988
"2671","ENSG00000106701","FSD1L","9",108210077,108314714,104637
"2672","ENSG00000106714","CNTNAP3","9",39072764,39288312,215548
"2673","ENSG00000106723","SPIN1","9",91003334,91093609,90275
"2674","ENSG00000106733","NMRK1","9",77675489,77703133,27644
"2675","ENSG00000106771","TMEM245","9",111777432,111882225,104793
"2676","ENSG00000106772","PRUNE2","9",79226292,79521003,294711
"2677","ENSG00000106780","MEGF9","9",123363091,123476748,113657
"2678","ENSG00000106789","CORO2A","9",100883257,100954922,71665
"2679","ENSG00000106799","TGFBR1","9",101866320,101916474,50154
"2680","ENSG00000106803","SEC61B","9",101984346,101992897,8551
"2681","ENSG00000106804","C5","9",123714616,123812554,97938
"2682","ENSG00000106823","ECM2","9",95256365,95298937,42572
"2683","ENSG00000106829","TLE4","9",82186688,82341658,154970
"2684","ENSG00000106853","PTGR1","9",114312002,114362135,50133
"2685","ENSG00000106868","SUSD1","9",114803065,114937688,134623
"2686","ENSG00000106948","AKNA","9",117096436,117156685,60249
"2687","ENSG00000106976","DNM1","9",130965658,131017527,51869
"2688","ENSG00000106991","ENG","9",130577291,130617035,39744
"2689","ENSG00000106992","AK1","9",130628759,130640022,11263
"2690","ENSG00000106993","CDC37L1","9",4679559,4708398,28839
"2691","ENSG00000107020","PLGRKT","9",5357973,5437878,79905
"2692","ENSG00000107021","TBC1D13","9",131549483,131572711,23228
"2693","ENSG00000107036","KIAA1432","9",5629025,5776557,147532
"2694","ENSG00000107077","KDM4C","9",6720863,7175648,454785
"2695","ENSG00000107104","KANK1","9",470291,746105,275814
"2696","ENSG00000107105","ELAVL2","9",23690102,23826335,136233
"2697","ENSG00000107130","NCS1","9",132934857,132999583,64726
"2698","ENSG00000107140","TESK1","9",35605367,35610038,4671
"2699","ENSG00000107164","FUBP3","9",133454352,133513739,59387
"2700","ENSG00000107175","CREB3","9",35732332,35737001,4669
"2701","ENSG00000107185","RGP1","9",35749203,35758572,9369
"2702","ENSG00000107186","MPDZ","9",13105703,13279589,173886
"2703","ENSG00000107201","DDX58","9",32455300,32526322,71022
"2704","ENSG00000107223","EDF1","9",139756571,139760738,4167
"2705","ENSG00000107242","PIP5K1B","9",71320575,71624092,303517
"2706","ENSG00000107249","GLIS3","9",3824127,4348392,524265
"2707","ENSG00000107262","BAG1","9",33247818,33264761,16943
"2708","ENSG00000107263","RAPGEF1","9",134452157,134615461,163304
"2709","ENSG00000107281","NPDC1","9",139933922,139940655,6733
"2710","ENSG00000107282","APBA1","9",72042446,72287222,244776
"2711","ENSG00000107290","SETX","9",135136743,135230372,93629
"2712","ENSG00000107295","SH3GL2","9",17579080,17797127,218047
"2713","ENSG00000107331","ABCA2","9",139901686,139923367,21681
"2714","ENSG00000107338","SHB","9",37919131,38069210,150079
"2715","ENSG00000107341","UBE2R2","9",33817565,33920402,102837
"2716","ENSG00000107362","ABHD17B","9",74477368,74525847,48479
"2717","ENSG00000107371","EXOSC3","9",37766975,37801434,34459
"2718","ENSG00000107372","ZFAND5","9",74966341,74980163,13822
"2719","ENSG00000107404","DVL1","1",1270656,1284730,14074
"2720","ENSG00000107438","PDLIM1","10",96997329,97050781,53452
"2721","ENSG00000107443","CCNJ","10",97803151,97820627,17476
"2722","ENSG00000107518","ATRNL1","10",116853124,117708503,855379
"2723","ENSG00000107521","HPS1","10",100175955,100206684,30729
"2724","ENSG00000107537","PHYH","10",13319796,13344412,24616
"2725","ENSG00000107551","RASSF4","10",45454855,45491339,36484
"2726","ENSG00000107554","DNMBP","10",101635334,101769676,134342
"2727","ENSG00000107560","RAB11FIP2","10",119764427,119806114,41687
"2728","ENSG00000107566","ERLIN1","10",101909851,101948091,38240
"2729","ENSG00000107581","EIF3A","10",120794356,120840316,45960
"2730","ENSG00000107611","CUBN","10",16865963,17171830,305867
"2731","ENSG00000107614","TRDMT1","10",17184253,17244053,59800
"2732","ENSG00000107623","GDF10","10",48425815,48438976,13161
"2733","ENSG00000107625","DDX50","10",70661034,70706603,45569
"2734","ENSG00000107643","MAPK8","10",49514698,49647403,132705
"2735","ENSG00000107651","SEC23IP","10",121652223,121702014,49791
"2736","ENSG00000107669","ATE1","10",123499939,123688316,188377
"2737","ENSG00000107672","NSMCE4A","10",123716603,123734732,18129
"2738","ENSG00000107679","PLEKHA1","10",124134212,124191867,57655
"2739","ENSG00000107719","PALD1","10",72238577,72328205,89628
"2740","ENSG00000107731","UNC5B","10",72972327,73062621,90294
"2741","ENSG00000107736","CDH23","10",73156691,73575702,419011
"2742","ENSG00000107742","SPOCK2","10",73818793,73848790,29997
"2743","ENSG00000107745","MICU1","10",74127098,74385899,258801
"2744","ENSG00000107758","PPP3CB","10",75196186,75255782,59596
"2745","ENSG00000107771","CCSER2","10",86088342,86278273,189931
"2746","ENSG00000107779","BMPR1A","10",88516407,88692595,176188
"2747","ENSG00000107789","MINPP1","10",89264632,89313217,48585
"2748","ENSG00000107796","ACTA2","10",90694831,90751147,56316
"2749","ENSG00000107798","LIPA","10",90973326,91174314,200988
"2750","ENSG00000107815","C10orf2","10",102747124,102754158,7034
"2751","ENSG00000107816","LZTS2","10",102756375,102767593,11218
"2752","ENSG00000107819","SFXN3","10",102790991,102800998,10007
"2753","ENSG00000107821","KAZALD1","10",102821598,102827888,6290
"2754","ENSG00000107829","FBXW4","10",103370423,103455052,84629
"2755","ENSG00000107833","NPM3","10",103541082,103543170,2088
"2756","ENSG00000107854","TNKS2","10",93558069,93625033,66964
"2757","ENSG00000107862","GBF1","10",104005289,104142656,137367
"2758","ENSG00000107863","ARHGAP21","10",24872538,25012597,140059
"2759","ENSG00000107864","CPEB3","10",93806449,94050844,244395
"2760","ENSG00000107872","FBXL15","10",104178946,104182893,3947
"2761","ENSG00000107874","CUEDC2","10",104183002,104192418,9416
"2762","ENSG00000107882","SUFU","10",104263744,104393292,129548
"2763","ENSG00000107890","ANKRD26","10",27280843,27389421,108578
"2764","ENSG00000107897","ACBD5","10",27484146,27531059,46913
"2765","ENSG00000107902","LHPP","10",126150403,126306457,156054
"2766","ENSG00000107929","LARP4B","10",855484,977564,122080
"2767","ENSG00000107937","GTPBP4","10",1034338,1065876,31538
"2768","ENSG00000107938","EDRF1","10",127408084,127452712,44628
"2769","ENSG00000107949","BCCIP","10",127512115,127542264,30149
"2770","ENSG00000107951","MTPAP","10",30598730,30663377,64647
"2771","ENSG00000107954","NEURL1","10",105253736,105352309,98573
"2772","ENSG00000107957","SH3PXD2A","10",105348285,105615301,267016
"2773","ENSG00000107959","PITRM1","10",3179920,3215003,35083
"2774","ENSG00000107960","OBFC1","10",105642300,105677963,35663
"2775","ENSG00000107968","MAP3K8","10",30722866,30750762,27896
"2776","ENSG00000107984","DKK1","10",54074056,54077802,3746
"2777","ENSG00000108001","EBF3","10",131633547,131762105,128558
"2778","ENSG00000108010","GLRX3","10",131934663,131982785,48122
"2779","ENSG00000108018","SORCS1","10",108333421,108924292,590871
"2780","ENSG00000108021","FAM208B","10",5726801,5805703,78902
"2781","ENSG00000108039","XPNPEP1","10",111624524,111683311,58787
"2782","ENSG00000108055","SMC3","10",112327449,112364394,36945
"2783","ENSG00000108061","SHOC2","10",112679301,112773425,94124
"2784","ENSG00000108064","TFAM","10",60144782,60158981,14199
"2785","ENSG00000108091","CCDC6","10",61548521,61666414,117893
"2786","ENSG00000108094","CUL2","10",35297479,35379570,82091
"2787","ENSG00000108100","CCNY","10",35535953,35860852,324899
"2788","ENSG00000108106","UBE2S","19",55912652,55919145,6493
"2789","ENSG00000108107","RPL28","19",55896713,55914612,17899
"2790","ENSG00000108175","ZMIZ1","10",80828792,81076276,247484
"2791","ENSG00000108176","DNAJC12","10",69556427,69597924,41497
"2792","ENSG00000108179","PPIF","10",81107225,81115093,7868
"2793","ENSG00000108187","PBLD","10",70042417,70092806,50389
"2794","ENSG00000108219","TSPAN14","10",82213922,82292879,78957
"2795","ENSG00000108231","LGI1","10",95517566,95557916,40350
"2796","ENSG00000108239","TBC1D12","10",96162261,96295687,133426
"2797","ENSG00000108255","CRYBA1","17",27573881,27581512,7631
"2798","ENSG00000108256","NUFIP2","17",27582854,27621136,38282
"2799","ENSG00000108262","GIT1","17",27900487,27921072,20585
"2800","ENSG00000108264","TADA2A","17",35766965,35839835,72870
"2801","ENSG00000108270","AATF","17",35306175,35414171,107996
"2802","ENSG00000108272","DHRS11","17",34948228,34957235,9007
"2803","ENSG00000108278","ZNHIT3","17",34842473,34855154,12681
"2804","ENSG00000108292","MLLT6","17",36861795,36886056,24261
"2805","ENSG00000108294","PSMB3","17",36908989,36920484,11495
"2806","ENSG00000108296","CWC25","17",36956687,36981734,25047
"2807","ENSG00000108298","RPL19","17",37356536,37360980,4444
"2808","ENSG00000108306","FBXL20","17",37415384,37558776,143392
"2809","ENSG00000108309","RUNDC3A","17",42385781,42396039,10258
"2810","ENSG00000108312","UBTF","17",42282401,42298994,16593
"2811","ENSG00000108344","PSMD3","17",38137050,38154213,17163
"2812","ENSG00000108349","CASC3","17",38296571,38328436,31865
"2813","ENSG00000108352","RAPGEFL1","17",38333263,38351908,18645
"2814","ENSG00000108370","RGS9","17",63133549,63223821,90272
"2815","ENSG00000108375","RNF43","17",56429861,56494956,65095
"2816","ENSG00000108379","WNT3","17",44839872,44910520,70648
"2817","ENSG00000108384","RAD51C","17",56769934,56811703,41769
"2818","ENSG00000108387","SEPT4","17",56597611,56618179,20568
"2819","ENSG00000108389","MTMR4","17",56566898,56595266,28368
"2820","ENSG00000108395","TRIM37","17",57059999,57184282,124283
"2821","ENSG00000108406","DHX40","17",57642886,57685706,42820
"2822","ENSG00000108423","TUBD1","17",57936851,57970304,33453
"2823","ENSG00000108424","KPNB1","17",45726842,45762871,36029
"2824","ENSG00000108433","GOSR2","17",45000483,45105003,104520
"2825","ENSG00000108439","PNPO","17",46018872,46025654,6782
"2826","ENSG00000108443","RPS6KB1","17",57970447,58027925,57478
"2827","ENSG00000108448","TRIM16L","17",18601311,18639431,38120
"2828","ENSG00000108465","CDK5RAP3","17",46045176,46059140,13964
"2829","ENSG00000108468","CBX1","17",46147414,46178883,31469
"2830","ENSG00000108469","RECQL5","17",73622925,73663269,40344
"2831","ENSG00000108474","PIGL","17",16120505,16252115,131610
"2832","ENSG00000108479","GALK1","17",73747675,73761792,14117
"2833","ENSG00000108506","INTS2","17",59942731,60005377,62646
"2834","ENSG00000108509","CAMTA2","17",4871287,4890960,19673
"2835","ENSG00000108510","MED13","17",60019966,60142643,122677
"2836","ENSG00000108515","ENO3","17",4851387,4860426,9039
"2837","ENSG00000108518","PFN1","17",4848947,4852356,3409
"2838","ENSG00000108523","RNF167","17",4843303,4848517,5214
"2839","ENSG00000108528","SLC25A11","17",4840425,4843546,3121
"2840","ENSG00000108551","RASD1","17",17397751,17399709,1958
"2841","ENSG00000108557","RAI1","17",17584787,17714767,129980
"2842","ENSG00000108559","NUP88","17",5264258,5323480,59222
"2843","ENSG00000108561","C1QBP","17",5336097,5352150,16053
"2844","ENSG00000108578","BLMH","17",28575218,28619074,43856
"2845","ENSG00000108582","CPD","17",28705923,28797007,91084
"2846","ENSG00000108587","GOSR1","17",28804380,28854610,50230
"2847","ENSG00000108588","CCDC47","17",61822610,61853711,31101
"2848","ENSG00000108590","MED31","17",6546635,6554954,8319
"2849","ENSG00000108591","DRG2","17",17991200,18011285,20085
"2850","ENSG00000108592","FTSJ3","17",61896793,61907372,10579
"2851","ENSG00000108599","AKAP10","17",19807615,19881656,74041
"2852","ENSG00000108604","SMARCD2","17",61909444,61920425,10981
"2853","ENSG00000108639","SYNGR2","17",76164639,76169608,4969
"2854","ENSG00000108641","B9D1","17",19240867,19281495,40628
"2855","ENSG00000108651","UTP6","17",30187923,30228784,40861
"2856","ENSG00000108654","DDX5","17",62495734,62504317,8583
"2857","ENSG00000108666","C17orf75","17",30651584,30677042,25458
"2858","ENSG00000108669","CYTH1","17",76670130,76778379,108249
"2859","ENSG00000108671","PSMD11","17",30771279,30810336,39057
"2860","ENSG00000108679","LGALS3BP","17",76967320,76976191,8871
"2861","ENSG00000108684","ASIC2","17",31340105,32501983,1161878
"2862","ENSG00000108691","CCL2","17",32582304,32584222,1918
"2863","ENSG00000108733","PEX12","17",33901814,33905882,4068
"2864","ENSG00000108773","KAT2A","17",40265126,40273376,8250
"2865","ENSG00000108774","RAB5C","17",40276994,40307035,30041
"2866","ENSG00000108784","NAGLU","17",40688190,40696467,8277
"2867","ENSG00000108786","HSD17B1","17",40701232,40707231,5999
"2868","ENSG00000108788","MLX","17",40719086,40725257,6171
"2869","ENSG00000108797","CNTNAP1","17",40834631,40851832,17201
"2870","ENSG00000108799","EZH1","17",40852293,40897071,44778
"2871","ENSG00000108819","PPP1R9B","17",48211104,48227991,16887
"2872","ENSG00000108821","COL1A1","17",48260650,48278993,18343
"2873","ENSG00000108826","MRPL27","17",48445218,48450575,5357
"2874","ENSG00000108828","VAT1","17",41166622,41177140,10518
"2875","ENSG00000108829","LRRC59","17",48452420,48474914,22494
"2876","ENSG00000108830","RND2","17",41177258,41184057,6799
"2877","ENSG00000108840","HDAC5","17",42154114,42201070,46956
"2878","ENSG00000108848","LUC7L3","17",48796905,48833574,36669
"2879","ENSG00000108852","MPP2","17",41952725,41987068,34343
"2880","ENSG00000108854","SMURF2","17",62538413,62658186,119773
"2881","ENSG00000108861","DUSP3","17",41843489,41856356,12867
"2882","ENSG00000108883","EFTUD2","17",42927311,42977030,49719
"2883","ENSG00000108932","SLC16A6","17",66263167,66287408,24241
"2884","ENSG00000108946","PRKAR1A","17",66507921,66547460,39539
"2885","ENSG00000108947","EFNB3","17",7608520,7614696,6176
"2886","ENSG00000108953","YWHAE","17",1247566,1303672,56106
"2887","ENSG00000108960","MMD","17",53469974,53499353,29379
"2888","ENSG00000108961","RANGRF","17",8191815,8193410,1595
"2889","ENSG00000108963","DPH1","17",1933404,1946724,13320
"2890","ENSG00000108984","MAP2K6","17",67410839,67539472,128633
"2891","ENSG00000109016","DHRS7B","17",21026677,21096578,69901
"2892","ENSG00000109046","WSB1","17",25621102,25640657,19555
"2893","ENSG00000109062","SLC9A3R1","17",72744791,72765492,20701
"2894","ENSG00000109063","MYH3","17",10531843,10560626,28783
"2895","ENSG00000109065","NAT9","17",72766686,72772506,5820
"2896","ENSG00000109066","TMEM104","17",72772622,72835918,63296
"2897","ENSG00000109079","TNFAIP1","17",26662628,26674035,11407
"2898","ENSG00000109083","IFT20","17",26655352,26662515,7163
"2899","ENSG00000109084","TMEM97","17",26646121,26655707,9586
"2900","ENSG00000109089","CDR2L","17",72983727,73001895,18168
"2901","ENSG00000109099","PMP22","17",15133095,15168643,35548
"2902","ENSG00000109103","UNC119","17",26873725,26879686,5961
"2903","ENSG00000109107","ALDOC","17",26900133,26904282,4149
"2904","ENSG00000109111","SUPT6H","17",26989109,27029697,40588
"2905","ENSG00000109113","RAB34","17",27041299,27045447,4148
"2906","ENSG00000109118","PHF12","17",27232268,27278789,46521
"2907","ENSG00000109133","TMEM33","4",41937137,41962589,25452
"2908","ENSG00000109171","SLAIN2","4",48343339,48428229,84890
"2909","ENSG00000109180","OCIAD1","4",48807229,48863834,56605
"2910","ENSG00000109184","DCUN1D4","4",52709166,52783003,73837
"2911","ENSG00000109189","USP46","4",53457138,53525502,68364
"2912","ENSG00000109220","CHIC2","4",54875956,54930857,54901
"2913","ENSG00000109255","NMU","4",56461396,56502865,41469
"2914","ENSG00000109265","KIAA1211","4",57036361,57194791,158430
"2915","ENSG00000109270","LAMTOR3","4",100799493,100815647,16154
"2916","ENSG00000109320","NFKB1","4",103422486,103538459,115973
"2917","ENSG00000109323","MANBA","4",103552660,103682151,129491
"2918","ENSG00000109332","UBE2D3","4",103715540,103790053,74513
"2919","ENSG00000109339","MAPK10","4",86936276,87515284,579008
"2920","ENSG00000109381","ELF2","4",139949266,140098372,149106
"2921","ENSG00000109390","NDUFC1","4",140188034,140223705,35671
"2922","ENSG00000109436","TBC1D9","4",141541919,141677274,135355
"2923","ENSG00000109445","ZNF330","4",142142041,142155851,13810
"2924","ENSG00000109452","INPP4B","4",142944313,143768585,824272
"2925","ENSG00000109458","GAB1","4",144257915,144395721,137806
"2926","ENSG00000109466","KLHL2","4",166128770,166244308,115538
"2927","ENSG00000109472","CPE","4",166282346,166419472,137126
"2928","ENSG00000109475","RPL34","4",109541722,109551568,9846
"2929","ENSG00000109501","WFS1","4",6271576,6304992,33416
"2930","ENSG00000109519","GRPEL1","4",7060633,7069924,9291
"2931","ENSG00000109534","GAR1","4",110736666,110745893,9227
"2932","ENSG00000109536","FRG1","4",190861943,190884359,22416
"2933","ENSG00000109572","CLCN3","4",170533784,170644824,111040
"2934","ENSG00000109576","AADAT","4",170981373,171012850,31477
"2935","ENSG00000109586","GALNT7","4",174089904,174245118,155214
"2936","ENSG00000109606","DHX15","4",24519064,24586173,67109
"2937","ENSG00000109618","SEPSECS","4",25121627,25162204,40577
"2938","ENSG00000109654","TRIM2","4",154073494,154260472,186978
"2939","ENSG00000109670","FBXW7","4",153242410,153457253,214843
"2940","ENSG00000109674","NEIL3","4",178230990,178284097,53107
"2941","ENSG00000109680","TBC1D19","4",26578059,26756973,178914
"2942","ENSG00000109685","WHSC1","4",1873151,1983934,110783
"2943","ENSG00000109686","SH3D19","4",152023903,152246784,222881
"2944","ENSG00000109689","STIM2","4",26859300,27027003,167703
"2945","ENSG00000109736","MFSD10","4",2932288,2936586,4298
"2946","ENSG00000109738","GLRB","4",157997209,158093242,96033
"2947","ENSG00000109743","BST1","4",15704573,15739936,35363
"2948","ENSG00000109756","RAPGEF2","4",160025330,160281321,255991
"2949","ENSG00000109762","SNX25","4",186125391,186291339,165948
"2950","ENSG00000109771","LRP2BP","4",186285032,186317053,32021
"2951","ENSG00000109775","UFSP2","4",186320694,186347139,26445
"2952","ENSG00000109787","KLF3","4",38665817,38702663,36846
"2953","ENSG00000109790","KLHL5","4",39046659,39128477,81818
"2954","ENSG00000109794","FAM149A","4",187025573,187093821,68248
"2955","ENSG00000109805","NCAPG","4",17812525,17846485,33960
"2956","ENSG00000109814","UGDH","4",39500375,39529931,29556
"2957","ENSG00000109819","PPARGC1A","4",23756664,23905712,149048
"2958","ENSG00000109832","DDX25","11",125773271,125793158,19887
"2959","ENSG00000109854","HTATIP2","11",20385231,20405329,20098
"2960","ENSG00000109861","CTSC","11",88026760,88070955,44195
"2961","ENSG00000109881","CCDC34","11",27352374,27385415,33041
"2962","ENSG00000109906","ZBTB16","11",113930315,114121398,191083
"2963","ENSG00000109911","ELP4","11",31531297,31805546,274249
"2964","ENSG00000109917","ZNF259","11",116648436,116658766,10330
"2965","ENSG00000109919","MTCH2","11",47638867,47664175,25308
"2966","ENSG00000109920","FNBP4","11",47738072,47788995,50923
"2967","ENSG00000109927","TECTA","11",120971882,121062202,90320
"2968","ENSG00000109929","SC5D","11",121163162,121179403,16241
"2969","ENSG00000109944","C11orf63","11",122753391,122830506,77115
"2970","ENSG00000109956","B3GAT1","11",134248398,134281812,33414
"2971","ENSG00000109971","HSPA8","11",122928197,122933938,5741
"2972","ENSG00000109991","P2RX3","11",57105848,57138073,32225
"2973","ENSG00000110002","VWA5A","11",123986069,124018428,32359
"2974","ENSG00000110011","DNAJC4","11",63997750,64001758,4008
"2975","ENSG00000110013","SIAE","11",124503009,124565603,62594
"2976","ENSG00000110025","SNX15","11",64794880,64808044,13164
"2977","ENSG00000110031","LPXN","11",58294344,58345693,51349
"2978","ENSG00000110042","DTX4","11",58938903,58976060,37157
"2979","ENSG00000110046","ATG2A","11",64662007,64684722,22715
"2980","ENSG00000110047","EHD1","11",64619114,64655768,36654
"2981","ENSG00000110048","OSBP","11",59341871,59383617,41746
"2982","ENSG00000110057","UNC93B1","11",67758575,67772452,13877
"2983","ENSG00000110060","PUS3","11",125763381,125773116,9735
"2984","ENSG00000110063","DCPS","11",126173647,126215644,41997
"2985","ENSG00000110066","SUV420H1","11",67922330,67981295,58965
"2986","ENSG00000110074","FOXRED1","11",126138950,126148026,9076
"2987","ENSG00000110075","PPP6R3","11",68228186,68382802,154616
"2988","ENSG00000110076","NRXN2","11",64373646,64490660,117014
"2989","ENSG00000110080","ST3GAL4","11",126225535,126310239,84704
"2990","ENSG00000110090","CPT1A","11",68522088,68611878,89790
"2991","ENSG00000110092","CCND1","11",69455855,69469242,13387
"2992","ENSG00000110104","CCDC86","11",60609544,60618554,9010
"2993","ENSG00000110107","PRPF19","11",60658202,60674060,15858
"2994","ENSG00000110108","TMEM109","11",60681346,60690915,9569
"2995","ENSG00000110171","TRIM3","11",6469843,6495689,25846
"2996","ENSG00000110172","CHORDC1","11",89934328,89956532,22204
"2997","ENSG00000110200","ANAPC15","11",71817424,71823826,6402
"2998","ENSG00000110218","PANX1","11",93862094,93915138,53044
"2999","ENSG00000110237","ARHGEF17","11",73019334,73080136,60802
"3000","ENSG00000110274","CEP164","11",117185273,117283984,98711
"3001","ENSG00000110315","RNF141","11",10533225,10562777,29552
"3002","ENSG00000110318","KIAA1377","11",101785746,101871789,86043
"3003","ENSG00000110321","EIF4G2","11",10818597,10830657,12060
"3004","ENSG00000110328","GALNT18","11",11292423,11643552,351129
"3005","ENSG00000110330","BIRC2","11",102217942,102249401,31459
"3006","ENSG00000110344","UBE4A","11",118230300,118269926,39626
"3007","ENSG00000110367","DDX6","11",118620034,118661858,41824
"3008","ENSG00000110395","CBL","11",119076752,119178859,102107
"3009","ENSG00000110400","PVRL1","11",119494120,119599794,105674
"3010","ENSG00000110422","HIPK3","11",33278218,33378569,100351
"3011","ENSG00000110427","KIAA1549L","11",33563618,33695648,132030
"3012","ENSG00000110429","FBXO3","11",33762485,33796089,33604
"3013","ENSG00000110435","PDHX","11",34937376,35042138,104762
"3014","ENSG00000110436","SLC1A2","11",35272753,35441610,168857
"3015","ENSG00000110442","COMMD9","11",36295051,36310999,15948
"3016","ENSG00000110446","SLC15A3","11",60704556,60720002,15446
"3017","ENSG00000110455","ACCS","11",44087475,44105772,18297
"3018","ENSG00000110492","MDK","11",46402306,46405375,3069
"3019","ENSG00000110497","AMBRA1","11",46417964,46615675,197711
"3020","ENSG00000110514","MADD","11",47290712,47351582,60870
"3021","ENSG00000110536","PTPMT1","11",47586982,47595013,8031
"3022","ENSG00000110583","NAA40","11",63706431,63724800,18369
"3023","ENSG00000110619","CARS","11",3022152,3078843,56691
"3024","ENSG00000110628","SLC22A18","11",2920951,2946476,25525
"3025","ENSG00000110651","CD81","11",2397407,2418649,21242
"3026","ENSG00000110660","SLC35F2","11",107661717,107799019,137302
"3027","ENSG00000110675","ELMOD1","11",107461817,107537505,75688
"3028","ENSG00000110693","SOX6","11",15987995,16761138,773143
"3029","ENSG00000110696","C11orf58","11",16634679,16778428,143749
"3030","ENSG00000110697","PITPNM1","11",67259239,67273734,14495
"3031","ENSG00000110700","RPS13","11",17095936,17099334,3398
"3032","ENSG00000110711","AIP","11",67250512,67258574,8062
"3033","ENSG00000110713","NUP98","11",3692313,3819022,126709
"3034","ENSG00000110717","NDUFS8","11",67798084,67804111,6027
"3035","ENSG00000110719","TCIRG1","11",67806483,67818362,11879
"3036","ENSG00000110721","CHKA","11",67820326,67888911,68585
"3037","ENSG00000110723","EXPH5","11",108376158,108464465,88307
"3038","ENSG00000110756","HPS5","11",18300223,18343745,43522
"3039","ENSG00000110768","GTF2H1","11",18343842,18388591,44749
"3040","ENSG00000110799","VWF","12",6058040,6233936,175896
"3041","ENSG00000110801","PSMD9","12",122326637,122356203,29566
"3042","ENSG00000110811","LEPREL2","12",6937572,6949018,11446
"3043","ENSG00000110841","PPFIBP1","12",27676364,27848497,172133
"3044","ENSG00000110844","PRPF40B","12",49962001,50038449,76448
"3045","ENSG00000110851","PRDM4","12",108126643,108155049,28406
"3046","ENSG00000110871","COQ5","12",120941077,120972237,31160
"3047","ENSG00000110876","SELPLG","12",109015686,109027735,12049
"3048","ENSG00000110880","CORO1C","12",109038885,109125372,86487
"3049","ENSG00000110881","ASIC1","12",50451331,50477394,26063
"3050","ENSG00000110888","CAPRIN2","12",30862486,30907885,45399
"3051","ENSG00000110900","TSPAN11","12",31079362,31149534,70172
"3052","ENSG00000110906","KCTD10","12",109886461,109915349,28888
"3053","ENSG00000110911","SLC11A2","12",51373184,51422349,49165
"3054","ENSG00000110917","MLEC","12",121124672,121139667,14995
"3055","ENSG00000110921","MVK","12",110011060,110035067,24007
"3056","ENSG00000110925","CSRNP2","12",51454990,51477447,22457
"3057","ENSG00000110931","CAMKK2","12",121675497,121736111,60614
"3058","ENSG00000110955","ATP5B","12",57031959,57039798,7839
"3059","ENSG00000110958","PTGES3","12",57057127,57082159,25032
"3060","ENSG00000110975","SYT10","12",33527173,33592754,65581
"3061","ENSG00000110987","BCL7A","12",122457328,122499948,42620
"3062","ENSG00000111011","RSRC2","12",122989190,123011547,22357
"3063","ENSG00000111052","LIN7A","12",81186299,81331704,145405
"3064","ENSG00000111057","KRT18","12",53342655,53346685,4030
"3065","ENSG00000111058","ACSS3","12",81331594,81650533,318939
"3066","ENSG00000111077","TENC1","12",53440753,53458156,17403
"3067","ENSG00000111087","GLI1","12",57853918,57866045,12127
"3068","ENSG00000111110","PPM1H","12",63037762,63328817,291055
"3069","ENSG00000111142","METAP2","12",95867296,95909615,42319
"3070","ENSG00000111144","LTA4H","12",96394606,96437298,42692
"3071","ENSG00000111145","ELK3","12",96588160,96663613,75453
"3072","ENSG00000111186","WNT5B","12",1639057,1756409,117352
"3073","ENSG00000111196","MAGOHB","12",10758612,10766222,7610
"3074","ENSG00000111203","ITFG2","12",2921788,2968957,47169
"3075","ENSG00000111206","FOXM1","12",2966847,2986206,19359
"3076","ENSG00000111215","PRR4","12",10977559,11324212,346653
"3077","ENSG00000111218","PRMT8","12",3490515,3703139,212624
"3078","ENSG00000111224","PARP11","12",3900213,3982608,82395
"3079","ENSG00000111229","ARPC3","12",110872630,110888227,15597
"3080","ENSG00000111231","GPN3","12",110890289,110907073,16784
"3081","ENSG00000111237","VPS29","12",110928902,110939922,11020
"3082","ENSG00000111247","RAD51AP1","12",4647950,4669214,21264
"3083","ENSG00000111249","CUX2","12",111471828,111788358,316530
"3084","ENSG00000111252","SH2B3","12",111843752,111889427,45675
"3085","ENSG00000111254","AKAP3","12",4724674,4758213,33539
"3086","ENSG00000111261","MANSC1","12",12482198,12503475,21277
"3087","ENSG00000111266","DUSP16","12",12628829,12715317,86488
"3088","ENSG00000111269","CREBL2","12",12764761,12798042,33281
"3089","ENSG00000111271","ACAD10","12",112123857,112194903,71046
"3090","ENSG00000111275","ALDH2","12",112204691,112247782,43091
"3091","ENSG00000111276","CDKN1B","12",12867992,12875305,7313
"3092","ENSG00000111300","NAA25","12",112464500,112546826,82326
"3093","ENSG00000111305","GSG1","12",13236494,13256619,20125
"3094","ENSG00000111325","OGFOD2","12",123459127,123464590,5463
"3095","ENSG00000111328","CDK2AP1","12",123745528,123756881,11353
"3096","ENSG00000111331","OAS3","12",113376157,113411054,34897
"3097","ENSG00000111348","ARHGDIB","12",15094951,15114662,19711
"3098","ENSG00000111358","GTF2H3","12",124118375,124147153,28778
"3099","ENSG00000111361","EIF2B1","12",124104953,124118313,13360
"3100","ENSG00000111364","DDX55","12",124086624,124105488,18864
"3101","ENSG00000111371","SLC38A1","12",46576846,46663800,86954
"3102","ENSG00000111412","C12orf49","12",117153593,117175875,22282
"3103","ENSG00000111445","RFC5","12",118451393,118470935,19542
"3104","ENSG00000111450","STX2","12",131274145,131323811,49666
"3105","ENSG00000111481","COPZ1","12",54694986,54745633,50647
"3106","ENSG00000111490","TBC1D30","12",65174589,65274812,100223
"3107","ENSG00000111530","CAND1","12",67663061,67713731,50670
"3108","ENSG00000111540","RAB5B","12",56367697,56388490,20793
"3109","ENSG00000111554","MDM1","12",68666223,68726161,59938
"3110","ENSG00000111581","NUP107","12",69080514,69136785,56271
"3111","ENSG00000111596","CNOT2","12",70636774,70748773,111999
"3112","ENSG00000111602","TIMELESS","12",56810903,56843187,32284
"3113","ENSG00000111605","CPSF6","12",69633317,69668138,34821
"3114","ENSG00000111615","KRR1","12",75890684,75905416,14732
"3115","ENSG00000111639","MRPL51","12",6601150,6603007,1857
"3116","ENSG00000111640","GAPDH","12",6643093,6647537,4444
"3117","ENSG00000111641","NOP2","12",6666029,6677857,11828
"3118","ENSG00000111642","CHD4","12",6679249,6716642,37393
"3119","ENSG00000111644","ACRBP","12",6747241,6756626,9385
"3120","ENSG00000111647","UHRF1BP1L","12",100422233,100536626,114393
"3121","ENSG00000111652","COPS7A","12",6832907,6841041,8134
"3122","ENSG00000111653","ING4","12",6759446,6772314,12868
"3123","ENSG00000111664","GNB3","12",6949118,6956557,7439
"3124","ENSG00000111665","CDCA3","12",6953957,6961230,7273
"3125","ENSG00000111666","CHPT1","12",102090725,102137918,47193
"3126","ENSG00000111667","USP5","12",6961292,6975796,14504
"3127","ENSG00000111669","TPI1","12",6976283,6980112,3829
"3128","ENSG00000111670","GNPTAB","12",102139275,102224716,85441
"3129","ENSG00000111671","SPSB2","12",6980099,6998522,18423
"3130","ENSG00000111674","ENO2","12",7022909,7032861,9952
"3131","ENSG00000111676","ATN1","12",7033626,7051484,17858
"3132","ENSG00000111678","C12orf57","12",7052141,7055166,3025
"3133","ENSG00000111684","LPCAT3","12",7085348,7125814,40466
"3134","ENSG00000111696","NT5DC3","12",104164231,104234975,70744
"3135","ENSG00000111707","SUDS3","12",118814185,118855840,41655
"3136","ENSG00000111711","GOLT1B","12",21654715,21671342,16627
"3137","ENSG00000111716","LDHB","12",21788276,21910791,122515
"3138","ENSG00000111725","PRKAB1","12",120105558,120119435,13877
"3139","ENSG00000111726","CMAS","12",22199108,22218608,19500
"3140","ENSG00000111727","HCFC2","12",104458235,104498639,40404
"3141","ENSG00000111728","ST8SIA1","12",22216707,22589975,373268
"3142","ENSG00000111731","C2CD5","12",22601517,22697480,95963
"3143","ENSG00000111737","RAB35","12",120532899,120555306,22407
"3144","ENSG00000111752","PHC1","12",9066492,9094063,27571
"3145","ENSG00000111775","COX6A1","12",120875893,120878545,2652
"3146","ENSG00000111783","RFX4","12",106976685,107156581,179896
"3147","ENSG00000111785","RIC8B","12",107168373,107283090,114717
"3148","ENSG00000111786","SRSF9","12",120899471,120907596,8125
"3149","ENSG00000111788","","12",9429831,9466684,36853
"3150","ENSG00000111790","FGFR1OP2","12",27091316,27119583,28267
"3151","ENSG00000111799","COL12A1","6",75794042,75915767,121725
"3152","ENSG00000111801","BTN3A3","6",26440700,26453643,12943
"3153","ENSG00000111802","TDP2","6",24650205,24667261,17056
"3154","ENSG00000111816","FRK","6",116252312,116381921,129609
"3155","ENSG00000111817","DSE","6",116575336,116762424,187088
"3156","ENSG00000111832","RWDD1","6",116892530,116918838,26308
"3157","ENSG00000111834","RSPH4A","6",116937642,116954148,16506
"3158","ENSG00000111837","MAK","6",10762956,10838764,75808
"3159","ENSG00000111843","TMEM14C","6",10723148,10731362,8214
"3160","ENSG00000111845","PAK1IP1","6",10694928,10710015,15087
"3161","ENSG00000111846","GCNT2","6",10492456,10629601,137145
"3162","ENSG00000111850","SMIM8","6",88032301,88052043,19742
"3163","ENSG00000111859","NEDD9","6",11183531,11382581,199050
"3164","ENSG00000111860","CEP85L","6",118781935,119031238,249303
"3165","ENSG00000111875","ASF1A","6",119215384,119230332,14948
"3166","ENSG00000111877","MCM9","6",119134605,119256327,121722
"3167","ENSG00000111879","FAM184A","6",119280928,119470552,189624
"3168","ENSG00000111880","RNGTT","6",89319985,89673348,353363
"3169","ENSG00000111885","MAN1A1","6",119498374,119670926,172552
"3170","ENSG00000111897","SERINC1","6",122764499,122792967,28468
"3171","ENSG00000111906","HDDC2","6",125541108,125623282,82174
"3172","ENSG00000111907","TPD52L1","6",125440195,125585553,145358
"3173","ENSG00000111911","HINT3","6",126277927,126301387,23460
"3174","ENSG00000111912","NCOA7","6",126102307,126252266,149959
"3175","ENSG00000111913","FAM65B","6",24797601,25042238,244637
"3176","ENSG00000111961","SASH1","6",148593440,148873186,279746
"3177","ENSG00000111962","UST","6",149068464,149398126,329662
"3178","ENSG00000111981","ULBP1","6",150285143,150294846,9703
"3179","ENSG00000112029","FBXO5","6",153291664,153304714,13050
"3180","ENSG00000112031","MTRF1L","6",153308497,153323820,15323
"3181","ENSG00000112033","PPARD","6",35310335,35395968,85633
"3182","ENSG00000112039","FANCE","6",35420138,35434880,14742
"3183","ENSG00000112062","MAPK14","6",35995488,36079013,83525
"3184","ENSG00000112078","KCTD20","6",36410544,36458920,48376
"3185","ENSG00000112079","STK38","6",36461669,36515247,53578
"3186","ENSG00000112081","SRSF3","6",36562145,36573377,11232
"3187","ENSG00000112096","SOD2","6",160090089,160183561,93472
"3188","ENSG00000112110","MRPL18","6",160210844,160219468,8624
"3189","ENSG00000112118","MCM3","6",52128807,52149679,20872
"3190","ENSG00000112130","RNF8","6",37321748,37362514,40766
"3191","ENSG00000112137","PHACTR1","6",12717893,13288645,570752
"3192","ENSG00000112139","MDGA1","6",37600284,37667082,66798
"3193","ENSG00000112144","ICK","6",52866077,52926600,60523
"3194","ENSG00000112146","FBXO9","6",52916789,52965671,48882
"3195","ENSG00000112149","CD83","6",14117872,14137149,19277
"3196","ENSG00000112159","MDN1","6",90352218,90529442,177224
"3197","ENSG00000112167","SAYSD1","6",39071840,39082965,11125
"3198","ENSG00000112175","BMP5","6",55618443,55740362,121919
"3199","ENSG00000112182","BACH2","6",90636248,91006627,370379
"3200","ENSG00000112183","RBM24","6",17281577,17294106,12529
"3201","ENSG00000112186","CAP2","6",17393447,17558023,164576
"3202","ENSG00000112200","ZNF451","6",56951642,57035105,83463
"3203","ENSG00000112208","BAG2","6",57037124,57054631,17507
"3204","ENSG00000112210","RAB23","6",57053607,57087078,33471
"3205","ENSG00000112218","GPR63","6",97242002,97285353,43351
"3206","ENSG00000112232","KHDRBS2","6",62389865,62996132,606267
"3207","ENSG00000112234","FBXL4","6",99316420,99395849,79429
"3208","ENSG00000112237","CCNC","6",99990256,100016849,26593
"3209","ENSG00000112242","E2F3","6",20402398,20493941,91543
"3210","ENSG00000112245","PTP4A1","6",64231666,64293492,61826
"3211","ENSG00000112246","SIM1","6",100832891,100912805,79914
"3212","ENSG00000112249","ASCC3","6",100956070,101329248,373178
"3213","ENSG00000112276","BVES","6",105544697,105585049,40352
"3214","ENSG00000112280","COL9A1","6",70924764,71012786,88022
"3215","ENSG00000112282","MED23","6",131895106,131949369,54263
"3216","ENSG00000112290","WASF1","6",110421022,110501207,80185
"3217","ENSG00000112293","GPLD1","6",24424793,24495433,70640
"3218","ENSG00000112294","ALDH5A1","6",24495080,24537435,42355
"3219","ENSG00000112304","ACOT13","6",24667263,24705293,38030
"3220","ENSG00000112305","SMAP1","6",71377479,71571718,194239
"3221","ENSG00000112306","RPS12","6",133135580,133138703,3123
"3222","ENSG00000112308","C6orf62","6",24705089,24721064,15975
"3223","ENSG00000112309","B3GAT2","6",71566382,71666741,100359
"3224","ENSG00000112312","GMNN","6",24775159,24786327,11168
"3225","ENSG00000112319","EYA4","6",133561736,133853258,291522
"3226","ENSG00000112320","SOBP","6",107811162,107981357,170195
"3227","ENSG00000112335","SNX3","6",108532426,108582464,50038
"3228","ENSG00000112339","HBS1L","6",135281516,135424194,142678
"3229","ENSG00000112343","TRIM38","6",25963030,25987384,24354
"3230","ENSG00000112357","PEX7","6",137143717,137235075,91358
"3231","ENSG00000112365","ZBTB24","6",109783797,109804440,20643
"3232","ENSG00000112367","FIG4","6",110012499,110146631,134132
"3233","ENSG00000112378","PERP","6",138409642,138428648,19006
"3234","ENSG00000112379","KIAA1244","6",138483058,138665800,182742
"3235","ENSG00000112394","SLC16A10","6",111408781,111552397,143616
"3236","ENSG00000112406","HECA","6",139456249,139501939,45690
"3237","ENSG00000112414","GPR126","6",142622991,142767403,144412
"3238","ENSG00000112419","PHACTR2","6",143857982,144152322,294340
"3239","ENSG00000112425","EPM2A","6",145822719,146057160,234441
"3240","ENSG00000112473","SLC39A7","6",33168222,33172216,3994
"3241","ENSG00000112511","PHF1","6",33378176,33384230,6054
"3242","ENSG00000112514","CUTA","6",33384219,33386094,1875
"3243","ENSG00000112530","PACRG","6",163148164,163736524,588360
"3244","ENSG00000112531","QKI","6",163835032,163999628,164596
"3245","ENSG00000112539","C6orf118","6",165693153,165723096,29943
"3246","ENSG00000112541","PDE10A","6",165740776,166400091,659315
"3247","ENSG00000112559","MDFI","6",41604620,41621984,17364
"3248","ENSG00000112561","TFEB","6",41651716,41703997,52281
"3249","ENSG00000112562","SMOC2","6",168841831,169073984,232153
"3250","ENSG00000112576","CCND3","6",41902671,42018095,115424
"3251","ENSG00000112578","BYSL","6",41888926,41900784,11858
"3252","ENSG00000112584","FAM120B","6",170599791,170716153,116362
"3253","ENSG00000112592","TBP","6",170863390,170881958,18568
"3254","ENSG00000112624","GLTSCR1L","6",42749765,42836298,86533
"3255","ENSG00000112640","PPP2R5D","6",42952237,42980080,27843
"3256","ENSG00000112651","MRPL2","6",43021767,43027544,5777
"3257","ENSG00000112655","PTK7","6",43044006,43129457,85451
"3258","ENSG00000112658","SRF","6",43139037,43149243,10206
"3259","ENSG00000112659","CUL9","6",43149913,43192325,42412
"3260","ENSG00000112667","DNPH1","6",43193367,43197222,3855
"3261","ENSG00000112679","DUSP22","6",291630,351355,59725
"3262","ENSG00000112685","EXOC2","6",485133,693117,207984
"3263","ENSG00000112695","COX7A2","6",75947391,75960039,12648
"3264","ENSG00000112697","TMEM30A","6",75962640,75994684,32044
"3265","ENSG00000112699","GMDS","6",1624041,2245926,621885
"3266","ENSG00000112701","SENP6","6",76311225,76427997,116772
"3267","ENSG00000112706","IMPG1","6",76630832,76782395,151563
"3268","ENSG00000112715","VEGFA","6",43737921,43754224,16303
"3269","ENSG00000112739","PRPF4B","6",4021501,4065217,43716
"3270","ENSG00000112742","TTK","6",80713604,80752244,38640
"3271","ENSG00000112759","SLC29A1","6",44187242,44201888,14646
"3272","ENSG00000112763","BTN2A1","6",26458150,26476849,18699
"3273","ENSG00000112769","LAMA4","6",112429963,112576141,146178
"3274","ENSG00000112773","FAM46A","6",82201156,82462491,261335
"3275","ENSG00000112787","FBRSL1","12",133066137,133161774,95637
"3276","ENSG00000112851","ERBB2IP","5",65222303,65378377,156074
"3277","ENSG00000112852","PCDHB2","5",140474227,140476962,2735
"3278","ENSG00000112855","HARS2","5",140071011,140078889,7878
"3279","ENSG00000112874","NUDT12","5",102884556,102898494,13938
"3280","ENSG00000112877","CEP72","5",612387,667283,54896
"3281","ENSG00000112893","MAN2A1","5",109025067,109205326,180259
"3282","ENSG00000112902","SEMA5A","5",9035138,9546187,511049
"3283","ENSG00000112941","PAPD7","5",6714718,6757161,42443
"3284","ENSG00000112964","GHR","5",42423879,42721979,298100
"3285","ENSG00000112972","HMGCS1","5",43289497,43313614,24117
"3286","ENSG00000112977","DAP","5",10679342,10761384,82042
"3287","ENSG00000112981","NME5","5",137450866,137475132,24266
"3288","ENSG00000112983","BRD8","5",137475455,137514675,39220
"3289","ENSG00000112984","KIF20A","5",137514408,137523404,8996
"3290","ENSG00000112992","NNT","5",43602794,43707507,104713
"3291","ENSG00000112996","MRPS30","5",44809027,44820530,11503
"3292","ENSG00000113013","HSPA9","5",137890571,137911133,20562
"3293","ENSG00000113048","MRPS27","5",71515236,71616473,101237
"3294","ENSG00000113068","PFDN1","5",139624624,139682706,58082
"3295","ENSG00000113070","HBEGF","5",139712428,139726216,13788
"3296","ENSG00000113083","LOX","5",121398890,121413980,15090
"3297","ENSG00000113100","CDH9","5",26880709,27121257,240548
"3298","ENSG00000113108","APBB3","5",139937853,139973337,35484
"3299","ENSG00000113119","TMCO6","5",140019012,140024993,5981
"3300","ENSG00000113140","SPARC","5",151040657,151066726,26069
"3301","ENSG00000113141","IK","5",140026643,140042064,15421
"3302","ENSG00000113161","HMGCR","5",74632154,74657929,25775
"3303","ENSG00000113163","COL4A3BP","5",74664311,74807963,143652
"3304","ENSG00000113194","FAF2","5",175874629,175937075,62446
"3305","ENSG00000113205","PCDHB3","5",140480234,140483406,3172
"3306","ENSG00000113209","PCDHB5","5",140514800,140517703,2903
"3307","ENSG00000113211","PCDHB6","5",140529683,140532868,3185
"3308","ENSG00000113212","PCDHB7","5",140552243,140555957,3714
"3309","ENSG00000113231","PDE8B","5",76506274,76725632,219358
"3310","ENSG00000113240","CLK4","5",178029665,178057616,27951
"3311","ENSG00000113248","PCDHB15","5",140625147,140627799,2652
"3312","ENSG00000113263","ITK","5",156569944,156682201,112257
"3313","ENSG00000113269","RNF130","5",179338651,179499118,160467
"3314","ENSG00000113272","THG1L","5",157158205,157168456,10251
"3315","ENSG00000113273","ARSB","5",78073032,78281910,208878
"3316","ENSG00000113282","CLINT1","5",157212751,157286183,73432
"3317","ENSG00000113296","THBS4","5",79287134,79379110,91976
"3318","ENSG00000113300","CNOT6","5",179921412,180005405,83993
"3319","ENSG00000113312","TTC1","5",159436120,159492550,56430
"3320","ENSG00000113318","MSH3","5",79950467,80172279,221812
"3321","ENSG00000113319","RASGRF2","5",80256491,80525975,269484
"3322","ENSG00000113328","CCNG1","5",162864575,162873157,8582
"3323","ENSG00000113356","POLR3G","5",89767565,89810370,42805
"3324","ENSG00000113360","DROSHA","5",31400604,31532303,131699
"3325","ENSG00000113361","CDH6","5",31193857,31329253,135396
"3326","ENSG00000113368","LMNB1","5",126112315,126172712,60397
"3327","ENSG00000113369","ARRDC3","5",90664541,90679176,14635
"3328","ENSG00000113384","GOLPH3","5",32124810,32174456,49646
"3329","ENSG00000113387","SUB1","5",32531739,32604185,72446
"3330","ENSG00000113391","FAM172A","5",92953775,93447404,493629
"3331","ENSG00000113407","TARS","5",33440802,33469644,28842
"3332","ENSG00000113441","LNPEP","5",96271098,96373219,102121
"3333","ENSG00000113448","PDE4D","5",58264865,59817947,1553082
"3334","ENSG00000113456","RAD1","5",34905369,34919094,13725
"3335","ENSG00000113460","BRIX1","5",34915481,34926101,10620
"3336","ENSG00000113494","PRLR","5",35048861,35230794,181933
"3337","ENSG00000113504","SLC12A7","5",1050499,1112150,61651
"3338","ENSG00000113522","RAD50","5",131891711,131980313,88602
"3339","ENSG00000113532","ST8SIA4","5",100142639,100238970,96331
"3340","ENSG00000113552","GNPDA1","5",141371314,141392606,21292
"3341","ENSG00000113555","PCDH12","5",141323150,141349304,26154
"3342","ENSG00000113558","SKP1","5",133484633,133512729,28096
"3343","ENSG00000113569","NUP155","5",37288239,37371283,83044
"3344","ENSG00000113575","PPP2CA","5",133530025,133561833,31808
"3345","ENSG00000113580","NR3C1","5",142657496,142815077,157581
"3346","ENSG00000113583","C5orf15","5",133291201,133304478,13277
"3347","ENSG00000113593","PPWD1","5",64859063,64883376,24313
"3348","ENSG00000113594","LIFR","5",38475065,38608456,133391
"3349","ENSG00000113595","TRIM23","5",64885507,64921802,36295
"3350","ENSG00000113597","TRAPPC13","5",64920543,64962060,41517
"3351","ENSG00000113615","SEC24A","5",133984479,134063513,79034
"3352","ENSG00000113621","TXNDC15","5",134209493,134237215,27722
"3353","ENSG00000113638","TTC33","5",40714577,40756077,41500
"3354","ENSG00000113643","RARS","5",167913450,167946304,32854
"3355","ENSG00000113645","WWC1","5",167718656,167899308,180652
"3356","ENSG00000113648","H2AFY","5",134669590,134735604,66014
"3357","ENSG00000113649","TCERG1","5",145826874,145891524,64650
"3358","ENSG00000113657","DPYSL3","5",146770374,146889619,119245
"3359","ENSG00000113658","SMAD5","5",135468534,135524435,55901
"3360","ENSG00000113712","CSNK1A1","5",148871760,148931007,59247
"3361","ENSG00000113716","HMGXB3","5",149379884,149432386,52502
"3362","ENSG00000113719","ERGIC1","5",172261278,172379688,118410
"3363","ENSG00000113721","PDGFRB","5",149493400,149535435,42035
"3364","ENSG00000113732","ATP6V0E1","5",172410760,172462448,51688
"3365","ENSG00000113734","BNIP1","5",172571445,172591390,19945
"3366","ENSG00000113739","STC2","5",172741716,172756506,14790
"3367","ENSG00000113742","CPEB4","5",173315283,173388979,73696
"3368","ENSG00000113758","DBN1","5",176883609,176901402,17793
"3369","ENSG00000113761","ZNF346","5",176449697,176508190,58493
"3370","ENSG00000113790","EHHADH","3",184908412,184999778,91366
"3371","ENSG00000113805","CNTN3","3",74311719,74570291,258572
"3372","ENSG00000113810","SMC4","3",160117062,160152750,35688
"3373","ENSG00000113811","","3",53918437,53926015,7578
"3374","ENSG00000113812","ACTR8","3",53901093,53916229,15136
"3375","ENSG00000113838","TBCCD1","3",186263862,186288332,24470
"3376","ENSG00000113845","TIMMDC1","3",119217379,119243937,26558
"3377","ENSG00000113851","CRBN","3",3190676,3221394,30718
"3378","ENSG00000113916","BCL6","3",187439165,187463515,24350
"3379","ENSG00000113924","HGD","3",120347020,120401418,54398
"3380","ENSG00000113966","ARL6","3",97483365,97519953,36588
"3381","ENSG00000113971","NPHP3","3",132276986,132441303,164317
"3382","ENSG00000114019","AMOTL2","3",134074716,134094321,19605
"3383","ENSG00000114021","NIT2","3",100053545,100075710,22165
"3384","ENSG00000114023","FAM162A","3",122103023,122131181,28158
"3385","ENSG00000114026","OGG1","3",9791628,9829903,38275
"3386","ENSG00000114030","KPNA1","3",122140796,122233792,92996
"3387","ENSG00000114054","PCCB","3",135969148,136056738,87590
"3388","ENSG00000114062","UBE3A","15",25582381,25684128,101747
"3389","ENSG00000114098","ARMC8","3",137906109,138017231,111122
"3390","ENSG00000114107","CEP70","3",138213186,138313380,100194
"3391","ENSG00000114115","RBP1","3",139236276,139258671,22395
"3392","ENSG00000114120","SLC25A36","3",140660672,140698775,38103
"3393","ENSG00000114125","RNF7","3",141457046,141466402,9356
"3394","ENSG00000114126","TFDP2","3",141663277,141868386,205109
"3395","ENSG00000114127","XRN1","3",142025449,142166904,141455
"3396","ENSG00000114166","KAT2B","3",20081515,20195896,114381
"3397","ENSG00000114200","BCHE","3",165490692,165555260,64568
"3398","ENSG00000114204","SERPINI2","3",167159577,167196792,37215
"3399","ENSG00000114209","PDCD10","3",167401086,167452727,51641
"3400","ENSG00000114251","WNT5A","3",55499743,55523973,24230
"3401","ENSG00000114268","PFKFB4","3",48555117,48599448,44331
"3402","ENSG00000114270","COL7A1","3",48601506,48632700,31194
"3403","ENSG00000114279","FGF12","3",191857184,192485553,628369
"3404","ENSG00000114302","PRKAR2A","3",48782030,48885279,103249
"3405","ENSG00000114315","HES1","3",193853934,193856521,2587
"3406","ENSG00000114316","USP4","3",49315264,49378145,62881
"3407","ENSG00000114331","ACAP2","3",194995465,195163807,168342
"3408","ENSG00000114346","ECT2","3",172468472,172539264,70792
"3409","ENSG00000114353","GNAI2","3",50263724,50296787,33063
"3410","ENSG00000114354","TFG","3",100428205,100467810,39605
"3411","ENSG00000114374","USP9Y","Y",14813160,14972764,159604
"3412","ENSG00000114378","HYAL1","3",50337320,50349812,12492
"3413","ENSG00000114383","TUSC2","3",50357458,50365682,8224
"3414","ENSG00000114388","NPRL2","3",50384761,50388522,3761
"3415","ENSG00000114391","RPL24","3",101399935,101405626,5691
"3416","ENSG00000114395","CYB561D2","3",50388126,50395891,7765
"3417","ENSG00000114405","C3orf14","3",62304648,62321888,17240
"3418","ENSG00000114416","FXR1","3",180585929,180700541,114612
"3419","ENSG00000114423","CBLB","3",105374305,105588396,214091
"3420","ENSG00000114439","BBX","3",107241783,107530171,288388
"3421","ENSG00000114446","IFT57","3",107879659,107941417,61758
"3422","ENSG00000114450","GNB4","3",179116990,179169378,52388
"3423","ENSG00000114473","IQCG","3",197615946,197687013,71067
"3424","ENSG00000114480","GBE1","3",81538850,81811312,272462
"3425","ENSG00000114491","UMPS","3",124449213,124464040,14827
"3426","ENSG00000114503","NCBP2","3",196662273,196669468,7195
"3427","ENSG00000114520","SNX4","3",125165495,125239041,73546
"3428","ENSG00000114529","C3orf52","3",111805182,111849851,44669
"3429","ENSG00000114541","FRMD4B","3",69219141,69591734,372593
"3430","ENSG00000114544","SLC41A3","3",125725198,125820404,95206
"3431","ENSG00000114554","PLXNA1","3",126707437,126756235,48798
"3432","ENSG00000114573","ATP6V1A","3",113465866,113530903,65037
"3433","ENSG00000114626","ABTB1","3",127391778,127399768,7990
"3434","ENSG00000114631","PODXL2","3",127348024,127391652,43628
"3435","ENSG00000114646","CSPG5","3",47603729,47622282,18553
"3436","ENSG00000114648","KLHL18","3",47324407,47388306,63899
"3437","ENSG00000114650","SCAP","3",47455203,47518616,63413
"3438","ENSG00000114654","EFCC1","3",128720472,128759585,39113
"3439","ENSG00000114656","KIAA1257","3",128628709,128721533,92824
"3440","ENSG00000114670","NEK11","3",130745694,131069309,323615
"3441","ENSG00000114686","MRPL3","3",131181056,131221827,40771
"3442","ENSG00000114698","PLSCR4","3",145910126,145968966,58840
"3443","ENSG00000114735","HEMK1","3",50606583,50622366,15783
"3444","ENSG00000114737","CISH","3",50643921,50649262,5341
"3445","ENSG00000114738","MAPKAPK3","3",50648951,50686720,37769
"3446","ENSG00000114739","ACVR2B","3",38495342,38534633,39291
"3447","ENSG00000114742","WDR48","3",39093489,39138155,44666
"3448","ENSG00000114744","COMMD2","3",149456257,149470286,14029
"3449","ENSG00000114745","GORASP1","3",39138150,39149854,11704
"3450","ENSG00000114767","RRP9","3",51967446,51975957,8511
"3451","ENSG00000114770","ABCC5","3",183637722,183735803,98081
"3452","ENSG00000114779","ABHD14B","3",52002526,52017425,14899
"3453","ENSG00000114784","EIF1B","3",40351175,40353915,2740
"3454","ENSG00000114790","ARHGEF26","3",153838792,153975616,136824
"3455","ENSG00000114796","KLHL24","3",183353356,183402265,48909
"3456","ENSG00000114805","PLCH1","3",155093369,155462856,369487
"3457","ENSG00000114841","DNAH1","3",52350335,52434507,84172
"3458","ENSG00000114850","SSR3","3",156257929,156272973,15044
"3459","ENSG00000114853","ZBTB47","3",42695176,42709072,13896
"3460","ENSG00000114857","NKTR","3",42642106,42690227,48121
"3461","ENSG00000114859","CLCN2","3",184063973,184079439,15466
"3462","ENSG00000114861","FOXP1","3",71003844,71633140,629296
"3463","ENSG00000114867","EIF4G1","3",184032283,184053146,20863
"3464","ENSG00000114902","SPCS1","3",52738971,52742182,3211
"3465","ENSG00000114904","NEK4","3",52744800,52804965,60165
"3466","ENSG00000114923","SLC4A3","2",220492049,220506702,14653
"3467","ENSG00000114933","INO80D","2",206858445,206951027,92582
"3468","ENSG00000114942","EEF1B2","2",207024309,207027652,3343
"3469","ENSG00000114948","ADAM23","2",207308263,207485851,177588
"3470","ENSG00000114956","DGUOK","2",74153953,74186088,32135
"3471","ENSG00000114978","MOB1A","2",74379655,74406025,26370
"3472","ENSG00000114982","KANSL3","2",97258907,97308524,49617
"3473","ENSG00000114988","LMAN2L","2",97371666,97405801,34135
"3474","ENSG00000114993","RTKN","2",74652963,74669549,16586
"3475","ENSG00000114999","TTL","2",113239731,113299316,59585
"3476","ENSG00000115020","PIKFYVE","2",209130991,209223475,92484
"3477","ENSG00000115041","KCNIP3","2",95963052,96051825,88773
"3478","ENSG00000115042","FAHD2A","2",96068469,96082364,13895
"3479","ENSG00000115053","NCL","2",232318242,232348352,30110
"3480","ENSG00000115073","ACTR1B","2",98272431,98280570,8139
"3481","ENSG00000115084","SLC35F5","2",114462588,114514400,51812
"3482","ENSG00000115091","ACTR3","2",114647537,114720173,72636
"3483","ENSG00000115109","EPB41L5","2",120770581,120936695,166114
"3484","ENSG00000115128","","2",24290454,24299313,8859
"3485","ENSG00000115129","TP53I3","2",24300303,24308731,8428
"3486","ENSG00000115137","DNAJC27","2",25166505,25194963,28458
"3487","ENSG00000115145","STAM2","2",152973315,153032506,59191
"3488","ENSG00000115159","GPD2","2",157291802,157470247,178445
"3489","ENSG00000115163","CENPA","2",26987157,27023935,36778
"3490","ENSG00000115170","ACVR1","2",158592958,158732374,139416
"3491","ENSG00000115183","TANC1","2",159825146,160089170,264024
"3492","ENSG00000115204","MPV17","2",27532360,27548547,16187
"3493","ENSG00000115207","GTF3C2","2",27548716,27579868,31152
"3494","ENSG00000115211","EIF2B4","2",27587219,27593353,6134
"3495","ENSG00000115216","NRBP1","2",27650657,27665126,14469
"3496","ENSG00000115226","FNDC4","2",27714750,27718112,3362
"3497","ENSG00000115232","ITGA4","2",182321929,182400914,78985
"3498","ENSG00000115233","PSMD14","2",162164549,162268228,103679
"3499","ENSG00000115234","SNX17","2",27593389,27599995,6606
"3500","ENSG00000115239","GPR75-ASB3","2",53759810,54087170,327360
"3501","ENSG00000115241","PPM1G","2",27604061,27632554,28493
"3502","ENSG00000115252","PDE1A","2",183004763,183387919,383156
"3503","ENSG00000115255","REEP6","19",1491165,1497926,6761
"3504","ENSG00000115257","PCSK4","19",1481427,1490751,9324
"3505","ENSG00000115266","APC2","19",1446300,1473243,26943
"3506","ENSG00000115267","IFIH1","2",163123589,163175213,51624
"3507","ENSG00000115268","RPS15","19",1438358,1440583,2225
"3508","ENSG00000115271","GCA","2",163175350,163228105,52755
"3509","ENSG00000115274","INO80B","2",74682150,74688011,5861
"3510","ENSG00000115275","MOGS","2",74688184,74692537,4353
"3511","ENSG00000115282","TTC31","2",74710200,74722013,11813
"3512","ENSG00000115286","NDUFS7","19",1383526,1395583,12057
"3513","ENSG00000115289","PCGF1","2",74732170,74735707,3537
"3514","ENSG00000115290","GRB14","2",165349322,165478358,129036
"3515","ENSG00000115295","CLIP4","2",29320571,29412509,91938
"3516","ENSG00000115306","SPTBN1","2",54683422,54896812,213390
"3517","ENSG00000115307","AUP1","2",74753772,74757066,3294
"3518","ENSG00000115310","RTN4","2",55199325,55339757,140432
"3519","ENSG00000115317","HTRA2","2",74756504,74760472,3968
"3520","ENSG00000115318","LOXL3","2",74759541,74782817,23276
"3521","ENSG00000115325","DOK1","2",74776153,74784681,8528
"3522","ENSG00000115350","POLE4","2",75185619,75197255,11636
"3523","ENSG00000115355","CCDC88A","2",55514978,55647057,132079
"3524","ENSG00000115364","MRPL19","2",75873909,75917977,44068
"3525","ENSG00000115365","LANCL1","2",211295973,211342376,46403
"3526","ENSG00000115368","WDR75","2",190306159,190340291,34132
"3527","ENSG00000115380","EFEMP1","2",56093102,56151274,58172
"3528","ENSG00000115392","FANCL","2",58386378,58468507,82129
"3529","ENSG00000115414","FN1","2",216225163,216300895,75732
"3530","ENSG00000115415","STAT1","2",191829084,191885686,56602
"3531","ENSG00000115419","GLS","2",191745553,191830278,84725
"3532","ENSG00000115421","PAPOLG","2",60983365,61029220,45855
"3533","ENSG00000115423","DNAH6","2",84743579,85046713,303134
"3534","ENSG00000115425","PECR","2",216861052,216947678,86626
"3535","ENSG00000115446","UNC50","2",99225042,99234978,9936
"3536","ENSG00000115457","IGFBP2","2",217497551,217529159,31608
"3537","ENSG00000115459","ELMOD3","2",85581517,85618875,37358
"3538","ENSG00000115461","IGFBP5","2",217536828,217560248,23420
"3539","ENSG00000115464","USP34","2",61414598,61697904,283306
"3540","ENSG00000115468","EFHD1","2",233470767,233547491,76724
"3541","ENSG00000115484","CCT4","2",62095224,62115939,20715
"3542","ENSG00000115486","GGCX","2",85771846,85788670,16824
"3543","ENSG00000115504","EHBP1","2",62900986,63273622,372636
"3544","ENSG00000115507","OTX1","2",63277192,63284971,7779
"3545","ENSG00000115514","TXNDC9","2",99935445,99957165,21720
"3546","ENSG00000115520","COQ10B","2",198318147,198340032,21885
"3547","ENSG00000115524","SF3B1","2",198254508,198299815,45307
"3548","ENSG00000115525","ST3GAL5","2",86066267,86116137,49870
"3549","ENSG00000115526","CHST10","2",101008327,101034118,25791
"3550","ENSG00000115539","PDCL3","2",101179152,101193197,14045
"3551","ENSG00000115540","MOB4","2",198380295,198418423,38128
"3552","ENSG00000115541","HSPE1","2",198364718,198368181,3463
"3553","ENSG00000115548","KDM3A","2",86667770,86719839,52069
"3554","ENSG00000115556","PLCD4","2",219472488,219501907,29419
"3555","ENSG00000115561","CHMP3","2",86730554,86948245,217691
"3556","ENSG00000115568","ZNF142","2",219502639,219524378,21739
"3557","ENSG00000115594","IL1R1","2",102681004,102796334,115330
"3558","ENSG00000115641","FHL2","2",105974169,106054970,80801
"3559","ENSG00000115648","MLPH","2",238394071,238463961,69890
"3560","ENSG00000115649","CNPPD1","2",220036619,220042828,6209
"3561","ENSG00000115652","UXS1","2",106709759,106810795,101036
"3562","ENSG00000115657","ABCB6","2",220074490,220083712,9222
"3563","ENSG00000115661","STK16","2",220110177,220115059,4882
"3564","ENSG00000115677","HDLBP","2",242166679,242256476,89797
"3565","ENSG00000115685","PPP1R7","2",242088991,242123067,34076
"3566","ENSG00000115687","PASK","2",242045514,242089679,44165
"3567","ENSG00000115694","STK25","2",242432089,242449145,17056
"3568","ENSG00000115705","TPO","2",1377995,1547483,169488
"3569","ENSG00000115738","ID2","2",8818975,8824583,5608
"3570","ENSG00000115750","TAF1B","2",9983483,10074545,91062
"3571","ENSG00000115756","HPCAL1","2",10443015,10567743,124728
"3572","ENSG00000115758","ODC1","2",10580094,10588630,8536
"3573","ENSG00000115760","BIRC6","2",32582096,32843966,261870
"3574","ENSG00000115761","NOL10","2",10710892,10830101,119209
"3575","ENSG00000115762","PLEKHB2","2",131862420,132111282,248862
"3576","ENSG00000115806","GORASP2","2",171784974,171823639,38665
"3577","ENSG00000115808","STRN","2",37070783,37193615,122832
"3578","ENSG00000115816","CEBPZ","2",37428755,37458856,30101
"3579","ENSG00000115825","PRKD3","2",37477645,37551951,74306
"3580","ENSG00000115827","DCAF17","2",172290727,172341562,50835
"3581","ENSG00000115839","RAB3GAP1","2",135809835,135933964,124129
"3582","ENSG00000115840","SLC25A12","2",172640880,172864766,223886
"3583","ENSG00000115841","RMDN2","2",38150330,38294285,143955
"3584","ENSG00000115850","LCT","2",136545410,136594750,49340
"3585","ENSG00000115866","DARS","2",136664247,136743670,79423
"3586","ENSG00000115875","SRSF7","2",38970741,38978636,7895
"3587","ENSG00000115884","SDC1","2",20400558,20425194,24636
"3588","ENSG00000115896","PLCL1","2",198669426,199437305,767879
"3589","ENSG00000115902","SLC1A4","2",65215611,65250999,35388
"3590","ENSG00000115904","SOS1","2",39208537,39351486,142949
"3591","ENSG00000115935","WIPF1","2",175424300,175547644,123344
"3592","ENSG00000115942","ORC2","2",201773696,201828403,54707
"3593","ENSG00000115944","COX7A2L","2",42560686,42652228,91542
"3594","ENSG00000115946","PNO1","2",68384976,68403370,18394
"3595","ENSG00000115947","ORC4","2",148687968,148779147,91179
"3596","ENSG00000115963","RND3","2",151324709,151395525,70816
"3597","ENSG00000115966","ATF2","2",175936978,176033110,96132
"3598","ENSG00000115970","THADA","2",43393800,43823185,429385
"3599","ENSG00000115977","AAK1","2",69688532,69901481,212949
"3600","ENSG00000115993","TRAK2","2",202241930,202316302,74372
"3601","ENSG00000115998","C2orf42","2",70377012,70475747,98735
"3602","ENSG00000116001","TIA1","2",70436576,70475792,39216
"3603","ENSG00000116005","PCYOX1","2",70484518,70508323,23805
"3604","ENSG00000116016","EPAS1","2",46520806,46613836,93030
"3605","ENSG00000116017","ARID3A","19",925781,975939,50158
"3606","ENSG00000116030","SUMO1","2",203070903,203103331,32428
"3607","ENSG00000116035","VAX2","2",71127720,71160576,32856
"3608","ENSG00000116039","ATP6V1B1","2",71163012,71192536,29524
"3609","ENSG00000116044","NFE2L2","2",178092323,178257425,165102
"3610","ENSG00000116062","MSH6","2",47922669,48037240,114571
"3611","ENSG00000116095","PLEKHA3","2",179345195,179381189,35994
"3612","ENSG00000116096","SPR","2",73114489,73119287,4798
"3613","ENSG00000116106","EPHA4","2",222282747,222438922,156175
"3614","ENSG00000116117","PARD3B","2",205410516,206484886,1074370
"3615","ENSG00000116120","FARSB","2",223435255,223521056,85801
"3616","ENSG00000116127","ALMS1","2",73612886,73837920,225034
"3617","ENSG00000116128","BCL9","1",147013182,147098017,84835
"3618","ENSG00000116132","PRRX1","1",170631869,170708560,76691
"3619","ENSG00000116133","DHCR24","1",55315306,55352891,37585
"3620","ENSG00000116138","DNAJC16","1",15853308,15918874,65566
"3621","ENSG00000116141","MARK1","1",220701568,220837803,136235
"3622","ENSG00000116151","MORN1","1",2252692,2323146,70454
"3623","ENSG00000116157","GPX7","1",53068044,53074723,6679
"3624","ENSG00000116161","CACYBP","1",174968300,174980851,12551
"3625","ENSG00000116171","SCP2","1",53392901,53517375,124474
"3626","ENSG00000116191","RALGPS2","1",178694300,178889238,194938
"3627","ENSG00000116198","CEP104","1",3728645,3773778,45133
"3628","ENSG00000116199","FAM20B","1",178994939,179045697,50758
"3629","ENSG00000116205","TCEANC2","1",54519260,54578192,58932
"3630","ENSG00000116209","TMEM59","1",54497347,54519177,21830
"3631","ENSG00000116212","LRRC42","1",54411750,54433841,22091
"3632","ENSG00000116213","WRAP73","1",3547331,3569325,21994
"3633","ENSG00000116221","MRPL37","1",54649714,54691137,41423
"3634","ENSG00000116237","ICMT","1",6281253,6296032,14779
"3635","ENSG00000116251","RPL22","1",6241329,6269449,28120
"3636","ENSG00000116260","QSOX1","1",180123969,180173165,49196
"3637","ENSG00000116266","STXBP3","1",109289296,109352148,62852
"3638","ENSG00000116273","PHF13","1",6673745,6684093,10348
"3639","ENSG00000116285","ERRFI1","1",8064464,8086368,21904
"3640","ENSG00000116288","PARK7","1",8014351,8045565,31214
"3641","ENSG00000116299","KIAA1324","1",109656301,109749401,93100
"3642","ENSG00000116337","AMPD2","1",110158726,110174673,15947
"3643","ENSG00000116350","SRSF4","1",29474255,29508499,34244
"3644","ENSG00000116353","MECR","1",29519385,29557454,38069
"3645","ENSG00000116396","KCNC4","1",110753965,110825722,71757
"3646","ENSG00000116406","EDEM3","1",184659365,184724047,64682
"3647","ENSG00000116455","WDR77","1",111982512,111991998,9486
"3648","ENSG00000116459","ATP5F1","1",111991486,112005395,13909
"3649","ENSG00000116473","RAP1A","1",112084840,112259313,174473
"3650","ENSG00000116478","HDAC1","1",32757687,32799236,41549
"3651","ENSG00000116489","CAPZA1","1",113161795,113214241,52446
"3652","ENSG00000116497","S100PBP","1",33282368,33324476,42108
"3653","ENSG00000116514","RNF19B","1",33402046,33430286,28240
"3654","ENSG00000116521","SCAMP3","1",155225770,155232221,6451
"3655","ENSG00000116525","TRIM62","1",33611003,33647660,36657
"3656","ENSG00000116539","ASH1L","1",155305059,155532598,227539
"3657","ENSG00000116560","SFPQ","1",35641979,35658749,16770
"3658","ENSG00000116574","RHOU","1",228870824,228882416,11592
"3659","ENSG00000116580","GON4L","1",155719508,155829191,109683
"3660","ENSG00000116584","ARHGEF2","1",155916630,155976861,60231
"3661","ENSG00000116586","LAMTOR2","1",156024543,156028301,3758
"3662","ENSG00000116604","MEF2D","1",156433519,156470620,37101
"3663","ENSG00000116641","DOCK7","1",62920399,63153969,233570
"3664","ENSG00000116649","SRM","1",11114641,11120081,5440
"3665","ENSG00000116652","DLEU2L","1",64014588,64015405,817
"3666","ENSG00000116667","C1orf21","1",184356192,184598154,241962
"3667","ENSG00000116668","SWT1","1",185126212,185260897,134685
"3668","ENSG00000116670","MAD2L2","1",11734537,11751707,17170
"3669","ENSG00000116675","DNAJC6","1",65713902,65881552,167650
"3670","ENSG00000116678","LEPR","1",65886248,66107242,220994
"3671","ENSG00000116679","IVNS1ABP","1",185265520,185286461,20941
"3672","ENSG00000116685","KIAA2013","1",11979648,11986485,6837
"3673","ENSG00000116688","MFN2","1",12040238,12073571,33333
"3674","ENSG00000116691","MIIP","1",12079523,12092102,12579
"3675","ENSG00000116698","SMG7","1",183441351,183567381,126030
"3676","ENSG00000116704","SLC35D1","1",67465015,67519782,54767
"3677","ENSG00000116711","PLA2G4A","1",186798085,186958113,160028
"3678","ENSG00000116717","GADD45A","1",68150744,68154021,3277
"3679","ENSG00000116729","WLS","1",68564142,68698803,134661
"3680","ENSG00000116731","PRDM2","1",14026693,14151574,124881
"3681","ENSG00000116741","RGS2","1",192778169,192781403,3234
"3682","ENSG00000116747","TROVE2","1",193028552,193060907,32355
"3683","ENSG00000116750","UCHL5","1",192981380,193029237,47857
"3684","ENSG00000116752","BCAS2","1",115110178,115124260,14082
"3685","ENSG00000116754","SRSF11","1",70671365,70718735,47370
"3686","ENSG00000116761","CTH","1",70876901,70905534,28633
"3687","ENSG00000116774","OLFML3","1",114522063,114524876,2813
"3688","ENSG00000116786","PLEKHM2","1",16010827,16061264,50437
"3689","ENSG00000116791","CRYZ","1",75171170,75199092,27922
"3690","ENSG00000116793","PHTF1","1",114239453,114302111,62658
"3691","ENSG00000116809","ZBTB17","1",16268364,16302627,34263
"3692","ENSG00000116815","CD58","1",117057157,117113661,56504
"3693","ENSG00000116819","TFAP2E","1",36038971,36060929,21958
"3694","ENSG00000116830","TTF2","1",117602925,117650075,47150
"3695","ENSG00000116833","NR5A2","1",199996730,200146552,149822
"3696","ENSG00000116852","KIF21B","1",200938520,200992828,54308
"3697","ENSG00000116857","TMEM9","1",201103900,201140702,36802
"3698","ENSG00000116863","ADPRHL2","1",36554476,36559533,5057
"3699","ENSG00000116871","MAP7D1","1",36621180,36646450,25270
"3700","ENSG00000116874","WARS2","1",119573839,119683294,109455
"3701","ENSG00000116883","","1",36789335,36794822,5487
"3702","ENSG00000116885","OSCP1","1",36881428,36916086,34658
"3703","ENSG00000116898","MRPS15","1",36921319,36930038,8719
"3704","ENSG00000116903","EXOC8","1",231468480,231473598,5118
"3705","ENSG00000116906","GNPAT","1",231376953,231413719,36766
"3706","ENSG00000116918","TSNAX","1",231664399,231702270,37871
"3707","ENSG00000116922","C1orf109","1",38147242,38157914,10672
"3708","ENSG00000116954","RRAGC","1",39303870,39325495,21625
"3709","ENSG00000116957","TBCE","1",235530675,235612283,81608
"3710","ENSG00000116962","NID1","1",236139130,236228462,89332
"3711","ENSG00000116977","LGALS8","1",236681300,236716281,34981
"3712","ENSG00000116983","HPCAL4","1",40144320,40157361,13041
"3713","ENSG00000116984","MTR","1",236958610,237067281,108671
"3714","ENSG00000116985","BMP8B","1",40222854,40254533,31679
"3715","ENSG00000116990","MYCL","1",40361098,40367928,6830
"3716","ENSG00000116991","SIPA1L2","1",232533711,232697304,163593
"3717","ENSG00000117000","RLF","1",40627045,40706593,79548
"3718","ENSG00000117010","ZNF684","1",40997233,41013841,16608
"3719","ENSG00000117013","KCNQ4","1",41249684,41306124,56440
"3720","ENSG00000117016","RIMS3","1",41086351,41131329,44978
"3721","ENSG00000117020","AKT3","1",243651535,244014381,362846
"3722","ENSG00000117036","ETV3","1",157090983,157108266,17283
"3723","ENSG00000117054","ACADM","1",76190036,76253260,63224
"3724","ENSG00000117069","ST6GALNAC5","1",77333126,77531396,198270
"3725","ENSG00000117114","LPHN2","1",81771845,82458120,686275
"3726","ENSG00000117115","PADI2","1",17393256,17445948,52692
"3727","ENSG00000117118","SDHB","1",17345217,17380665,35448
"3728","ENSG00000117122","MFAP2","1",17300997,17307330,6333
"3729","ENSG00000117133","RPF1","1",84944942,84963473,18531
"3730","ENSG00000117139","KDM5B","1",202696526,202778598,82072
"3731","ENSG00000117143","UAP1","1",162531323,162569627,38304
"3732","ENSG00000117151","CTBS","1",85015289,85040163,24874
"3733","ENSG00000117152","RGS4","1",163038565,163046592,8027
"3734","ENSG00000117153","KLHL12","1",202860228,202897764,37536
"3735","ENSG00000117155","SSX2IP","1",85109390,85156486,47096
"3736","ENSG00000117174","ZNHIT6","1",86115106,86174116,59010
"3737","ENSG00000117222","RBBP5","1",205055270,205091143,35873
"3738","ENSG00000117226","GBP3","1",89472349,89488577,16228
"3739","ENSG00000117242","PINK1-AS","1",20969150,20978686,9536
"3740","ENSG00000117245","KIF17","1",20990507,21044510,54003
"3741","ENSG00000117262","GPR89A","1",145764411,145827103,62692
"3742","ENSG00000117280","RAB7L1","1",205737114,205744588,7474
"3743","ENSG00000117289","TXNIP","1",145438469,145442635,4166
"3744","ENSG00000117298","ECE1","1",21543740,21671997,128257
"3745","ENSG00000117305","HMGCL","1",24128375,24165110,36735
"3746","ENSG00000117308","GALE","1",24122089,24127271,5182
"3747","ENSG00000117318","ID3","1",23884409,23886285,1876
"3748","ENSG00000117335","CD46","1",207925402,207968858,43456
"3749","ENSG00000117360","PRPF3","1",150293925,150325671,31746
"3750","ENSG00000117362","APH1A","1",150237804,150241980,4176
"3751","ENSG00000117385","LEPRE1","1",43212006,43232755,20749
"3752","ENSG00000117394","SLC2A1","1",43391052,43424530,33478
"3753","ENSG00000117395","EBNA1BP2","1",43629846,43736607,106761
"3754","ENSG00000117399","CDC20","1",43824626,43828874,4248
"3755","ENSG00000117408","IPO13","1",44412611,44433694,21083
"3756","ENSG00000117410","ATP6V0B","1",44440159,44443967,3808
"3757","ENSG00000117411","B4GALT2","1",44444615,44456840,12225
"3758","ENSG00000117419","ERI3","1",44686742,44820932,134190
"3759","ENSG00000117425","PTCH2","1",45285516,45308735,23219
"3760","ENSG00000117448","AKR1A1","1",46016215,46035721,19506
"3761","ENSG00000117450","PRDX1","1",45976708,45988719,12011
"3762","ENSG00000117461","PIK3R3","1",46505812,46642160,136348
"3763","ENSG00000117475","BLZF1","1",169337208,169365778,28570
"3764","ENSG00000117477","CCDC181","1",169364108,169429907,65799
"3765","ENSG00000117479","SLC19A2","1",169433147,169455241,22094
"3766","ENSG00000117480","FAAH","1",46859937,46879520,19583
"3767","ENSG00000117481","NSUN4","1",46805849,46830824,24975
"3768","ENSG00000117500","TMED5","1",93615299,93646285,30986
"3769","ENSG00000117505","DR1","1",93811445,93835055,23610
"3770","ENSG00000117519","CNN3","1",95362507,95392834,30327
"3771","ENSG00000117523","PRRC2C","1",171454651,171562650,107999
"3772","ENSG00000117525","F3","1",94994781,95007356,12575
"3773","ENSG00000117528","ABCD3","1",94883933,94984222,100289
"3774","ENSG00000117533","VAMP4","1",171669300,171711387,42087
"3775","ENSG00000117543","DPH5","1",101455179,101491644,36465
"3776","ENSG00000117569","PTBP2","1",97187221,97289294,102073
"3777","ENSG00000117592","PRDX6","1",173446405,173457946,11541
"3778","ENSG00000117593","DARS2","1",173793641,173827684,34043
"3779","ENSG00000117597","DIEXF","1",210001352,210030910,29558
"3780","ENSG00000117598","","1",99355806,99470588,114782
"3781","ENSG00000117600","","1",99729509,99775146,45637
"3782","ENSG00000117602","RCAN3","1",24829387,24867530,38143
"3783","ENSG00000117614","SYF2","1",25549170,25558993,9823
"3784","ENSG00000117616","C1orf63","1",25568728,25664704,95976
"3785","ENSG00000117620","SLC35A3","1",100435345,100492535,57190
"3786","ENSG00000117625","RCOR3","1",211431719,211489727,58008
"3787","ENSG00000117632","STMN1","1",26210672,26233482,22810
"3788","ENSG00000117640","MTFR1L","1",26145131,26159432,14301
"3789","ENSG00000117643","MAN1C1","1",25943959,26112698,168739
"3790","ENSG00000117650","NEK2","1",211836114,211848960,12846
"3791","ENSG00000117676","RPS6KA1","1",26856252,26901521,45269
"3792","ENSG00000117682","DHDDS","1",26758773,26797785,39012
"3793","ENSG00000117691","NENF","1",212606229,212619714,13485
"3794","ENSG00000117697","NSL1","1",212899495,212965124,65629
"3795","ENSG00000117707","PROX1","1",214156524,214214595,58071
"3796","ENSG00000117713","ARID1A","1",27022524,27108595,86071
"3797","ENSG00000117724","CENPF","1",214776538,214837931,61393
"3798","ENSG00000117748","RPA2","1",28218035,28241257,23222
"3799","ENSG00000117751","PPP1R8","1",28157289,28178187,20898
"3800","ENSG00000117758","STX12","1",28099694,28150963,51269
"3801","ENSG00000117791","MARC2","1",220921567,220958150,36583
"3802","ENSG00000117859","OSBPL9","1",52042851,52254889,212038
"3803","ENSG00000117862","TXNDC12","1",52485803,52521843,36040
"3804","ENSG00000117868","ESYT2","7",158523686,158622944,99258
"3805","ENSG00000117877","CD3EAP","19",45909467,45914024,4557
"3806","ENSG00000117899","MESDC2","15",81239667,81282219,42552
"3807","ENSG00000117906","RCN2","15",77223960,77242601,18641
"3808","ENSG00000117971","CHRNB4","15",78916461,79020096,103635
"3809","ENSG00000117984","CTSD","11",1773982,1785222,11240
"3810","ENSG00000118007","STAG1","3",136055077,136471220,416143
"3811","ENSG00000118046","STK11","19",1189406,1228428,39022
"3812","ENSG00000118058","KMT2A","11",118307205,118397539,90334
"3813","ENSG00000118096","IFT46","11",118415243,118443685,28442
"3814","ENSG00000118162","KPTN","19",47978401,47987525,9124
"3815","ENSG00000118181","RPS25","11",118886422,118889401,2979
"3816","ENSG00000118193","KIF14","1",200520628,200589862,69234
"3817","ENSG00000118197","DDX59","1",200593024,200639097,46073
"3818","ENSG00000118200","CAMSAP2","1",200708686,200829832,121146
"3819","ENSG00000118217","ATF6","1",161736084,161933860,197776
"3820","ENSG00000118242","MREG","2",216809213,216898819,89606
"3821","ENSG00000118246","FASTKD2","2",207630081,207657233,27152
"3822","ENSG00000118257","NRP2","2",206546714,206662857,116143
"3823","ENSG00000118260","CREB1","2",208394461,208468155,73694
"3824","ENSG00000118263","KLF7","2",207938861,208031991,93130
"3825","ENSG00000118276","B4GALT6","18",29202210,29265799,63589
"3826","ENSG00000118292","C1orf54","1",150240600,150253327,12727
"3827","ENSG00000118298","CA14","1",150229554,150237478,7924
"3828","ENSG00000118307","CASC1","12",25261354,25348096,86742
"3829","ENSG00000118363","SPCS2","11",74660292,74690076,29784
"3830","ENSG00000118369","USP35","11",77899858,77925757,25899
"3831","ENSG00000118402","ELOVL4","6",80624529,80657297,32768
"3832","ENSG00000118407","FILIP1","6",76001575,76203454,201879
"3833","ENSG00000118412","CASP8AP2","6",90539613,90584155,44542
"3834","ENSG00000118418","HMGN3","6",79910962,79944406,33444
"3835","ENSG00000118420","UBE3D","6",83602117,83775560,173443
"3836","ENSG00000118432","CNR1","6",88849583,88876078,26495
"3837","ENSG00000118454","ANKRD13C","1",70726271,70820417,94146
"3838","ENSG00000118473","SGIP1","1",66999066,67213982,214916
"3839","ENSG00000118482","PHF3","6",64345725,64489229,143504
"3840","ENSG00000118495","PLAGL1","6",144261437,144385735,124298
"3841","ENSG00000118496","FBXO30","6",146114638,146135889,21251
"3842","ENSG00000118503","TNFAIP3","6",138188351,138204449,16098
"3843","ENSG00000118507","AKAP7","6",131456806,131604675,147869
"3844","ENSG00000118508","RAB32","6",146864829,146876101,11272
"3845","ENSG00000118513","MYB","6",135502453,135540311,37858
"3846","ENSG00000118515","SGK1","6",134490384,134639250,148866
"3847","ENSG00000118518","RNF146","6",127587755,127609712,21957
"3848","ENSG00000118523","CTGF","6",132269316,132272513,3197
"3849","ENSG00000118557","PMFBP1","16",72146056,72210777,64721
"3850","ENSG00000118564","FBXL5","4",15606162,15683302,77140
"3851","ENSG00000118579","MED28","4",17616254,17635728,19474
"3852","ENSG00000118596","SLC16A7","12",59989848,60176395,186547
"3853","ENSG00000118600","TMEM5","12",64173583,64203338,29755
"3854","ENSG00000118620","ZNF430","19",21203426,21242856,39430
"3855","ENSG00000118655","DCLRE1B","1",114447763,114456708,8945
"3856","ENSG00000118680","MYL12B","18",3261907,3278282,16375
"3857","ENSG00000118689","FOXO3","6",108881038,109005977,124939
"3858","ENSG00000118690","ARMC2","6",109169619,109295186,125567
"3859","ENSG00000118705","RPN2","20",35806813,35870022,63209
"3860","ENSG00000118707","TGIF2","20",35201891,35222353,20462
"3861","ENSG00000118733","OLFM3","1",102268130,102462586,194456
"3862","ENSG00000118762","PKD2","4",88928820,88998929,70109
"3863","ENSG00000118777","ABCG2","4",89011416,89152474,141058
"3864","ENSG00000118785","SPP1","4",88896819,88904562,7743
"3865","ENSG00000118816","CCNI","4",77968311,77997158,28847
"3866","ENSG00000118855","MFSD1","3",158449987,158547508,97521
"3867","ENSG00000118873","RAB3GAP2","1",220321635,220445796,124161
"3868","ENSG00000118894","FAM86A","16",5134305,5147809,13504
"3869","ENSG00000118900","UBN1","16",4896666,4932361,35695
"3870","ENSG00000118922","KLF12","13",74260226,74708394,448168
"3871","ENSG00000118939","UCHL3","13",76123619,76180085,56466
"3872","ENSG00000118946","PCDH17","13",58205944,58303445,97501
"3873","ENSG00000118960","HS1BP3","2",20760208,20850849,90641
"3874","ENSG00000118961","C2orf43","2",20883788,21022882,139094
"3875","ENSG00000118965","WDR35","2",20110021,20189892,79871
"3876","ENSG00000118971","CCND2","12",4382938,4414516,31578
"3877","ENSG00000118985","ELL2","5",95220802,95297775,76973
"3878","ENSG00000118997","DNAH7","2",196602427,196933536,331109
"3879","ENSG00000119004","CYP20A1","2",204103663,204163009,59346
"3880","ENSG00000119013","NDUFB3","2",201936156,201950473,14317
"3881","ENSG00000119041","GTF3C3","2",197627756,197664449,36693
"3882","ENSG00000119042","SATB2","2",200134223,200335989,201766
"3883","ENSG00000119048","UBE2B","5",133706870,133727683,20813
"3884","ENSG00000119125","GDA","9",74729511,74872109,142598
"3885","ENSG00000119139","TJP2","9",71736209,71870124,133915
"3886","ENSG00000119185","ITGB1BP1","2",9543604,9563676,20072
"3887","ENSG00000119203","CPSF3","2",9563697,9613230,49533
"3888","ENSG00000119231","SENP5","3",196594727,196661585,66858
"3889","ENSG00000119242","CCDC92","12",124403207,124457378,54171
"3890","ENSG00000119280","C1orf198","1",230972865,231005335,32470
"3891","ENSG00000119283","TRIM67","1",231297858,231357302,59444
"3892","ENSG00000119285","HEATR1","1",236712305,236767804,55499
"3893","ENSG00000119314","PTBP3","9",114980715,115095947,115232
"3894","ENSG00000119318","RAD23B","9",110045418,110094475,49057
"3895","ENSG00000119321","FKBP15","9",115923286,115983641,60355
"3896","ENSG00000119326","CTNNAL1","9",111704851,111775809,70958
"3897","ENSG00000119328","FAM206A","9",111696461,111713024,16563
"3898","ENSG00000119333","WDR34","9",131395940,131419066,23126
"3899","ENSG00000119335","SET","9",131445703,131458679,12976
"3900","ENSG00000119383","PPP2R4","9",131873229,131911225,37996
"3901","ENSG00000119392","GLE1","9",131266979,131304567,37588
"3902","ENSG00000119396","RAB14","9",123940415,123985292,44877
"3903","ENSG00000119397","CNTRL","9",123837141,123939888,102747
"3904","ENSG00000119401","TRIM32","9",119449581,119463579,13998
"3905","ENSG00000119402","FBXW2","9",123514256,123555690,41434
"3906","ENSG00000119403","PHF19","9",123617977,123639606,21629
"3907","ENSG00000119408","NEK6","9",127019885,127115586,95701
"3908","ENSG00000119414","PPP6C","9",127908852,127952218,43366
"3909","ENSG00000119421","NDUFA8","9",124894745,124922098,27353
"3910","ENSG00000119431","HDHD3","9",116135699,116139279,3580
"3911","ENSG00000119446","RBM18","9",124999903,125027118,27215
"3912","ENSG00000119471","HSDL2","9",115142217,115234690,92473
"3913","ENSG00000119487","MAPKAP1","9",128199672,128469513,269841
"3914","ENSG00000119508","NR4A3","9",102584137,102629173,45036
"3915","ENSG00000119509","INVS","9",102861538,103063282,201744
"3916","ENSG00000119514","GALNT12","9",101569981,101612363,42382
"3917","ENSG00000119522","DENND1A","9",126141933,126692431,550498
"3918","ENSG00000119523","ALG2","9",101978708,101984238,5530
"3919","ENSG00000119537","KDSR","18",60994959,61034743,39784
"3920","ENSG00000119541","VPS4B","18",61056423,61089716,33293
"3921","ENSG00000119547","ONECUT2","18",55102917,55158529,55612
"3922","ENSG00000119559","C19orf25","19",1461142,1479555,18413
"3923","ENSG00000119574","ZBTB45","19",59024897,59050278,25381
"3924","ENSG00000119596","YLPM1","14",75230069,75322244,92175
"3925","ENSG00000119599","DCAF4","14",73393040,73426411,33371
"3926","ENSG00000119616","FCF1","14",75179847,75203394,23547
"3927","ENSG00000119632","IFI27L2","14",94594116,94596590,2474
"3928","ENSG00000119636","CCDC176","14",74486056,74549566,63510
"3929","ENSG00000119638","NEK9","14",75548822,75594047,45225
"3930","ENSG00000119640","ACYP1","14",75519924,75536186,16262
"3931","ENSG00000119650","IFT43","14",76368479,76550928,182449
"3932","ENSG00000119655","NPC2","14",74942895,74960880,17985
"3933","ENSG00000119661","DNAL1","14",74111578,74170435,58857
"3934","ENSG00000119669","IRF2BPL","14",77490888,77495034,4146
"3935","ENSG00000119673","ACOT2","14",74034324,74042357,8033
"3936","ENSG00000119681","LTBP2","14",74964873,75079306,114433
"3937","ENSG00000119682","AREL1","14",75120140,75179818,59678
"3938","ENSG00000119684","MLH3","14",75480467,75518235,37768
"3939","ENSG00000119685","TTLL5","14",76099968,76421421,321453
"3940","ENSG00000119686","FLVCR2","14",76044960,76129557,84597
"3941","ENSG00000119688","ABCD4","14",74752126,74769759,17633
"3942","ENSG00000119689","DLST","14",75348594,75370448,21854
"3943","ENSG00000119698","PPP4R4","14",94612465,94746072,133607
"3944","ENSG00000119699","TGFB3","14",76424442,76449334,24892
"3945","ENSG00000119703","ZC2HC1C","14",75530873,75545126,14253
"3946","ENSG00000119705","SLIRP","14",78174414,78227447,53033
"3947","ENSG00000119707","RBM25","14",73525144,73588122,62978
"3948","ENSG00000119711","ALDH6A1","14",74523553,74551196,27643
"3949","ENSG00000119718","EIF2B2","14",75469614,75476292,6678
"3950","ENSG00000119720","NRDE2","14",90742580,90798481,55901
"3951","ENSG00000119723","COQ6","14",74416629,74430373,13744
"3952","ENSG00000119725","ZNF410","14",74353320,74399214,45894
"3953","ENSG00000119729","RHOQ","2",46768945,46810260,41315
"3954","ENSG00000119737","GPR75","2",54080050,54087126,7076
"3955","ENSG00000119760","SUPT7L","2",27873679,27886676,12997
"3956","ENSG00000119771","KLHL29","2",23608088,23931481,323393
"3957","ENSG00000119772","DNMT3A","2",25455845,25565459,109614
"3958","ENSG00000119777","TMEM214","2",27255778,27264563,8785
"3959","ENSG00000119778","ATAD2B","2",23971534,24149984,178450
"3960","ENSG00000119782","FKBP1B","2",24272571,24286551,13980
"3961","ENSG00000119787","ATL2","2",38522022,38604427,82405
"3962","ENSG00000119801","YPEL5","2",30369807,30383399,13592
"3963","ENSG00000119812","FAM98A","2",33808725,33824449,15724
"3964","ENSG00000119820","YIPF4","2",32502979,32541663,38684
"3965","ENSG00000119844","AFTPH","2",64751465,64820139,68674
"3966","ENSG00000119862","LGALSL","2",64681103,64688515,7412
"3967","ENSG00000119865","CNRIP1","2",68511303,68547183,35880
"3968","ENSG00000119866","BCL11A","2",60678302,60780702,102400
"3969","ENSG00000119878","CRIPT","2",46843555,46852881,9326
"3970","ENSG00000119899","SLC17A5","6",74303102,74363878,60776
"3971","ENSG00000119900","OGFRL1","6",71998506,72018653,20147
"3972","ENSG00000119906","FAM178A","10",102672326,102724893,52567
"3973","ENSG00000119912","IDE","10",94211441,94333833,122392
"3974","ENSG00000119917","IFIT3","10",91087651,91100728,13077
"3975","ENSG00000119922","IFIT2","10",91061712,91069033,7321
"3976","ENSG00000119927","GPAM","10",113909624,113975135,65511
"3977","ENSG00000119929","CUTC","10",101462315,101515891,53576
"3978","ENSG00000119938","PPP1R3C","10",93388199,93392811,4612
"3979","ENSG00000119943","PYROXD2","10",100143322,100174941,31619
"3980","ENSG00000119946","CNNM1","10",101088856,101154087,65231
"3981","ENSG00000119950","MXI1","10",111967363,112047123,79760
"3982","ENSG00000119953","SMNDC1","10",112050488,112064709,14221
"3983","ENSG00000119965","C10orf88","10",124690419,124713919,23500
"3984","ENSG00000119969","HELLS","10",96305547,96373662,68115
"3985","ENSG00000119977","TCTN3","10",97423158,97453900,30742
"3986","ENSG00000119979","FAM45A","10",120863598,120897496,33898
"3987","ENSG00000120008","WDR11","10",122610687,122669036,58349
"3988","ENSG00000120029","C10orf76","10",103605356,103815950,210594
"3989","ENSG00000120049","KCNIP2","10",103585731,103603677,17946
"3990","ENSG00000120051","CCDC147","10",106113522,106214848,101326
"3991","ENSG00000120053","GOT1","10",101156627,101190381,33754
"3992","ENSG00000120063","GNA13","17",63006833,63052957,46124
"3993","ENSG00000120071","KANSL1","17",44107282,44302733,195451
"3994","ENSG00000120129","DUSP1","5",172195093,172198198,3105
"3995","ENSG00000120137","PANK3","5",167975500,168006605,31105
"3996","ENSG00000120149","MSX2","5",174151536,174157896,6360
"3997","ENSG00000120158","RCL1","9",4792869,4885917,93048
"3998","ENSG00000120159","CAAP1","9",26840683,26892802,52119
"3999","ENSG00000120162","MOB3B","9",27325207,27529779,204572
"4000","ENSG00000120251","GRIA2","4",158125334,158287227,161893
"4001","ENSG00000120253","NUP43","6",150045451,150070801,25350
"4002","ENSG00000120254","MTHFD1L","6",151186685,151423023,236338
"4003","ENSG00000120256","LRP11","6",150139934,150186199,46265
"4004","ENSG00000120265","PCMT1","6",150070579,150132556,61977
"4005","ENSG00000120278","PLEKHG1","6",150920999,151164799,243800
"4006","ENSG00000120306","CYSTM1","5",139554227,139661637,107410
"4007","ENSG00000120314","WDR55","5",140044261,140053709,9448
"4008","ENSG00000120318","ARAP3","5",141032968,141061788,28820
"4009","ENSG00000120324","PCDHB10","5",140571942,140575215,3273
"4010","ENSG00000120327","PCDHB14","5",140602931,140605858,2927
"4011","ENSG00000120328","PCDHB12","5",140588269,140591696,3427
"4012","ENSG00000120329","SLC25A2","5",140682196,140683612,1416
"4013","ENSG00000120332","TNN","1",175036994,175117202,80208
"4014","ENSG00000120333","MRPS14","1",174979925,174992561,12636
"4015","ENSG00000120334","CENPL","1",173768688,173793858,25170
"4016","ENSG00000120370","GORAB","1",170501270,170522587,21317
"4017","ENSG00000120437","ACAT2","6",160181360,160200144,18784
"4018","ENSG00000120438","TCP1","6",160199530,160210781,11251
"4019","ENSG00000120451","SNX19","11",130745331,130786404,41073
"4020","ENSG00000120458","MSANTD2","11",124636394,124670569,34175
"4021","ENSG00000120509","PDZD11","X",69506445,69510364,3919
"4022","ENSG00000120519","SLC10A7","4",147175127,147443123,267996
"4023","ENSG00000120526","NUDCD1","8",110253148,110346614,93466
"4024","ENSG00000120533","ENY2","8",110346553,110358182,11629
"4025","ENSG00000120539","MASTL","10",27443753,27475853,32100
"4026","ENSG00000120549","KIAA1217","10",23983675,24836772,853097
"4027","ENSG00000120594","PLXDC2","10",20105168,20578785,473617
"4028","ENSG00000120616","EPC1","10",32556679,32667726,111047
"4029","ENSG00000120647","CCDC77","12",498439,551811,53372
"4030","ENSG00000120656","TAF12","1",28915835,28969597,53762
"4031","ENSG00000120658","ENOX1","13",43787654,44361044,573390
"4032","ENSG00000120662","MTRF1","13",41790505,41837742,47237
"4033","ENSG00000120664","SPG20OS","13",36920568,36943738,23170
"4034","ENSG00000120675","DNAJC15","13",43597339,43683045,85706
"4035","ENSG00000120685","PROSER1","13",39584003,39612252,28249
"4036","ENSG00000120686","UFM1","13",38923986,38937140,13154
"4037","ENSG00000120688","WBP4","13",41635410,41658137,22727
"4038","ENSG00000120690","ELF1","13",41506056,41635576,129520
"4039","ENSG00000120693","SMAD9","13",37418968,37494902,75934
"4040","ENSG00000120694","HSPH1","13",31710762,31736525,25763
"4041","ENSG00000120696","KBTBD7","13",41763969,41768702,4733
"4042","ENSG00000120697","ALG5","13",37523912,37574398,50486
"4043","ENSG00000120699","EXOSC8","13",37572953,37583750,10797
"4044","ENSG00000120705","ETF1","5",137841784,137878989,37205
"4045","ENSG00000120708","TGFBI","5",135364584,135399507,34923
"4046","ENSG00000120709","FAM53C","5",137667624,137685416,17792
"4047","ENSG00000120725","SIL1","5",138282409,138629246,346837
"4048","ENSG00000120727","PAIP2","5",138677276,138705406,28130
"4049","ENSG00000120733","KDM3B","5",137688285,137772717,84432
"4050","ENSG00000120738","EGR1","5",137801179,137805004,3825
"4051","ENSG00000120742","SERP1","3",150259781,150321015,61234
"4052","ENSG00000120756","PLS1","3",142315229,142432506,117277
"4053","ENSG00000120784","ZFP30","19",38104650,38183238,78588
"4054","ENSG00000120798","NR2C1","12",95414005,95467479,53474
"4055","ENSG00000120800","UTP20","12",101673887,101780394,106507
"4056","ENSG00000120802","TMPO","12",98909290,98944157,34867
"4057","ENSG00000120805","ARL1","12",101786898,101801598,14700
"4058","ENSG00000120832","MTERFD3","12",107371069,107380944,9875
"4059","ENSG00000120833","SOCS2","12",93963590,93977263,13673
"4060","ENSG00000120837","NFYB","12",104510855,104532067,21212
"4061","ENSG00000120860","CCDC53","12",102406705,102455927,49222
"4062","ENSG00000120868","APAF1","12",99038919,99129204,90285
"4063","ENSG00000120875","DUSP4","8",29190581,29208185,17604
"4064","ENSG00000120885","CLU","8",27454434,27472548,18114
"4065","ENSG00000120889","TNFRSF10B","8",22877646,22926692,49046
"4066","ENSG00000120896","SORBS3","8",22402499,22433301,30802
"4067","ENSG00000120899","PTK2B","8",27168999,27316903,147904
"4068","ENSG00000120910","PPP3CC","8",22298332,22398652,100320
"4069","ENSG00000120913","PDLIM2","8",22435792,22455538,19746
"4070","ENSG00000120915","EPHX2","8",27348296,27403081,54785
"4071","ENSG00000120925","RNF170","8",42704780,42752433,47653
"4072","ENSG00000120942","UBIAD1","1",11333263,11356106,22843
"4073","ENSG00000120948","TARDBP","1",11072414,11085796,13382
"4074","ENSG00000120963","ZNF706","8",102190106,102218421,28315
"4075","ENSG00000120992","LYPLA1","8",54958938,55014577,55639
"4076","ENSG00000121005","CRISPLD1","8",75896750,75946793,50043
"4077","ENSG00000121022","COPS5","8",67955314,67996018,40704
"4078","ENSG00000121039","RDH10","8",74206847,74237516,30669
"4079","ENSG00000121057","AKAP1","17",55162453,55198710,36257
"4080","ENSG00000121058","COIL","17",55015548,55038415,22867
"4081","ENSG00000121060","TRIM25","17",54965270,54991399,26129
"4082","ENSG00000121064","SCPEP1","17",55055466,55084129,28663
"4083","ENSG00000121067","SPOP","17",47676246,47755596,79350
"4084","ENSG00000121073","SLC35B1","17",47778305,47786376,8071
"4085","ENSG00000121101","TEX14","17",56634039,56769416,135377
"4086","ENSG00000121104","FAM117A","17",47787694,47866542,78848
"4087","ENSG00000121152","NCAPH","2",97001525,97039583,38058
"4088","ENSG00000121207","LRAT","4",155548097,155674270,126173
"4089","ENSG00000121210","KIAA0922","4",154387498,154557863,170365
"4090","ENSG00000121211","MND1","4",154265801,154336270,70469
"4091","ENSG00000121236","TRIM6","11",5617339,5634188,16849
"4092","ENSG00000121274","PAPD5","16",50186829,50269221,82392
"4093","ENSG00000121281","ADCY7","16",50280048,50352046,71998
"4094","ENSG00000121289","CEP89","19",33369902,33462897,92995
"4095","ENSG00000121297","TSHZ3","19",31765851,31840453,74602
"4096","ENSG00000121316","PLBD1","12",14656595,14721283,64688
"4097","ENSG00000121318","TAS2R10","12",10977916,10978957,1041
"4098","ENSG00000121350","PYROXD1","12",21590549,21623300,32751
"4099","ENSG00000121361","KCNJ8","12",21917889,21928515,10626
"4100","ENSG00000121380","BCL2L14","12",12202778,12364018,161240
"4101","ENSG00000121390","PSPC1","13",20248896,20357142,108246
"4102","ENSG00000121406","ZNF549","19",58038693,58068910,30217
"4103","ENSG00000121410","A1BG","19",58856544,58864865,8321
"4104","ENSG00000121413","ZSCAN18","19",58595205,58629794,34589
"4105","ENSG00000121417","ZNF211","19",58141761,58154147,12386
"4106","ENSG00000121440","PDZRN3","3",73431584,73674091,242507
"4107","ENSG00000121481","RNF2","1",185014496,185071740,57244
"4108","ENSG00000121486","TRMT1L","1",185087220,185126204,38984
"4109","ENSG00000121542","SEC22A","3",122920774,122992977,72203
"4110","ENSG00000121570","DPPA4","3",109044988,109056419,11431
"4111","ENSG00000121577","POPDC2","3",119355304,119384171,28867
"4112","ENSG00000121578","B4GALT4","3",118930579,118959950,29371
"4113","ENSG00000121579","NAA50","3",113435307,113465147,29840
"4114","ENSG00000121621","KIF18A","11",28042167,28129855,87688
"4115","ENSG00000121644","DESI2","1",244816237,244872335,56098
"4116","ENSG00000121653","MAPK8IP1","11",45907202,45928016,20814
"4117","ENSG00000121671","CRY2","11",45868669,45904798,36129
"4118","ENSG00000121680","PEX16","11",45931220,45940363,9143
"4119","ENSG00000121690","DEPDC7","11",33037410,33055128,17718
"4120","ENSG00000121691","CAT","11",34460472,34493609,33137
"4121","ENSG00000121716","PILRB","7",99933737,99965356,31619
"4122","ENSG00000121741","ZMYM2","13",20532810,20665968,133158
"4123","ENSG00000121749","TBC1D15","12",72233487,72320629,87142
"4124","ENSG00000121753","BAI2","1",32192718,32230494,37776
"4125","ENSG00000121766","ZCCHC17","1",31769842,31837783,67941
"4126","ENSG00000121769","FABP3","1",31838472,31849697,11225
"4127","ENSG00000121774","KHDRBS1","1",32479430,32526451,47021
"4128","ENSG00000121775","TMEM39B","1",32537632,32568467,30835
"4129","ENSG00000121848","RNF115","1",145611036,145696218,85182
"4130","ENSG00000121851","POLR3GL","1",145456236,145470388,14152
"4131","ENSG00000121864","ZNF639","3",179040779,179053323,12544
"4132","ENSG00000121871","SLITRK3","3",164904508,164914897,10389
"4133","ENSG00000121879","PIK3CA","3",178865902,178957881,91979
"4134","ENSG00000121892","PDS5A","4",39824483,39979576,155093
"4135","ENSG00000121897","LIAS","4",39460620,39479273,18653
"4136","ENSG00000121903","ZSCAN20","1",33938246,33962107,23861
"4137","ENSG00000121931","LRIF1","1",111489807,111506701,16894
"4138","ENSG00000121940","CLCC1","1",109472130,109506111,33981
"4139","ENSG00000121957","GPSM2","1",109417972,109477167,59195
"4140","ENSG00000121964","GTDC1","2",144695635,145090135,394500
"4141","ENSG00000121966","CXCR4","2",136871919,136875735,3816
"4142","ENSG00000121988","ZRANB3","2",135894486,136288806,394320
"4143","ENSG00000121989","ACVR2A","2",148602086,148688393,86307
"4144","ENSG00000122008","POLK","5",74807581,74896969,89388
"4145","ENSG00000122012","SV2C","5",75378997,75649764,270767
"4146","ENSG00000122026","RPL21","13",27825446,27830828,5382
"4147","ENSG00000122033","MTIF3","13",28009776,28024739,14963
"4148","ENSG00000122034","GTF3A","13",27998681,28009958,11277
"4149","ENSG00000122035","RASL11A","13",27844464,27847827,3363
"4150","ENSG00000122042","UBL3","13",30338508,30424821,86313
"4151","ENSG00000122068","FYTTD1","3",197464050,197514467,50417
"4152","ENSG00000122085","MTERFD2","2",242011584,242041747,30163
"4153","ENSG00000122126","OCRL","X",128673826,128726538,52712
"4154","ENSG00000122140","MRPS2","9",138391830,138396519,4689
"4155","ENSG00000122203","KIAA1191","5",175773064,175788971,15907
"4156","ENSG00000122218","COPA","1",160259063,160313190,54127
"4157","ENSG00000122257","RBBP6","16",24549014,24584184,35170
"4158","ENSG00000122299","ZC3H7A","16",11844442,11891123,46681
"4159","ENSG00000122335","SERAC1","6",158530536,158589312,58776
"4160","ENSG00000122359","ANXA11","10",81910645,81965328,54683
"4161","ENSG00000122376","FAM35A","10",88853918,88951225,97307
"4162","ENSG00000122378","FAM213A","10",82167585,82192753,25168
"4163","ENSG00000122386","ZNF205","16",3162561,3170518,7957
"4164","ENSG00000122390","NAA60","16",3493611,3536963,43352
"4165","ENSG00000122406","RPL5","1",93297582,93307481,9899
"4166","ENSG00000122417","ODF2L","1",86814344,86862023,47679
"4167","ENSG00000122420","PTGFR","1",78769568,79005434,235866
"4168","ENSG00000122435","TRMT13","1",100598706,100616053,17347
"4169","ENSG00000122477","LRRC39","1",100614409,100643771,29362
"4170","ENSG00000122481","RWDD3","1",95699711,95712781,13070
"4171","ENSG00000122482","ZNF644","1",91380859,91487829,106970
"4172","ENSG00000122483","CCDC18","1",93645476,93744287,98811
"4173","ENSG00000122484","RPAP2","1",92764522,92867613,103091
"4174","ENSG00000122490","PQLC1","18",77662420,77711664,49244
"4175","ENSG00000122497","NBPF14","1",148003642,148025863,22221
"4176","ENSG00000122507","BBS9","7",33168856,33645680,476824
"4177","ENSG00000122512","PMS2","7",6012870,6048756,35886
"4178","ENSG00000122515","ZMIZ2","7",44788180,44809477,21297
"4179","ENSG00000122545","SEPT7","7",35840542,35944917,104375
"4180","ENSG00000122547","EEPD1","7",36192758,36341152,148394
"4181","ENSG00000122550","KLHL7","7",23145353,23217533,72180
"4182","ENSG00000122557","HERPUD2","7",35672269,35735181,62912
"4183","ENSG00000122565","CBX3","7",26240782,26252976,12194
"4184","ENSG00000122566","HNRNPA2B1","7",26229547,26241149,11602
"4185","ENSG00000122585","NPY","7",24323782,24331484,7702
"4186","ENSG00000122591","FAM126A","7",22980878,23053749,72871
"4187","ENSG00000122641","INHBA","7",41724712,41742706,17994
"4188","ENSG00000122642","FKBP9","7",32997017,33046543,49526
"4189","ENSG00000122643","NT5C3A","7",33053742,33102409,48667
"4190","ENSG00000122644","ARL4A","7",12726481,12730559,4078
"4191","ENSG00000122674","CCZ1","7",5938356,5965605,27249
"4192","ENSG00000122678","POLM","7",44111846,44122139,10293
"4193","ENSG00000122687","FTSJ2","7",2273866,2281840,7974
"4194","ENSG00000122691","TWIST1","7",19060614,19157295,96681
"4195","ENSG00000122692","SMU1","9",33041762,33076665,34903
"4196","ENSG00000122694","GLIPR2","9",36136732,36163910,27178
"4197","ENSG00000122696","SLC25A51","9",37879400,37904350,24950
"4198","ENSG00000122705","CLTA","9",36190853,36304778,113925
"4199","ENSG00000122707","RECK","9",36036430,36124448,88018
"4200","ENSG00000122729","ACO1","9",32384618,32454767,70149
"4201","ENSG00000122735","DNAI1","9",34457412,34520982,63570
"4202","ENSG00000122741","DCAF10","9",37800499,37867663,67164
"4203","ENSG00000122756","CNTFR","9",34551430,34590121,38691
"4204","ENSG00000122778","KIAA1549","7",138516126,138666064,149938
"4205","ENSG00000122779","TRIM24","7",138145079,138274738,129659
"4206","ENSG00000122783","C7orf49","7",134777115,134855547,78432
"4207","ENSG00000122786","CALD1","7",134429003,134655479,226476
"4208","ENSG00000122824","NUDT10","X",51075083,51080377,5294
"4209","ENSG00000122861","PLAU","10",75668935,75677255,8320
"4210","ENSG00000122863","CHST3","10",73724123,73773322,49199
"4211","ENSG00000122870","BICC1","10",60272900,60591195,318295
"4212","ENSG00000122873","CISD1","10",60028818,60049346,20528
"4213","ENSG00000122877","EGR2","10",64571756,64679660,107904
"4214","ENSG00000122882","ECD","10",74889913,74928813,38900
"4215","ENSG00000122884","P4HA1","10",74766975,74856732,89757
"4216","ENSG00000122912","SLC25A16","10",70237756,70287231,49475
"4217","ENSG00000122952","ZWINT","10",58116989,58121036,4047
"4218","ENSG00000122958","VPS26A","10",70883268,70932617,49349
"4219","ENSG00000122965","RBM19","12",114254543,114404176,149633
"4220","ENSG00000122966","CIT","12",120123595,120315095,191500
"4221","ENSG00000122970","IFT81","12",110562140,110656602,94462
"4222","ENSG00000122971","ACADS","12",121163538,121177811,14273
"4223","ENSG00000122986","HVCN1","12",111065646,111142755,77109
"4224","ENSG00000123064","DDX54","12",113594979,113623284,28305
"4225","ENSG00000123066","MED13L","12",116395711,116715143,319432
"4226","ENSG00000123080","CDKN2C","1",51426417,51440305,13888
"4227","ENSG00000123091","RNF11","1",51701943,51739127,37184
"4228","ENSG00000123094","RASSF8","12",26111962,26232825,120863
"4229","ENSG00000123096","SSPN","12",26274924,26452223,177299
"4230","ENSG00000123104","ITPR2","12",26490342,26986131,495789
"4231","ENSG00000123106","CCDC91","12",28286182,28732883,446701
"4232","ENSG00000123119","NECAB1","8",91803778,91971636,167858
"4233","ENSG00000123124","WWP1","8",87354967,87490649,135682
"4234","ENSG00000123130","ACOT9","X",23720370,23784592,64222
"4235","ENSG00000123131","PRDX4","X",23682379,23704516,22137
"4236","ENSG00000123136","DDX39A","19",14519631,14530192,10561
"4237","ENSG00000123143","PKN1","19",14543865,14582679,38814
"4238","ENSG00000123144","C19orf43","19",12841454,12845589,4135
"4239","ENSG00000123146","CD97","19",14491313,14519537,28224
"4240","ENSG00000123154","WDR83","19",12777614,12786646,9032
"4241","ENSG00000123159","GIPC1","19",14588572,14606944,18372
"4242","ENSG00000123178","SPRYD7","13",50486842,50510626,23784
"4243","ENSG00000123179","EBPL","13",50234859,50265611,30752
"4244","ENSG00000123191","ATP7B","13",52506809,52585630,78821
"4245","ENSG00000123200","ZC3H13","13",46528600,46626894,98294
"4246","ENSG00000123213","NLN","5",65018023,65167553,149530
"4247","ENSG00000123219","CENPK","5",64813593,64858998,45405
"4248","ENSG00000123240","OPTN","10",13141449,13180291,38842
"4249","ENSG00000123268","ATF1","12",51157493,51214905,57412
"4250","ENSG00000123297","TSFM","12",58176372,58201854,25482
"4251","ENSG00000123307","NEUROD4","12",55413729,55423798,10069
"4252","ENSG00000123329","ARHGAP9","12",57866038,57882597,16559
"4253","ENSG00000123349","PFDN5","12",53689075,53693234,4159
"4254","ENSG00000123352","SPATS2","12",49760367,49921205,160838
"4255","ENSG00000123353","ORMDL2","12",56211703,56215663,3960
"4256","ENSG00000123358","NR4A1","12",52416616,52453291,36675
"4257","ENSG00000123360","PDE1B","12",54943134,54973023,29889
"4258","ENSG00000123374","CDK2","12",56360553,56366568,6015
"4259","ENSG00000123384","LRP1","12",57522276,57607134,84858
"4260","ENSG00000123395","C12orf44","12",52463030,52471278,8248
"4261","ENSG00000123411","IKZF4","12",56401443,56432219,30776
"4262","ENSG00000123415","SMUG1","12",54558529,54582778,24249
"4263","ENSG00000123416","TUBA1B","12",49521565,49525180,3615
"4264","ENSG00000123427","METTL21B","12",58165275,58176324,11049
"4265","ENSG00000123444","KBTBD4","11",47593749,47600567,6818
"4266","ENSG00000123453","SARDH","9",136528682,136605077,76395
"4267","ENSG00000123472","ATPAF1","1",47098409,47139539,41130
"4268","ENSG00000123473","STIL","1",47715811,47779819,64008
"4269","ENSG00000123485","HJURP","2",234742062,234763212,21150
"4270","ENSG00000123496","IL13RA2","X",114238538,114254540,16002
"4271","ENSG00000123505","AMD1","6",111195973,111216916,20943
"4272","ENSG00000123545","NDUFAF4","6",97337189,97345757,8568
"4273","ENSG00000123552","USP45","6",99880190,99969604,89414
"4274","ENSG00000123560","PLP1","X",103028647,103047548,18901
"4275","ENSG00000123562","MORF4L2","X",102930424,102943086,12662
"4276","ENSG00000123570","RAB9B","X",103077252,103087158,9906
"4277","ENSG00000123572","NRK","X",105066536,105202602,136066
"4278","ENSG00000123575","FAM199X","X",103411301,103440583,29282
"4279","ENSG00000123595","RAB9A","X",13707244,13728625,21381
"4280","ENSG00000123600","METTL8","2",172173919,172291312,117393
"4281","ENSG00000123607","TTC21B","2",166713985,166810353,96368
"4282","ENSG00000123609","NMI","2",152126979,152146571,19592
"4283","ENSG00000123636","BAZ2B","2",160175490,160473203,297713
"4284","ENSG00000123643","SLC36A1","5",150816607,150871942,55335
"4285","ENSG00000123684","LPGAT1","1",211916799,212004114,87315
"4286","ENSG00000123700","KCNJ2","17",68164814,68176189,11375
"4287","ENSG00000123728","RAP2C","X",131337053,131353471,16418
"4288","ENSG00000123737","EXOSC9","4",122722472,122738176,15704
"4289","ENSG00000123739","PLA2G12A","4",110631145,110651233,20088
"4290","ENSG00000123810","B9D2","19",41860326,41870078,9752
"4291","ENSG00000123815","ADCK4","19",41197434,41224112,26678
"4292","ENSG00000123836","PFKFB2","1",207222801,207254369,31568
"4293","ENSG00000123870","ZNF137P","19",53091758,53100660,8902
"4294","ENSG00000123892","RAB38","11",87846410,87908635,62225
"4295","ENSG00000123908","AGO2","8",141541264,141645718,104454
"4296","ENSG00000123933","MXD4","4",2249159,2264021,14862
"4297","ENSG00000123965","PMS2P5","7",74306894,74366314,59420
"4298","ENSG00000123975","CKS2","9",91926113,91931618,5505
"4299","ENSG00000123983","ACSL3","2",223725652,223809357,83705
"4300","ENSG00000123989","CHPF","2",220403669,220408509,4840
"4301","ENSG00000123992","DNPEP","2",220238268,220264744,26476
"4302","ENSG00000124006","OBSL1","2",220415451,220436581,21130
"4303","ENSG00000124067","SLC12A4","16",67977377,68003504,26127
"4304","ENSG00000124074","ENKD1","16",67696848,67701168,4320
"4305","ENSG00000124098","FAM210B","20",54933971,54943719,9748
"4306","ENSG00000124104","SNX21","20",44462449,44471914,9465
"4307","ENSG00000124120","TTPAL","20",43104526,43123244,18718
"4308","ENSG00000124126","PREX1","20",47240790,47444420,203630
"4309","ENSG00000124140","SLC12A5","20",44650356,44688784,38428
"4310","ENSG00000124145","SDC4","20",43953928,43977064,23136
"4311","ENSG00000124151","NCOA3","20",46130601,46285621,155020
"4312","ENSG00000124155","PIGT","20",44044717,44054884,10167
"4313","ENSG00000124160","NCOA5","20",44689624,44718591,28967
"4314","ENSG00000124164","VAPB","20",56964178,57026157,61979
"4315","ENSG00000124171","PARD6B","20",49348081,49373332,25251
"4316","ENSG00000124172","ATP5E","20",57600522,57607437,6915
"4317","ENSG00000124177","CHD6","20",40030741,40247133,216392
"4318","ENSG00000124181","PLCG1","20",39765600,39811629,46029
"4319","ENSG00000124191","TOX2","20",42543504,42698256,154752
"4320","ENSG00000124193","SRSF6","20",42086568,42092245,5677
"4321","ENSG00000124194","GDAP1L1","20",42875887,42909013,33126
"4322","ENSG00000124198","ARFGEF2","20",47538427,47653230,114803
"4323","ENSG00000124201","ZNFX1","20",47854483,47894963,40480
"4324","ENSG00000124207","CSE1L","20",47662849,47713489,50640
"4325","ENSG00000124209","RAB22A","20",56884752,56942563,57811
"4326","ENSG00000124212","PTGIS","20",48120411,48184683,64272
"4327","ENSG00000124214","STAU1","20",47729878,47804904,75026
"4328","ENSG00000124215","CDH26","20",58533471,58609066,75595
"4329","ENSG00000124216","SNAI1","20",48599536,48605423,5887
"4330","ENSG00000124217","MOCS3","20",49575363,49577820,2457
"4331","ENSG00000124222","STX16","20",57226328,57254582,28254
"4332","ENSG00000124224","PPP4R1L","20",56806188,56884495,78307
"4333","ENSG00000124225","PMEPA1","20",56223448,56286592,63144
"4334","ENSG00000124226","RNF114","20",48552948,48570429,17481
"4335","ENSG00000124228","DDX27","20",47835884,47860614,24730
"4336","ENSG00000124243","BCAS4","20",49411431,49493714,82283
"4337","ENSG00000124257","NEURL2","20",44517264,44519926,2662
"4338","ENSG00000124275","MTRR","5",7851299,7906138,54839
"4339","ENSG00000124279","FASTKD3","5",7859272,7869150,9878
"4340","ENSG00000124299","PEPD","19",33877856,34012700,134844
"4341","ENSG00000124333","VAMP7","X",155110956,155173433,62477
"4342","ENSG00000124356","STAMBP","2",74056086,74100786,44700
"4343","ENSG00000124357","NAGK","2",71291474,71306935,15461
"4344","ENSG00000124370","MCEE","2",71336814,71357369,20555
"4345","ENSG00000124374","PAIP2B","2",71409869,71454213,44344
"4346","ENSG00000124380","SNRNP27","2",70120692,70132707,12015
"4347","ENSG00000124383","MPHOSPH10","2",71357444,71377231,19787
"4348","ENSG00000124406","ATP8A1","4",42410390,42659122,248732
"4349","ENSG00000124422","USP22","17",20902910,20947073,44163
"4350","ENSG00000124440","HIF3A","19",46800303,46846690,46387
"4351","ENSG00000124444","ZNF576","19",44100544,44105309,4765
"4352","ENSG00000124459","ZNF45","19",44416781,44439430,22649
"4353","ENSG00000124486","USP9X","X",40944888,41095832,150944
"4354","ENSG00000124491","F13A1","6",6144318,6321246,176928
"4355","ENSG00000124496","TRERF1","6",42192669,42419789,227120
"4356","ENSG00000124508","BTN2A2","6",26383324,26395102,11778
"4357","ENSG00000124523","SIRT5","6",13574816,13614790,39974
"4358","ENSG00000124529","HIST1H4B","6",26027124,26027480,356
"4359","ENSG00000124532","MRS2","6",24403153,24425810,22657
"4360","ENSG00000124535","WRNIP1","6",2765648,2787186,21538
"4361","ENSG00000124541","RRP36","6",42989383,43001894,12511
"4362","ENSG00000124549","BTN2A3P","6",26421619,26432611,10992
"4363","ENSG00000124562","SNRPC","6",34725183,34741571,16388
"4364","ENSG00000124570","SERPINB6","6",2948393,2972090,23697
"4365","ENSG00000124571","XPO5","6",43490072,43543812,53740
"4366","ENSG00000124574","ABCC10","6",43395104,43418168,23064
"4367","ENSG00000124575","HIST1H1D","6",26234440,26235216,776
"4368","ENSG00000124587","PEX6","6",42931608,42946958,15350
"4369","ENSG00000124588","NQO2","6",2988221,3019996,31775
"4370","ENSG00000124593","PRICKLE4","6",41748087,41757879,9792
"4371","ENSG00000124596","OARD1","6",41001366,41065526,64160
"4372","ENSG00000124602","UNC5CL","6",40994772,41006928,12156
"4373","ENSG00000124608","AARS2","6",44267391,44281063,13672
"4374","ENSG00000124610","HIST1H1A","6",26017260,26018040,780
"4375","ENSG00000124613","ZNF391","6",27342394,27371683,29289
"4376","ENSG00000124614","RPS10","6",34385231,34393902,8671
"4377","ENSG00000124615","MOCS1","6",39867354,39902290,34936
"4378","ENSG00000124635","HIST1H2BJ","6",27093676,27100541,6865
"4379","ENSG00000124641","MED20","6",41873092,41888877,15785
"4380","ENSG00000124659","TBCC","6",42712219,42714558,2339
"4381","ENSG00000124688","MAD2L1BP","6",43597277,43608689,11412
"4382","ENSG00000124693","HIST1H3B","6",26031817,26032288,471
"4383","ENSG00000124702","KLHDC3","6",42981951,42989036,7085
"4384","ENSG00000124733","MEA1","6",42979832,42981706,1874
"4385","ENSG00000124743","KLHL31","6",53512699,53530506,17807
"4386","ENSG00000124749","COL21A1","6",55921388,56258892,337504
"4387","ENSG00000124762","CDKN1A","6",36644305,36655116,10811
"4388","ENSG00000124766","SOX4","6",21593972,21598847,4875
"4389","ENSG00000124767","GLO1","6",38643701,38670917,27216
"4390","ENSG00000124782","RREB1","6",7107830,7252213,144383
"4391","ENSG00000124783","SSR1","6",7268539,7347679,79140
"4392","ENSG00000124784","RIOK1","6",7389729,7418270,28541
"4393","ENSG00000124785","NRN1","6",5998232,6007200,8968
"4394","ENSG00000124786","SLC35B3","6",8413301,8435794,22493
"4395","ENSG00000124787","RPP40","6",4994966,5004297,9331
"4396","ENSG00000124788","ATXN1","6",16299343,16761722,462379
"4397","ENSG00000124789","NUP153","6",17615269,17706656,91387
"4398","ENSG00000124795","DEK","6",18224099,18265054,40955
"4399","ENSG00000124802","EEF1E1","6",8073593,8102811,29218
"4400","ENSG00000124813","RUNX2","6",45295894,45632086,336192
"4401","ENSG00000124831","LRRFIP1","2",238536219,238722325,186106
"4402","ENSG00000124835","","2",237957242,237964810,7568
"4403","ENSG00000124920","MYRF","11",61520114,61555990,35876
"4404","ENSG00000124942","AHNAK","11",62201016,62323707,122691
"4405","ENSG00000125037","EMC3","3",10004221,10052800,48579
"4406","ENSG00000125046","SSUH2","3",8661086,8786726,125640
"4407","ENSG00000125107","CNOT1","16",58553855,58663790,109935
"4408","ENSG00000125122","LRRC29","16",67241042,67260951,19909
"4409","ENSG00000125124","BBS2","16",56500748,56554195,53447
"4410","ENSG00000125148","MT2A","16",56642111,56643409,1298
"4411","ENSG00000125149","C16orf70","16",67143861,67182442,38581
"4412","ENSG00000125166","GOT2","16",58741035,58768261,27226
"4413","ENSG00000125170","DOK4","16",57505863,57521239,15376
"4414","ENSG00000125246","CLYBL","13",100258919,100549387,290468
"4415","ENSG00000125247","TMTC4","13",101256181,101327347,71166
"4416","ENSG00000125249","RAP2A","13",98086476,98121382,34906
"4417","ENSG00000125255","SLC10A2","13",103696350,103719196,22846
"4418","ENSG00000125257","ABCC4","13",95672083,95953687,281604
"4419","ENSG00000125266","EFNB2","13",107142079,107187462,45383
"4420","ENSG00000125285","SOX21","13",95361886,95364389,2503
"4421","ENSG00000125304","TM9SF2","13",100153671,100216260,62589
"4422","ENSG00000125319","C17orf53","17",42219274,42239844,20570
"4423","ENSG00000125347","IRF1","5",131817301,131826490,9189
"4424","ENSG00000125351","UPF3B","X",118967985,118986961,18976
"4425","ENSG00000125352","RNF113A","X",119004497,119005791,1294
"4426","ENSG00000125354","SEPT6","X",118749687,118827333,77646
"4427","ENSG00000125355","TMEM255A","X",119392505,119445411,52906
"4428","ENSG00000125356","NDUFA1","X",119005450,119010625,5175
"4429","ENSG00000125375","ATP5S","14",50779044,50802276,23232
"4430","ENSG00000125378","BMP4","14",54416454,54425479,9025
"4431","ENSG00000125386","FAM193A","4",2626988,2734292,107304
"4432","ENSG00000125388","GRK4","4",2965335,3042474,77139
"4433","ENSG00000125398","SOX9","17",70117161,70122561,5400
"4434","ENSG00000125430","HS3ST3B1","17",14204400,14252721,48321
"4435","ENSG00000125434","SLC25A35","17",8191081,8198661,7580
"4436","ENSG00000125445","MRPS7","17",73257755,73262454,4699
"4437","ENSG00000125447","GGA3","17",73232694,73258444,25750
"4438","ENSG00000125449","ARMC7","17",73106047,73126360,20313
"4439","ENSG00000125450","NUP85","17",73201754,73231853,30099
"4440","ENSG00000125454","SLC25A19","17",73269073,73285591,16518
"4441","ENSG00000125457","MIF4GD","17",73262309,73267308,4999
"4442","ENSG00000125458","NT5C","17",73126320,73127890,1570
"4443","ENSG00000125459","MSTO1","1",155579979,155718153,138174
"4444","ENSG00000125482","TTF1","9",135251008,135282209,31201
"4445","ENSG00000125484","GTF3C4","9",135545422,135570342,24920
"4446","ENSG00000125485","DDX31","9",135468384,135545788,77404
"4447","ENSG00000125503","PPP1R12C","19",55602281,55628927,26646
"4448","ENSG00000125505","MBOAT7","19",54677107,54693733,16626
"4449","ENSG00000125510","OPRL1","20",62711526,62731996,20470
"4450","ENSG00000125520","SLC2A4RG","20",62371214,62374858,3644
"4451","ENSG00000125534","PPDPF","20",62152077,62153559,1482
"4452","ENSG00000125551","PLGLB2","2",88047606,88058312,10706
"4453","ENSG00000125611","CHCHD5","2",113341817,113346852,5035
"4454","ENSG00000125618","PAX8","2",113973574,114036527,62953
"4455","ENSG00000125629","INSIG2","2",118846028,118868573,22545
"4456","ENSG00000125630","POLR1B","2",113299492,113334635,35143
"4457","ENSG00000125633","CCDC93","2",118673054,118771709,98655
"4458","ENSG00000125637","PSD4","2",113914902,113966973,52071
"4459","ENSG00000125648","SLC25A23","19",6436090,6465214,29124
"4460","ENSG00000125650","PSPN","19",6375159,6379069,3910
"4461","ENSG00000125651","GTF2F1","19",6379580,6393992,14412
"4462","ENSG00000125652","ALKBH7","19",6372444,6375042,2598
"4463","ENSG00000125656","CLPP","19",6361463,6368919,7456
"4464","ENSG00000125675","GRIA3","X",122318006,122624766,306760
"4465","ENSG00000125676","THOC2","X",122734412,122866906,132494
"4466","ENSG00000125686","MED1","17",37560538,37607539,47001
"4467","ENSG00000125691","RPL23","17",37004118,37010096,5978
"4468","ENSG00000125703","ATG4C","1",63249806,63331184,81378
"4469","ENSG00000125733","TRIP10","19",6737936,6751537,13601
"4470","ENSG00000125734","GPR108","19",6729925,6737614,7689
"4471","ENSG00000125740","FOSB","19",45971253,45978437,7184
"4472","ENSG00000125741","OPA3","19",46030685,46105470,74785
"4473","ENSG00000125743","SNRPD2","19",46190712,46195827,5115
"4474","ENSG00000125744","RTN2","19",45988547,46000319,11772
"4475","ENSG00000125746","EML2","19",46110252,46148887,38635
"4476","ENSG00000125753","VASP","19",46009837,46030241,20404
"4477","ENSG00000125755","SYMPK","19",46318668,46366548,47880
"4478","ENSG00000125772","GPCPD1","20",5525085,5591672,66587
"4479","ENSG00000125779","PANK2","20",3869486,3907605,38119
"4480","ENSG00000125804","FAM182A","20",26035291,26073683,38392
"4481","ENSG00000125810","CD93","20",23059986,23066977,6991
"4482","ENSG00000125812","GZF1","20",23342787,23353700,10913
"4483","ENSG00000125814","NAPB","20",23355159,23402125,46966
"4484","ENSG00000125817","CENPB","20",3764498,3767337,2839
"4485","ENSG00000125818","PSMF1","20",1093906,1160596,66690
"4486","ENSG00000125821","DTD1","20",18568537,18744561,176024
"4487","ENSG00000125826","RBCK1","20",388142,411610,23468
"4488","ENSG00000125827","TMX4","20",7957995,8000476,42481
"4489","ENSG00000125834","STK35","20",2082257,2157684,75427
"4490","ENSG00000125835","SNRPB","20",2442280,2451499,9219
"4491","ENSG00000125841","NRSN2","20",327426,340304,12878
"4492","ENSG00000125843","AP5S1","20",3801178,3805949,4771
"4493","ENSG00000125844","RRBP1","20",17594323,17662940,68617
"4494","ENSG00000125845","BMP2","20",6748311,6760927,12616
"4495","ENSG00000125846","ZNF133","20",18269121,18297640,28519
"4496","ENSG00000125848","FLRT3","20",14303634,14318262,14628
"4497","ENSG00000125851","PCSK2","20",17206752,17465223,258471
"4498","ENSG00000125863","MKKS","20",10381657,10414870,33213
"4499","ENSG00000125864","BFSP1","20",17474550,17549865,75315
"4500","ENSG00000125868","DSTN","20",17550508,17590564,40056
"4501","ENSG00000125869","LAMP5","20",9495005,9511171,16166
"4502","ENSG00000125870","SNRPB2","20",16710606,16722421,11815
"4503","ENSG00000125871","MGME1","20",17949556,17971765,22209
"4504","ENSG00000125875","TBC1D20","20",416124,443197,27073
"4505","ENSG00000125877","ITPA","20",3189514,3204516,15002
"4506","ENSG00000125885","MCM8","20",5931298,5975852,44554
"4507","ENSG00000125898","FAM110A","20",814358,838106,23748
"4508","ENSG00000125901","MRPS26","20",3026591,3028900,2309
"4509","ENSG00000125912","NCLN","19",3185561,3209573,24012
"4510","ENSG00000125931","CITED1","X",71521488,71527037,5549
"4511","ENSG00000125944","HNRNPR","1",23630264,23670829,40565
"4512","ENSG00000125945","ZNF436","1",23685941,23695935,9994
"4513","ENSG00000125952","MAX","14",65472892,65569413,96521
"4514","ENSG00000125962","ARMCX5","X",101854096,101859087,4991
"4515","ENSG00000125966","MMP24","20",33814457,33864801,50344
"4516","ENSG00000125967","NECAB3","20",32244893,32262269,17376
"4517","ENSG00000125968","ID1","20",30193086,30194318,1232
"4518","ENSG00000125970","RALY","20",32581452,32696114,114662
"4519","ENSG00000125971","DYNLRB1","20",33104214,33128762,24548
"4520","ENSG00000125977","EIF2S2","20",32676104,32700138,24034
"4521","ENSG00000125991","ERGIC3","20",34129770,34145405,15635
"4522","ENSG00000125995","ROMO1","20",34287194,34288906,1712
"4523","ENSG00000126001","CEP250","20",34042985,34099804,56819
"4524","ENSG00000126003","PLAGL2","20",30780306,30795594,15288
"4525","ENSG00000126005","MMP24-AS1","20",33804265,33865934,61669
"4526","ENSG00000126012","KDM5C","X",53220503,53254604,34101
"4527","ENSG00000126016","AMOT","X",112017731,112084043,66312
"4528","ENSG00000126062","TMEM115","3",50392180,50397041,4861
"4529","ENSG00000126067","PSMB2","1",36067185,36107445,40260
"4530","ENSG00000126070","AGO3","1",36396319,36538101,141782
"4531","ENSG00000126088","UROD","1",45477819,45481247,3428
"4532","ENSG00000126091","ST3GAL3","1",44171495,44396831,225336
"4533","ENSG00000126106","TMEM53","1",45100910,45140227,39317
"4534","ENSG00000126107","HECTD3","1",45468212,45477001,8789
"4535","ENSG00000126214","KLC1","14",104028233,104167888,139655
"4536","ENSG00000126215","XRCC3","14",104163946,104181841,17895
"4537","ENSG00000126216","TUBGCP3","13",113139325,113242481,103156
"4538","ENSG00000126217","MCF2L","13",113548692,113754053,205361
"4539","ENSG00000126226","PCID2","13",113831891,113863029,31138
"4540","ENSG00000126243","LRFN3","19",36426260,36436669,10409
"4541","ENSG00000126247","CAPNS1","19",36630477,36641255,10778
"4542","ENSG00000126249","PDCD2L","19",34895289,34917073,21784
"4543","ENSG00000126254","RBM42","19",36119932,36128588,8656
"4544","ENSG00000126259","KIRREL2","19",36346763,36358011,11248
"4545","ENSG00000126261","UBA2","19",34919257,34960853,41596
"4546","ENSG00000126267","COX6B1","19",36139125,36149763,10638
"4547","ENSG00000126351","THRA","17",38214543,38250120,35577
"4548","ENSG00000126368","NR1D1","17",38249040,38256978,7938
"4549","ENSG00000126391","FRMD8","11",65154070,65180996,26926
"4550","ENSG00000126432","PRDX5","11",64085560,64089283,3723
"4551","ENSG00000126453","BCL2L12","19",50168823,50177173,8350
"4552","ENSG00000126456","IRF3","19",50162826,50169132,6306
"4553","ENSG00000126457","PRMT1","19",50179043,50192286,13243
"4554","ENSG00000126458","RRAS","19",50138549,50143458,4909
"4555","ENSG00000126461","SCAF1","19",50145382,50161899,16517
"4556","ENSG00000126464","PRR12","19",50094900,50129696,34796
"4557","ENSG00000126522","ASL","7",65540785,65558545,17760
"4558","ENSG00000126524","SBDS","7",66452664,66460588,7924
"4559","ENSG00000126561","STAT5A","17",40439565,40463961,24396
"4560","ENSG00000126581","BECN1","17",40962152,40985367,23215
"4561","ENSG00000126602","TRAP1","16",3701640,3767598,65958
"4562","ENSG00000126603","GLIS2","16",4364762,4389598,24836
"4563","ENSG00000126653","NSRP1","17",28442539,28513493,70954
"4564","ENSG00000126698","DNAJC8","1",28525967,28559536,33569
"4565","ENSG00000126705","AHDC1","1",27860546,27930942,70396
"4566","ENSG00000126709","IFI6","1",27992572,27998729,6157
"4567","ENSG00000126733","DACH2","X",85403462,86087607,684145
"4568","ENSG00000126746","ZNF384","12",6775643,6798738,23095
"4569","ENSG00000126749","EMG1","12",7072408,7105520,33112
"4570","ENSG00000126756","UXT","X",47511197,47518560,7363
"4571","ENSG00000126767","ELK1","X",47494920,47510003,15083
"4572","ENSG00000126768","TIMM17B","X",48750730,48755426,4696
"4573","ENSG00000126773","PCNXL4","14",60558629,60635851,77222
"4574","ENSG00000126775","ATG14","14",55833110,55878576,45466
"4575","ENSG00000126777","KTN1","14",56025790,56168244,142454
"4576","ENSG00000126785","RHOJ","14",63670832,63759937,89105
"4577","ENSG00000126787","DLGAP5","14",55614830,55658396,43566
"4578","ENSG00000126790","L3HYPDH","14",59927081,59951148,24067
"4579","ENSG00000126803","HSPA2","14",65002623,65009955,7332
"4580","ENSG00000126804","ZBTB1","14",64970430,65000408,29978
"4581","ENSG00000126814","TRMT5","14",61438169,61448076,9907
"4582","ENSG00000126821","SGPP1","14",64150932,64194757,43825
"4583","ENSG00000126822","PLEKHG3","14",65170820,65213610,42790
"4584","ENSG00000126858","RHOT1","17",30469473,30580393,110920
"4585","ENSG00000126870","WDR60","7",158649269,158749438,100169
"4586","ENSG00000126878","AIF1L","9",133971863,133998539,26676
"4587","ENSG00000126882","FAM78A","9",134133463,134151934,18471
"4588","ENSG00000126883","NUP214","9",134000948,134110057,109109
"4589","ENSG00000126903","SLC10A3","X",153715645,153719016,3371
"4590","ENSG00000126934","MAP2K2","19",4090319,4124126,33807
"4591","ENSG00000126945","HNRNPH2","X",100663283,100669121,5838
"4592","ENSG00000126947","ARMCX1","X",100805514,100809683,4169
"4593","ENSG00000126950","TMEM35","X",100333709,100351353,17644
"4594","ENSG00000126953","TIMM8A","X",100600649,100604184,3535
"4595","ENSG00000126970","ZC4H2","X",64136250,64254593,118343
"4596","ENSG00000127022","CANX","5",179105629,179157926,52297
"4597","ENSG00000127054","CPSF3L","1",1246965,1260071,13106
"4598","ENSG00000127080","IPPK","9",95375466,95432547,57081
"4599","ENSG00000127081","ZNF484","9",95607874,95640304,32430
"4600","ENSG00000127084","FGD3","9",95709733,95798518,88785
"4601","ENSG00000127124","HIVEP3","1",41972036,42501596,529560
"4602","ENSG00000127125","PPCS","1",42921788,42939056,17268
"4603","ENSG00000127152","BCL11B","14",99635624,99737861,102237
"4604","ENSG00000127184","COX7C","5",85913721,85916779,3058
"4605","ENSG00000127191","TRAF2","9",139776364,139821059,44695
"4606","ENSG00000127220","ABHD8","19",17402940,17421045,18105
"4607","ENSG00000127241","MASP1","3",186935942,187009810,73868
"4608","ENSG00000127252","HRASLS","3",192958914,192995527,36613
"4609","ENSG00000127311","HELB","12",66696325,66737423,41098
"4610","ENSG00000127314","RAP1B","12",69004619,69054372,49753
"4611","ENSG00000127325","BEST3","12",70037140,70093256,56116
"4612","ENSG00000127328","RAB3IP","12",70132461,70216984,84523
"4613","ENSG00000127329","PTPRB","12",70910630,71031220,120590
"4614","ENSG00000127334","DYRK2","12",68042118,68059186,17068
"4615","ENSG00000127337","YEATS4","12",69753483,69784576,31093
"4616","ENSG00000127362","TAS2R3","7",141463897,141464997,1100
"4617","ENSG00000127364","TAS2R4","7",141478242,141479235,993
"4618","ENSG00000127366","TAS2R5","7",141490017,141491166,1149
"4619","ENSG00000127399","LRRC61","7",150019728,150035239,15511
"4620","ENSG00000127418","FGFRL1","4",1003724,1020685,16961
"4621","ENSG00000127419","TMEM175","4",926175,952444,26269
"4622","ENSG00000127423","AUNIP","1",26158414,26185903,27489
"4623","ENSG00000127445","PIN1","19",9945933,9960358,14425
"4624","ENSG00000127452","FBXL12","19",9920943,9938492,17549
"4625","ENSG00000127463","EMC1","1",19542158,19578046,35888
"4626","ENSG00000127481","UBR4","1",19401000,19536770,135770
"4627","ENSG00000127483","HP1BP3","1",21069154,21113816,44662
"4628","ENSG00000127511","SIN3B","19",16940211,16991164,50953
"4629","ENSG00000127526","SLC35E1","19",16660642,16683193,22551
"4630","ENSG00000127527","EPS15L1","19",16466050,16582896,116846
"4631","ENSG00000127540","UQCR11","19",1597171,1605480,8309
"4632","ENSG00000127554","GFER","16",2034208,2037750,3542
"4633","ENSG00000127561","SYNGR3","16",2039661,2044276,4615
"4634","ENSG00000127564","PKMYT1","16",3018025,3030540,12515
"4635","ENSG00000127580","WDR24","16",734622,740444,5822
"4636","ENSG00000127585","FBXL16","16",742500,755829,13329
"4637","ENSG00000127586","CHTF18","16",838046,850737,12691
"4638","ENSG00000127603","MACF1","1",39546988,39952849,405861
"4639","ENSG00000127616","SMARCA4","19",11071598,11176071,104473
"4640","ENSG00000127663","KDM4B","19",4969125,5153606,184481
"4641","ENSG00000127720","METTL25","12",82752276,82873015,120739
"4642","ENSG00000127774","EMC6","17",3572109,3572962,853
"4643","ENSG00000127804","METTL16","17",2308856,2415185,106329
"4644","ENSG00000127837","AAMP","2",219128850,219134980,6130
"4645","ENSG00000127838","PNKD","2",219135115,219211516,76401
"4646","ENSG00000127863","TNFRSF19","13",24144509,24250232,105723
"4647","ENSG00000127870","RNF6","13",26706253,26796791,90538
"4648","ENSG00000127884","ECHS1","10",135175984,135187193,11209
"4649","ENSG00000127903","ZNF835","19",57174020,57183151,9131
"4650","ENSG00000127914","AKAP9","7",91570181,91739987,169806
"4651","ENSG00000127920","GNG11","7",93551011,93557922,6911
"4652","ENSG00000127922","SHFM1","7",96110938,96339203,228265
"4653","ENSG00000127946","HIP1","7",75162621,75368280,205659
"4654","ENSG00000127947","PTPN12","7",77166592,77269388,102796
"4655","ENSG00000127948","POR","7",75528518,75616173,87655
"4656","ENSG00000127952","STYXL1","7",75625656,75677322,51666
"4657","ENSG00000127955","GNAI1","7",79763271,79848718,85447
"4658","ENSG00000127957","PMS2P3","7",75132254,75157478,25224
"4659","ENSG00000127980","PEX1","7",92116334,92157845,41511
"4660","ENSG00000127989","MTERF","7",91321323,91510034,188711
"4661","ENSG00000127990","SGCE","7",94214542,94285521,70979
"4662","ENSG00000127993","RBM48","7",92158087,92167319,9232
"4663","ENSG00000127995","CASD1","7",94138531,94186331,47800
"4664","ENSG00000128000","ZNF780B","19",40534167,40562116,27949
"4665","ENSG00000128016","ZFP36","19",39897453,39900052,2599
"4666","ENSG00000128039","SRD5A3","4",56212276,56239263,26987
"4667","ENSG00000128045","RASL11B","4",53728457,53733000,4543
"4668","ENSG00000128050","PAICS","4",57301907,57327534,25627
"4669","ENSG00000128052","KDR","4",55944644,55991756,47112
"4670","ENSG00000128059","PPAT","4",57259528,57301781,42253
"4671","ENSG00000128159","TUBGCP6","22",50656118,50683421,27303
"4672","ENSG00000128185","DGCR6L","22",20301799,20307603,5804
"4673","ENSG00000128191","DGCR8","22",20067755,20099400,31645
"4674","ENSG00000128203","ASPHD2","22",26825239,26840981,15742
"4675","ENSG00000128228","SDF2L1","22",21996550,21998587,2037
"4676","ENSG00000128245","YWHAH","22",32340447,32353590,13143
"4677","ENSG00000128254","C22orf24","22",32329507,32341504,11997
"4678","ENSG00000128266","GNAZ","22",23412540,23467224,54684
"4679","ENSG00000128268","MGAT3","22",39853349,39888199,34850
"4680","ENSG00000128271","ADORA2A","22",24813847,24838328,24481
"4681","ENSG00000128272","ATF4","22",39915700,39918691,2991
"4682","ENSG00000128283","CDC42EP1","22",37956454,37965412,8958
"4683","ENSG00000128294","TPST2","22",26921458,26992681,71223
"4684","ENSG00000128309","MPST","22",37415676,37425863,10187
"4685","ENSG00000128311","TST","22",37406900,37415681,8781
"4686","ENSG00000128335","APOL2","22",36622256,36636000,13744
"4687","ENSG00000128342","LIF","22",30636436,30642840,6404
"4688","ENSG00000128394","APOBEC3F","22",39436609,39449915,13306
"4689","ENSG00000128408","RIBC2","22",45809572,45828376,18804
"4690","ENSG00000128463","EMC4","15",34517200,34522357,5157
"4691","ENSG00000128487","SPECC1","17",19912657,20222339,309682
"4692","ENSG00000128512","DOCK4","7",111366166,111846466,480300
"4693","ENSG00000128513","POT1","7",124462440,124570037,107597
"4694","ENSG00000128524","ATP6V1F","7",128502880,128505898,3018
"4695","ENSG00000128534","NAA38","7",117824086,117832878,8792
"4696","ENSG00000128536","CDHR3","7",105517242,105676877,159635
"4697","ENSG00000128563","PRKRIP1","7",102004319,102067123,62804
"4698","ENSG00000128567","PODXL","7",131185021,131242976,57955
"4699","ENSG00000128573","FOXP2","7",113726382,114333827,607445
"4700","ENSG00000128578","STRIP2","7",129074274,129128240,53966
"4701","ENSG00000128581","RABL5","7",100956975,100965104,8129
"4702","ENSG00000128585","MKLN1","7",130794855,131181395,386540
"4703","ENSG00000128590","DNAJB9","7",108210012,108215294,5282
"4704","ENSG00000128591","FLNC","7",128470431,128499328,28897
"4705","ENSG00000128594","LRRC4","7",127667124,127672160,5036
"4706","ENSG00000128595","CALU","7",128379346,128411861,32515
"4707","ENSG00000128596","CCDC136","7",128430811,128462186,31375
"4708","ENSG00000128602","SMO","7",128828713,128853386,24673
"4709","ENSG00000128606","LRRC17","7",102553438,102585396,31958
"4710","ENSG00000128607","KLHDC10","7",129710350,129775560,65210
"4711","ENSG00000128609","NDUFA5","7",123177051,123198309,21258
"4712","ENSG00000128626","MRPS12","19",39421188,39423802,2614
"4713","ENSG00000128641","MYO1B","2",192109911,192290115,180204
"4714","ENSG00000128654","MTX2","2",177134123,177202753,68630
"4715","ENSG00000128655","PDE11A","2",178487980,178973066,485086
"4716","ENSG00000128656","CHN1","2",175664091,175870097,206006
"4717","ENSG00000128683","GAD1","2",171669723,171717661,47938
"4718","ENSG00000128694","OSGEPL1","2",190611386,190627953,16567
"4719","ENSG00000128699","ORMDL1","2",190635049,190649097,14048
"4720","ENSG00000128708","HAT1","2",172778958,172848599,69641
"4721","ENSG00000128731","HERC2","15",28356186,28567298,211112
"4722","ENSG00000128739","SNRPN","15",25068794,25223870,155076
"4723","ENSG00000128789","PSMG2","18",12658737,12725739,67002
"4724","ENSG00000128791","TWSG1","18",9334765,9402418,67653
"4725","ENSG00000128805","ARHGAP22","10",49654077,49864310,210233
"4726","ENSG00000128829","EIF2AK4","15",40226347,40327797,101450
"4727","ENSG00000128833","MYO5C","15",52484519,52587995,103476
"4728","ENSG00000128849","CGNL1","15",57668165,57842925,174760
"4729","ENSG00000128872","TMOD2","15",52043758,52108565,64807
"4730","ENSG00000128881","TTBK2","15",43030932,43213007,182075
"4731","ENSG00000128891","C15orf57","15",40820882,40857256,36374
"4732","ENSG00000128908","INO80","15",41271078,41408552,137474
"4733","ENSG00000128915","NARG2","15",60711808,60771359,59551
"4734","ENSG00000128917","DLL4","15",41221538,41231237,9699
"4735","ENSG00000128918","ALDH1A2","15",58245622,58790065,544443
"4736","ENSG00000128923","FAM63B","15",59063391,59154099,90708
"4737","ENSG00000128928","IVD","15",40697686,40728146,30460
"4738","ENSG00000128944","KNSTRN","15",40674922,40686447,11525
"4739","ENSG00000128951","DUT","15",48623208,48635570,12362
"4740","ENSG00000128965","CHAC1","15",41245160,41248710,3550
"4741","ENSG00000128973","CLN6","15",68499330,68549549,50219
"4742","ENSG00000128989","ARPP19","15",52839242,52862080,22838
"4743","ENSG00000129003","VPS13C","15",62144588,62352672,208084
"4744","ENSG00000129007","CALML4","15",68483043,68498417,15374
"4745","ENSG00000129028","THAP10","15",71173681,71185124,11443
"4746","ENSG00000129038","LOXL1","15",74218330,74244478,26148
"4747","ENSG00000129055","ANAPC13","3",134196548,134205558,9010
"4748","ENSG00000129071","MBD4","3",129149787,129158878,9091
"4749","ENSG00000129083","COPB1","11",14464986,14521573,56587
"4750","ENSG00000129084","PSMA1","11",14515329,14665181,149852
"4751","ENSG00000129103","SUMF2","7",56131695,56148363,16668
"4752","ENSG00000129116","PALLD","4",169418217,169849608,431391
"4753","ENSG00000129128","SPCS3","4",177241115,177253396,12281
"4754","ENSG00000129151","BBOX1","11",27062272,27149356,87084
"4755","ENSG00000129158","SERGEF","11",17809595,18034709,225114
"4756","ENSG00000129159","KCNC1","11",17756359,17804602,48243
"4757","ENSG00000129167","TPH1","11",18039111,18063973,24862
"4758","ENSG00000129173","E2F8","11",19245610,19263167,17557
"4759","ENSG00000129187","DCTD","4",183811213,183839089,27876
"4760","ENSG00000129195","FAM64A","17",6347735,6354789,7054
"4761","ENSG00000129197","RPAIN","17",5322961,5336196,13235
"4762","ENSG00000129214","SHBG","17",7517382,7536700,19318
"4763","ENSG00000129219","PLD2","17",4710391,4726729,16338
"4764","ENSG00000129235","TXNDC17","17",6544078,6547861,3783
"4765","ENSG00000129244","ATP1B2","17",7549945,7561086,11141
"4766","ENSG00000129245","FXR2","17",7494548,7518189,23641
"4767","ENSG00000129250","KIF1C","17",4901243,4931696,30453
"4768","ENSG00000129255","MPDU1","17",7486847,7496107,9260
"4769","ENSG00000129282","MRM1","17",34958001,34965407,7406
"4770","ENSG00000129292","PHF20L1","8",133787618,133861052,73434
"4771","ENSG00000129295","LRRC6","8",133584320,133687838,103518
"4772","ENSG00000129315","CCNT1","12",49082247,49110681,28434
"4773","ENSG00000129317","PUS7L","12",44122410,44152620,30210
"4774","ENSG00000129347","KRI1","19",10663761,10676713,12952
"4775","ENSG00000129351","ILF3","19",10764937,10803093,38156
"4776","ENSG00000129353","SLC44A2","19",10713133,10755235,42102
"4777","ENSG00000129355","CDKN2D","19",10677138,10679735,2597
"4778","ENSG00000129422","MTUS1","8",17501304,17658426,157122
"4779","ENSG00000129460","NGDN","14",23938897,23979071,40174
"4780","ENSG00000129472","RAB2B","14",21927179,21945132,17953
"4781","ENSG00000129473","BCL2L2","14",23767999,23780968,12969
"4782","ENSG00000129474","AJUBA","14",23440383,23451851,11468
"4783","ENSG00000129480","DTD2","14",31915242,31926716,11474
"4784","ENSG00000129484","PARP2","14",20811741,20826064,14323
"4785","ENSG00000129493","HEATR5A","14",31760994,31889788,128794
"4786","ENSG00000129515","SNX6","14",35030300,35099389,69089
"4787","ENSG00000129518","EAPP","14",34985135,35008916,23781
"4788","ENSG00000129521","EGLN3","14",34393437,34931980,538543
"4789","ENSG00000129534","MIS18BP1","14",45672393,45722743,50350
"4790","ENSG00000129559","NEDD8","14",24686058,24701660,15602
"4791","ENSG00000129562","DAD1","14",23033805,23058175,24370
"4792","ENSG00000129566","TEP1","14",20833826,20881588,47762
"4793","ENSG00000129595","EPB41L4A","5",111478138,111755013,276875
"4794","ENSG00000129596","CDO1","5",115140430,115152651,12221
"4795","ENSG00000129625","REEP5","5",112212084,112258236,46152
"4796","ENSG00000129636","ITFG1","16",47188298,47498060,309762
"4797","ENSG00000129646","QRICH2","17",74270130,74303761,33631
"4798","ENSG00000129654","FOXJ1","17",74132414,74137380,4966
"4799","ENSG00000129657","SEC14L1","17",75082798,75213179,130381
"4800","ENSG00000129675","ARHGEF6","X",135747706,135864247,116541
"4801","ENSG00000129680","MAP7D3","X",135295381,135338641,43260
"4802","ENSG00000129682","FGF13","X",137713735,138304939,591204
"4803","ENSG00000129691","ASH2L","8",37962760,38001594,38834
"4804","ENSG00000129696","TTI2","8",33330904,33371119,40215
"4805","ENSG00000129749","CHRNA10","11",3686817,3692614,5797
"4806","ENSG00000129757","CDKN1C","11",2904443,2907111,2668
"4807","ENSG00000129810","SGOL1","3",20202085,20227784,25699
"4808","ENSG00000129824","RPS4Y1","Y",2709527,2800041,90514
"4809","ENSG00000129911","KLF16","19",1852399,1863567,11168
"4810","ENSG00000129925","TMEM8A","16",420773,437113,16340
"4811","ENSG00000129932","DOHH","19",3490819,3500938,10119
"4812","ENSG00000129933","MAU2","19",19431490,19469563,38073
"4813","ENSG00000129946","SHC2","19",416583,460996,44413
"4814","ENSG00000129951","","19",812518,821967,9449
"4815","ENSG00000129968","ABHD17A","19",1876809,1885546,8737
"4816","ENSG00000129990","SYT5","19",55682567,55691809,9242
"4817","ENSG00000130005","GAMT","19",1397091,1401569,4478
"4818","ENSG00000130021","HDHD1","X",6966961,7066231,99270
"4819","ENSG00000130023","ERMARD","6",170151718,170181680,29962
"4820","ENSG00000130024","PHF10","6",170104001,170124151,20150
"4821","ENSG00000130035","GALNT8","12",4829507,4960277,130770
"4822","ENSG00000130038","EFCAB4B","12",3715799,3873985,158186
"4823","ENSG00000130052","STARD8","X",67867508,67945684,78176
"4824","ENSG00000130054","FAM155B","X",68725084,68752351,27267
"4825","ENSG00000130055","GDPD2","X",69642881,69653240,10359
"4826","ENSG00000130066","SAT1","X",23801290,23804343,3053
"4827","ENSG00000130119","GNL3L","X",54556644,54587504,30860
"4828","ENSG00000130147","SH3BP4","2",235860617,235964358,103741
"4829","ENSG00000130150","MOSPD2","X",14891563,14940449,48886
"4830","ENSG00000130158","DOCK6","19",11309971,11373157,63186
"4831","ENSG00000130159","ECSIT","19",11616731,11639989,23258
"4832","ENSG00000130164","LDLR","19",11200038,11244492,44454
"4833","ENSG00000130165","ELOF1","19",11661962,11670051,8089
"4834","ENSG00000130175","PRKCSH","19",11546109,11561783,15674
"4835","ENSG00000130176","CNN1","19",11649532,11661138,11606
"4836","ENSG00000130177","CDC16","13",115000362,115038198,37836
"4837","ENSG00000130193","THEM6","8",143808621,143818345,9724
"4838","ENSG00000130202","PVRL2","19",45349432,45392485,43053
"4839","ENSG00000130203","APOE","19",45409011,45412650,3639
"4840","ENSG00000130204","TOMM40","19",45393826,45406946,13120
"4841","ENSG00000130208","APOC1","19",45417504,45422606,5102
"4842","ENSG00000130222","GADD45G","9",92219928,92221470,1542
"4843","ENSG00000130224","LRCH2","X",114345185,114468635,123450
"4844","ENSG00000130227","XPO7","8",21777180,21864096,86916
"4845","ENSG00000130244","FAM98C","19",38893775,38899728,5953
"4846","ENSG00000130254","SAFB2","19",5587010,5624057,37047
"4847","ENSG00000130255","RPL36","19",5674958,5691887,16929
"4848","ENSG00000130270","ATP8B3","19",1782074,1812275,30201
"4849","ENSG00000130287","NCAN","19",19322782,19363042,40260
"4850","ENSG00000130294","KIF1A","2",241653181,241759725,106544
"4851","ENSG00000130299","GTPBP3","19",17445729,17453544,7815
"4852","ENSG00000130304","SLC27A1","19",17579578,17616977,37399
"4853","ENSG00000130305","NSUN5","7",72716514,72722864,6350
"4854","ENSG00000130309","COLGALT1","19",17666403,17693971,27568
"4855","ENSG00000130311","DDA1","19",17420327,17434110,13783
"4856","ENSG00000130312","MRPL34","19",17403418,17417652,14234
"4857","ENSG00000130313","PGLS","19",17622438,17632097,9659
"4858","ENSG00000130332","LSM7","19",2321516,2328619,7103
"4859","ENSG00000130338","TULP4","6",158733692,158932860,199168
"4860","ENSG00000130340","SNX9","6",158244296,158366109,121813
"4861","ENSG00000130347","RTN4IP1","6",107018903,107077373,58470
"4862","ENSG00000130348","QRSL1","6",107077453,107116292,38839
"4863","ENSG00000130349","C6orf203","6",107349407,107372546,23139
"4864","ENSG00000130363","RSPH3","6",159393903,159421219,27316
"4865","ENSG00000130382","MLLT1","19",6212966,6279959,66993
"4866","ENSG00000130396","MLLT4","6",168227602,168372703,145101
"4867","ENSG00000130402","ACTN4","19",39138289,39222223,83934
"4868","ENSG00000130413","STK33","11",8413418,8615836,202418
"4869","ENSG00000130414","NDUFA10","2",240831867,240964819,132952
"4870","ENSG00000130429","ARPC1B","7",98971872,98992424,20552
"4871","ENSG00000130449","ZSWIM6","5",60628100,60841997,213897
"4872","ENSG00000130475","FCHO1","19",17858527,17899377,40850
"4873","ENSG00000130477","UNC13A","19",17712137,17799401,87264
"4874","ENSG00000130479","MAP1S","19",17830051,17845325,15274
"4875","ENSG00000130489","SCO2","22",50961997,50964868,2871
"4876","ENSG00000130508","PXDN","2",1635659,1748624,112965
"4877","ENSG00000130511","SSBP4","19",18529674,18545372,15698
"4878","ENSG00000130513","GDF15","19",18485541,18499986,14445
"4879","ENSG00000130517","PGPEP1","19",18451397,18480760,29363
"4880","ENSG00000130518","KIAA1683","19",18367908,18385319,17411
"4881","ENSG00000130520","LSM4","19",18417040,18434084,17044
"4882","ENSG00000130522","JUND","19",18390563,18392432,1869
"4883","ENSG00000130529","TRPM4","19",49660998,49715093,54095
"4884","ENSG00000130540","SULT4A1","22",44220389,44258398,38009
"4885","ENSG00000130544","ZNF557","19",7069455,7087979,18524
"4886","ENSG00000130558","OLFM1","9",137967268,138013025,45757
"4887","ENSG00000130559","CAMSAP1","9",138700333,138799074,98741
"4888","ENSG00000130560","UBAC1","9",138824815,138853226,28411
"4889","ENSG00000130584","ZBTB46","20",62375019,62462597,87578
"4890","ENSG00000130589","HELZ2","20",62189439,62205592,16153
"4891","ENSG00000130590","SAMD10","20",62605466,62611361,5895
"4892","ENSG00000130635","COL5A1","9",137533620,137736686,203066
"4893","ENSG00000130638","ATXN10","22",46067678,46241187,173509
"4894","ENSG00000130640","TUBGCP2","10",135093135,135125841,32706
"4895","ENSG00000130669","PAK4","19",39616410,39673456,57046
"4896","ENSG00000130684","ZNF337","20",25654851,25677477,22626
"4897","ENSG00000130695","CEP85","1",26560691,26605299,44608
"4898","ENSG00000130699","TAF4","20",60528525,60640866,112341
"4899","ENSG00000130702","LAMA5","20",60883011,60942368,59357
"4900","ENSG00000130703","OSBPL2","20",60813580,60871268,57688
"4901","ENSG00000130706","ADRM1","20",60877149,60883918,6769
"4902","ENSG00000130707","ASS1","9",133320316,133376661,56345
"4903","ENSG00000130711","PRDM12","9",133539981,133558368,18387
"4904","ENSG00000130713","EXOSC2","9",133569108,133580248,11140
"4905","ENSG00000130714","POMT1","9",134378289,134399193,20904
"4906","ENSG00000130717","UCK1","9",134399188,134406655,7467
"4907","ENSG00000130723","PRRC2B","9",134269480,134375584,106104
"4908","ENSG00000130724","CHMP2A","19",59062933,59066491,3558
"4909","ENSG00000130725","UBE2M","19",59067079,59070327,3248
"4910","ENSG00000130726","TRIM28","19",59055458,59062089,6631
"4911","ENSG00000130731","C16orf13","16",684429,686358,1929
"4912","ENSG00000130733","YIPF2","19",11033444,11039357,5913
"4913","ENSG00000130734","ATG4D","19",10654571,10664094,9523
"4914","ENSG00000130741","EIF2S3","X",24072833,24096088,23255
"4915","ENSG00000130748","TMEM160","19",47549165,47551888,2723
"4916","ENSG00000130749","ZC3H4","19",47567444,47617009,49565
"4917","ENSG00000130758","MAP3K10","19",40697651,40721482,23831
"4918","ENSG00000130762","ARHGEF16","1",3370990,3397677,26687
"4919","ENSG00000130764","LRRC47","1",3696784,3713068,16284
"4920","ENSG00000130766","SESN2","1",28586038,28609002,22964
"4921","ENSG00000130770","ATPIF1","1",28562620,28573417,10797
"4922","ENSG00000130772","MED18","1",28655513,28662476,6963
"4923","ENSG00000130775","THEMIS2","1",28199055,28213196,14141
"4924","ENSG00000130779","CLIP1","12",122755979,122907179,151200
"4925","ENSG00000130783","CCDC62","12",123258874,123312075,53201
"4926","ENSG00000130787","HIP1R","12",123319000,123347507,28507
"4927","ENSG00000130803","ZNF317","19",9251056,9274100,23044
"4928","ENSG00000130810","PPAN","19",10216965,10225414,8449
"4929","ENSG00000130811","EIF3G","19",10225693,10230596,4903
"4930","ENSG00000130813","C19orf66","19",10196798,10203928,7130
"4931","ENSG00000130816","DNMT1","19",10244021,10341962,97941
"4932","ENSG00000130818","ZNF426","19",9638667,9649303,10636
"4933","ENSG00000130821","SLC6A8","X",152953554,152962048,8494
"4934","ENSG00000130822","PNCK","X",152935185,152954465,19280
"4935","ENSG00000130826","DKC1","X",153991031,154005964,14933
"4936","ENSG00000130827","PLXNA3","X",153686621,153701989,15368
"4937","ENSG00000130830","MPP1","X",154006959,154049282,42323
"4938","ENSG00000130844","ZNF331","19",54024235,54083523,59288
"4939","ENSG00000130856","ZNF236","18",74534563,74682683,148120
"4940","ENSG00000130881","LRP3","19",33668509,33698694,30185
"4941","ENSG00000130921","C12orf65","12",123717463,123742506,25043
"4942","ENSG00000130935","NOL11","17",65713949,65740647,26698
"4943","ENSG00000130939","UBE4B","1",10092890,10241297,148407
"4944","ENSG00000130940","CASZ1","1",10696661,10856707,160046
"4945","ENSG00000130956","HABP4","9",99212483,99253618,41135
"4946","ENSG00000130958","SLC35D2","9",99082988,99145992,63004
"4947","ENSG00000130962","PRRG1","X",37208528,37316548,108020
"4948","ENSG00000130985","UBA1","X",47050260,47074527,24267
"4949","ENSG00000130997","POLN","4",2073645,2243848,170203
"4950","ENSG00000131002","TXLNG2P","Y",21729199,21768160,38961
"4951","ENSG00000131013","PPIL4","6",149825869,149867174,41305
"4952","ENSG00000131016","AKAP12","6",151561134,151679692,118558
"4953","ENSG00000131018","SYNE1","6",152442819,152958936,516117
"4954","ENSG00000131019","ULBP3","6",150384286,150390231,5945
"4955","ENSG00000131023","LATS1","6",149979289,150039392,60103
"4956","ENSG00000131037","EPS8L1","19",55583388,55599291,15903
"4957","ENSG00000131043","AAR2","20",34824381,34858840,34459
"4958","ENSG00000131051","RBM39","20",34291531,34330234,38703
"4959","ENSG00000131061","ZNF341","20",32319463,32380075,60612
"4960","ENSG00000131067","GGT7","20",33432523,33460663,28140
"4961","ENSG00000131069","ACSS2","20",33459949,33515769,55820
"4962","ENSG00000131080","EDA2R","X",65815479,65859108,43629
"4963","ENSG00000131089","ARHGEF9","X",62854847,63005426,150579
"4964","ENSG00000131100","ATP6V1E1","22",18074902,18111584,36682
"4965","ENSG00000131115","ZNF227","19",44711700,44741421,29721
"4966","ENSG00000131116","ZNF428","19",44111371,44124026,12655
"4967","ENSG00000131127","ZNF141","4",331603,378653,47050
"4968","ENSG00000131143","COX4I1","16",85832239,85840650,8411
"4969","ENSG00000131148","EMC8","16",85805364,85833214,27850
"4970","ENSG00000131149","GSE1","16",85645015,85709810,64795
"4971","ENSG00000131153","GINS2","16",85709804,85723679,13875
"4972","ENSG00000131165","CHMP1A","16",89710839,89724253,13414
"4973","ENSG00000131171","SH3BGRL","X",80457442,80554046,96604
"4974","ENSG00000131174","COX7B","X",77154935,77162870,7935
"4975","ENSG00000131188","PRR7","5",176873446,176883283,9837
"4976","ENSG00000131236","CAP1","1",40505905,40538321,32416
"4977","ENSG00000131238","PPT1","1",40538379,40563375,24996
"4978","ENSG00000131242","RAB11FIP4","17",29718642,29865236,146594
"4979","ENSG00000131263","RLIM","X",73805052,73834452,29400
"4980","ENSG00000131269","ABCB7","X",74273115,74376567,103452
"4981","ENSG00000131323","TRAF3","14",103243813,103377837,134024
"4982","ENSG00000131351","HAUS8","19",17160539,17186435,25896
"4983","ENSG00000131368","MRPS25","3",15083967,15106842,22875
"4984","ENSG00000131370","SH3BP5","3",15296360,15382875,86515
"4985","ENSG00000131373","HACL1","3",15602211,15643338,41127
"4986","ENSG00000131374","TBC1D5","3",17198654,18486309,1287655
"4987","ENSG00000131375","CAPN7","3",15247659,15294425,46766
"4988","ENSG00000131378","RFTN1","3",16355081,16555533,200452
"4989","ENSG00000131379","C3orf20","3",14716606,14814541,97935
"4990","ENSG00000131381","ZFYVE20","3",15111580,15140670,29090
"4991","ENSG00000131389","SLC6A6","3",14444076,14530857,86781
"4992","ENSG00000131408","NR1H2","19",50832910,50886239,53329
"4993","ENSG00000131409","LRRC4B","19",51020149,51071302,51153
"4994","ENSG00000131435","PDLIM4","5",131593364,131609147,15783
"4995","ENSG00000131437","KIF3A","5",132028320,132073330,45010
"4996","ENSG00000131446","MGAT1","5",180217541,180242652,25111
"4997","ENSG00000131459","GFPT2","5",179727690,179780387,52697
"4998","ENSG00000131462","TUBG1","17",40761694,40767252,5558
"4999","ENSG00000131467","PSME3","17",40976402,40995774,19372
"5000","ENSG00000131469","RPL27","17",41150290,41154976,4686
"5001","ENSG00000131470","PSMC3IP","17",40724333,40729849,5516
"5002","ENSG00000131473","ACLY","17",40023161,40086795,63634
"5003","ENSG00000131475","VPS25","17",40925454,40931617,6163
"5004","ENSG00000131480","AOC2","17",40996617,41002724,6107
"5005","ENSG00000131495","NDUFA2","5",140018325,140027370,9045
"5006","ENSG00000131503","ANKHD1","5",139781399,139929163,147764
"5007","ENSG00000131504","DIAPH1","5",140894583,140998622,104039
"5008","ENSG00000131507","NDFIP1","5",141488070,141534005,45935
"5009","ENSG00000131508","UBE2D2","5",138906016,139008018,102002
"5010","ENSG00000131558","EXOC4","7",132937829,133751342,813513
"5011","ENSG00000131584","ACAP3","1",1227756,1244989,17233
"5012","ENSG00000131591","C1orf159","1",1017198,1051741,34543
"5013","ENSG00000131626","PPFIA1","11",70116806,70230509,113703
"5014","ENSG00000131652","THOC6","16",3074028,3077756,3728
"5015","ENSG00000131653","TRAF7","16",2205699,2228130,22431
"5016","ENSG00000131669","NINJ1","9",95883771,95896570,12799
"5017","ENSG00000131697","NPHP4","1",5922871,6052533,129662
"5018","ENSG00000131711","MAP1B","5",71403061,71505395,102334
"5019","ENSG00000131724","IL13RA1","X",117861535,117928502,66967
"5020","ENSG00000131725","WDR44","X",117480036,117583924,103888
"5021","ENSG00000131732","ZCCHC9","5",80597409,80609116,11707
"5022","ENSG00000131747","TOP2A","17",38544768,38574202,29434
"5023","ENSG00000131748","STARD3","17",37793318,37819737,26419
"5024","ENSG00000131759","RARA","17",38465444,38513094,47650
"5025","ENSG00000131773","KHDRBS3","8",136469700,136668965,199265
"5026","ENSG00000131778","CHD1L","1",146714291,146767443,53152
"5027","ENSG00000131779","PEX11B","1",145516252,145523730,7478
"5028","ENSG00000131788","PIAS3","1",145575233,145586546,11313
"5029","ENSG00000131791","PRKAB2","1",146626685,146644129,17444
"5030","ENSG00000131795","RBM8A","1",145507598,145513536,5938
"5031","ENSG00000131797","CLUHP3","16",31711911,31721097,9186
"5032","ENSG00000131828","PDHA1","X",19362011,19379823,17812
"5033","ENSG00000131844","MCCC2","5",70883115,70954531,71416
"5034","ENSG00000131845","ZNF304","19",57862675,57871266,8591
"5035","ENSG00000131848","ZSCAN5A","19",56732681,56879752,147071
"5036","ENSG00000131849","ZNF132","19",58944181,58951589,7408
"5037","ENSG00000131871","VIMP","15",101811022,101817705,6683
"5038","ENSG00000131873","CHSY1","15",101715928,101792137,76209
"5039","ENSG00000131876","SNRPA1","15",101821715,101835487,13772
"5040","ENSG00000131899","LLGL1","17",18128901,18148189,19288
"5041","ENSG00000131914","LIN28A","1",26737269,26756213,18944
"5042","ENSG00000131931","THAP1","8",42691817,42698468,6651
"5043","ENSG00000131941","RHPN2","19",33469499,33555794,86295
"5044","ENSG00000131943","C19orf12","19",30191721,30206364,14643
"5045","ENSG00000131944","C19orf40","19",33463115,33469128,6013
"5046","ENSG00000131951","LRRC9","14",60386431,60530277,143846
"5047","ENSG00000131966","ACTR10","14",58666798,58701750,34952
"5048","ENSG00000131969","ABHD12B","14",51338878,51371688,32810
"5049","ENSG00000131979","GCH1","14",55308726,55369570,60844
"5050","ENSG00000131981","LGALS3","14",55590828,55612126,21298
"5051","ENSG00000132002","DNAJB1","19",14625582,14640582,15000
"5052","ENSG00000132003","ZSWIM4","19",13906274,13943044,36770
"5053","ENSG00000132004","FBXW9","19",12798867,12807457,8590
"5054","ENSG00000132005","RFX1","19",14072350,14117851,45501
"5055","ENSG00000132010","ZNF20","19",12203658,12251222,47564
"5056","ENSG00000132016","C19orf57","19",13993161,14017265,24104
"5057","ENSG00000132017","DCAF15","19",14063304,14072254,8950
"5058","ENSG00000132024","CC2D1A","19",14017014,14041692,24678
"5059","ENSG00000132031","MATN3","2",20191872,20212455,20583
"5060","ENSG00000132109","TRIM21","11",4406127,4414926,8799
"5061","ENSG00000132122","SPATA6","1",48761044,48937845,176801
"5062","ENSG00000132128","LRRC41","1",46726868,46769280,42412
"5063","ENSG00000132141","CCT6B","17",33254878,33308097,53219
"5064","ENSG00000132142","ACACA","17",35441923,35766909,324986
"5065","ENSG00000132153","DHX30","3",47844399,47891685,47286
"5066","ENSG00000132155","RAF1","3",12625100,12705725,80625
"5067","ENSG00000132182","NUP210","3",13357737,13461809,104072
"5068","ENSG00000132196","HSD17B7","1",162760492,162782607,22115
"5069","ENSG00000132199","ENOSF1","18",670324,712676,42352
"5070","ENSG00000132205","EMILIN2","18",2847028,2915991,68963
"5071","ENSG00000132254","ARFIP2","11",6496910,6502666,5756
"5072","ENSG00000132256","TRIM5","11",5684425,5959849,275424
"5073","ENSG00000132274","TRIM22","11",5710919,5758319,47400
"5074","ENSG00000132275","RRP8","11",6616305,6624850,8545
"5075","ENSG00000132286","TIMM10B","11",6502677,6505909,3232
"5076","ENSG00000132294","EFR3A","8",132916335,133025889,109554
"5077","ENSG00000132300","PTCD3","2",86333305,86369280,35975
"5078","ENSG00000132305","IMMT","2",86371055,86422893,51838
"5079","ENSG00000132313","MRPL35","2",86426478,86440917,14439
"5080","ENSG00000132321","IQCA1","2",237232794,237416185,183391
"5081","ENSG00000132323","ILKAP","2",239079042,239112370,33328
"5082","ENSG00000132326","PER2","2",239152679,239198743,46064
"5083","ENSG00000132330","SCLY","2",238969530,239008054,38524
"5084","ENSG00000132334","PTPRE","10",129705325,129884119,178794
"5085","ENSG00000132341","RAN","12",131356424,131362223,5799
"5086","ENSG00000132356","PRKAA1","5",40759481,40798476,38995
"5087","ENSG00000132357","CARD6","5",40841286,40860275,18989
"5088","ENSG00000132359","RAP1GAP2","17",2680350,2941033,260683
"5089","ENSG00000132361","CLUH","17",2592680,2615957,23277
"5090","ENSG00000132376","INPP5K","17",1397865,1420182,22317
"5091","ENSG00000132382","MYBBP1A","17",4442192,4458926,16734
"5092","ENSG00000132383","RPA1","17",1732996,1803376,70380
"5093","ENSG00000132386","SERPINF1","17",1665253,1680868,15615
"5094","ENSG00000132388","UBE2G1","17",4172554,4269923,97369
"5095","ENSG00000132394","EEFSEC","3",127872297,128127485,255188
"5096","ENSG00000132405","TBC1D14","4",6910969,7034845,123876
"5097","ENSG00000132406","TMEM128","4",4237269,4249950,12681
"5098","ENSG00000132423","COQ3","6",99817276,99842080,24804
"5099","ENSG00000132424","PNISR","6",99845927,99873207,27280
"5100","ENSG00000132429","POPDC3","6",105606155,105627870,21715
"5101","ENSG00000132432","SEC61G","7",54819943,54827667,7724
"5102","ENSG00000132434","LANCL2","7",55433141,55501435,68294
"5103","ENSG00000132436","FIGNL1","7",50511831,50518088,6257
"5104","ENSG00000132437","DDC","7",50526134,50633154,107020
"5105","ENSG00000132463","GRSF1","4",71681499,71705662,24163
"5106","ENSG00000132466","ANKRD17","4",73939093,74124515,185422
"5107","ENSG00000132467","UTP3","4",71554196,71556267,2071
"5108","ENSG00000132471","WBP2","17",73841780,73852588,10808
"5109","ENSG00000132475","H3F3B","17",73772515,73781974,9459
"5110","ENSG00000132478","UNK","17",73780681,73821886,41205
"5111","ENSG00000132485","ZRANB2","1",71528974,71546980,18006
"5112","ENSG00000132507","EIF5A","17",7210318,7215774,5456
"5113","ENSG00000132510","KDM6B","17",7743222,7758114,14892
"5114","ENSG00000132522","GPS2","17",7214643,7218883,4240
"5115","ENSG00000132535","DLG4","17",7093209,7123021,29812
"5116","ENSG00000132541","HRSP12","8",99114572,99129469,14897
"5117","ENSG00000132549","VPS13B","8",100025494,100889808,864314
"5118","ENSG00000132554","RGS22","8",100973164,101143496,170332
"5119","ENSG00000132561","MATN2","8",98881068,99048944,167876
"5120","ENSG00000132563","REEP2","5",137774706,137782658,7952
"5121","ENSG00000132570","PCBD2","5",134240596,134343649,103053
"5122","ENSG00000132581","SDF2","17",26975374,26989207,13833
"5123","ENSG00000132589","FLOT2","17",27206353,27224697,18344
"5124","ENSG00000132591","ERAL1","17",27181956,27188085,6129
"5125","ENSG00000132600","PRMT7","16",68344877,68392466,47589
"5126","ENSG00000132603","NIP7","16",69373333,69377014,3681
"5127","ENSG00000132604","TERF2","16",69389464,69442474,53010
"5128","ENSG00000132612","VPS4A","16",69345259,69358949,13690
"5129","ENSG00000132613","MTSS1L","16",70695107,70719969,24862
"5130","ENSG00000132623","ANKEF1","20",9966774,10037410,70636
"5131","ENSG00000132635","PCED1A","20",2815960,2821836,5876
"5132","ENSG00000132639","SNAP25","20",10199478,10288066,88588
"5133","ENSG00000132640","BTBD3","20",11871371,11907257,35886
"5134","ENSG00000132646","PCNA","20",5095599,5107272,11673
"5135","ENSG00000132661","NXT1","20",23331373,23335414,4041
"5136","ENSG00000132664","POLR3F","20",18447771,18465287,17516
"5137","ENSG00000132669","RIN2","20",19867165,19983101,115936
"5138","ENSG00000132670","PTPRA","20",2844830,3019722,174892
"5139","ENSG00000132676","DAP3","1",155657751,155708801,51050
"5140","ENSG00000132680","KIAA0907","1",155882834,155904191,21357
"5141","ENSG00000132688","NES","1",156638555,156647189,8634
"5142","ENSG00000132694","ARHGEF11","1",156904632,157015162,110530
"5143","ENSG00000132716","DCAF8","1",160185505,160254920,69415
"5144","ENSG00000132718","SYT11","1",155829300,155854990,25690
"5145","ENSG00000132740","IGHMBP2","11",68671310,68708070,36760
"5146","ENSG00000132749","MTL5","11",68474908,68519032,44124
"5147","ENSG00000132763","MMACHC","1",45965725,45976739,11014
"5148","ENSG00000132768","DPH2","1",44435672,44439041,3369
"5149","ENSG00000132773","TOE1","1",45805342,45809647,4305
"5150","ENSG00000132780","NASP","1",46049518,46084566,35048
"5151","ENSG00000132781","MUTYH","1",45794835,45806142,11307
"5152","ENSG00000132792","CTNNBL1","20",36322408,36500531,178123
"5153","ENSG00000132793","LPIN3","20",39969560,39989222,19662
"5154","ENSG00000132801","ZSWIM3","20",44486256,44507761,21505
"5155","ENSG00000132819","RBM38","20",55966463,55984389,17926
"5156","ENSG00000132821","VSTM2L","20",36531499,36573752,42253
"5157","ENSG00000132823","OSER1","20",42825136,42839431,14295
"5158","ENSG00000132824","SERINC3","20",43124862,43150750,25888
"5159","ENSG00000132825","PPP1R3D","20",58511894,58515352,3458
"5160","ENSG00000132842","AP3B1","5",77296349,77590579,294230
"5161","ENSG00000132846","ZBED3","5",76367897,76383148,15251
"5162","ENSG00000132849","INADL","1",62208149,62629592,421443
"5163","ENSG00000132854","KANK4","1",62702651,62785085,82434
"5164","ENSG00000132872","SYT4","18",40847843,40857615,9772
"5165","ENSG00000132879","FBXO44","1",11714432,11723384,8952
"5166","ENSG00000132881","RSG1","1",16558195,16563657,5462
"5167","ENSG00000132906","CASP9","1",15817327,15853029,35702
"5168","ENSG00000132912","DCTN4","5",150088002,150138671,50669
"5169","ENSG00000132932","ATP8A2","13",25946209,26599989,653780
"5170","ENSG00000132938","MTUS2","13",29598748,30077892,479144
"5171","ENSG00000132950","ZMYM5","13",20397622,20437776,40154
"5172","ENSG00000132952","USPL1","13",31191830,31233686,41856
"5173","ENSG00000132953","XPO4","13",21351469,21477187,125718
"5174","ENSG00000132963","POMP","13",29233241,29253062,19821
"5175","ENSG00000132964","CDK8","13",26828276,26979375,151099
"5176","ENSG00000132967","HMGB1P5","3",22423310,22424420,1110
"5177","ENSG00000132970","WASF3","13",27131840,27263085,131245
"5178","ENSG00000133019","CHRM3","1",239549865,240078750,528885
"5179","ENSG00000133026","MYH10","17",8377523,8534079,156556
"5180","ENSG00000133027","PEMT","17",17408877,17495022,86145
"5181","ENSG00000133028","SCO1","17",10583654,10601692,18038
"5182","ENSG00000133030","MPRIP","17",16945859,17120993,175134
"5183","ENSG00000133056","PIK3C2B","1",204391756,204463852,72096
"5184","ENSG00000133059","DSTYK","1",205111632,205180727,69095
"5185","ENSG00000133065","SLC41A1","1",205758221,205782876,24655
"5186","ENSG00000133069","TMCC2","1",205197304,205242471,45167
"5187","ENSG00000133083","DCLK1","13",36345478,36705443,359965
"5188","ENSG00000133101","CCNA1","13",37005967,37017019,11052
"5189","ENSG00000133103","COG6","13",40229764,40365802,136038
"5190","ENSG00000133104","SPG20","13",36875775,36944317,68542
"5191","ENSG00000133106","EPSTI1","13",43460524,43566407,105883
"5192","ENSG00000133107","TRPC4","13",38210773,38444562,233789
"5193","ENSG00000133110","POSTN","13",38136720,38172981,36261
"5194","ENSG00000133111","RFXAP","13",37393361,37403241,9880
"5195","ENSG00000133112","TPT1","13",45911008,45915505,4497
"5196","ENSG00000133114","GPALPP1","13",45563687,45607746,44059
"5197","ENSG00000133115","STOML3","13",39540062,39565203,25141
"5198","ENSG00000133116","KL","13",33590207,33640282,50075
"5199","ENSG00000133119","RFC3","13",34392186,34540695,148509
"5200","ENSG00000133121","STARD13","13",33677272,33924767,247495
"5201","ENSG00000133124","IRS4","X",107975712,107979651,3939
"5202","ENSG00000133131","MORC4","X",106057101,106243474,186373
"5203","ENSG00000133134","BEX2","X",102564274,102565974,1700
"5204","ENSG00000133138","TBC1D8B","X",106045910,106119375,73465
"5205","ENSG00000133142","TCEAL4","X",102831159,102842657,11498
"5206","ENSG00000133169","BEX1","X",102317579,102319168,1589
"5207","ENSG00000133193","FAM104A","17",71203492,71232892,29400
"5208","ENSG00000133195","SLC39A11","17",70642088,71088851,446763
"5209","ENSG00000133216","EPHB2","1",23037332,23241818,204486
"5210","ENSG00000133226","SRRM1","1",24958207,24999758,41551
"5211","ENSG00000133243","BTBD2","19",1985447,2034880,49433
"5212","ENSG00000133247","SUV420H2","19",55851221,55859488,8267
"5213","ENSG00000133250","ZNF414","19",8575462,8579048,3586
"5214","ENSG00000133256","PDE6B","4",619373,664571,45198
"5215","ENSG00000133265","HSPBP1","19",55773599,55791749,18150
"5216","ENSG00000133275","CSNK1G2","19",1941188,1981337,40149
"5217","ENSG00000133302","ANKRD32","5",93954052,94075141,121089
"5218","ENSG00000133313","CNDP2","18",72163051,72188366,25315
"5219","ENSG00000133315","MACROD1","11",63766030,63933578,167548
"5220","ENSG00000133316","WDR74","11",62599814,62609281,9467
"5221","ENSG00000133318","RTN3","11",63448918,63527363,78445
"5222","ENSG00000133393","FOPNL","16",15959577,15982482,22905
"5223","ENSG00000133398","MED10","5",6371994,6378707,6713
"5224","ENSG00000133401","PDZD2","5",31639517,32111037,471520
"5225","ENSG00000133422","MORC2","22",31321117,31364284,43167
"5226","ENSG00000133424","LARGE","22",33558212,34318829,760617
"5227","ENSG00000133460","SLC2A11","22",24198890,24228496,29606
"5228","ENSG00000133466","C1QTNF6","22",37576207,37595425,19218
"5229","ENSG00000133597","ADCK2","7",140372953,140396061,23108
"5230","ENSG00000133606","MKRN1","7",140152840,140179369,26529
"5231","ENSG00000133612","AGAP3","7",150782918,150841523,58605
"5232","ENSG00000133619","KRBA1","7",149411872,149431664,19792
"5233","ENSG00000133624","ZNF767","7",149244245,149321843,77598
"5234","ENSG00000133627","ACTR3B","7",152456834,152552463,95629
"5235","ENSG00000133639","BTG1","12",92536286,92539673,3387
"5236","ENSG00000133640","LRRIQ1","12",85430092,85657002,226910
"5237","ENSG00000133641","C12orf29","12",88427623,88443937,16314
"5238","ENSG00000133657","ATP13A3","3",194123401,194219093,95692
"5239","ENSG00000133678","TMEM254","10",81838402,81852313,13911
"5240","ENSG00000133687","TMTC1","12",29653773,29937692,283919
"5241","ENSG00000133703","KRAS","12",25357723,25403870,46147
"5242","ENSG00000133704","IPO8","12",30781922,30848920,66998
"5243","ENSG00000133706","LARS","5",145492601,145562223,69622
"5244","ENSG00000133710","SPINK5","5",147405246,147516852,111606
"5245","ENSG00000133731","IMPA1","8",82570196,82598928,28732
"5246","ENSG00000133739","LRRCC1","8",86019382,86058311,38929
"5247","ENSG00000133740","E2F5","8",86089460,86129387,39927
"5248","ENSG00000133773","CCDC59","12",82617460,82752584,135124
"5249","ENSG00000133789","SWAP70","11",9685624,9774538,88914
"5250","ENSG00000133794","ARNTL","11",13298199,13408813,110614
"5251","ENSG00000133805","AMPD3","11",10329860,10529126,199266
"5252","ENSG00000133812","SBF2","11",9800214,10315754,515540
"5253","ENSG00000133816","MICAL2","11",12115543,12285334,169791
"5254","ENSG00000133818","RRAS2","11",14299472,14386052,86580
"5255","ENSG00000133835","HSD17B4","5",118788138,118972894,184756
"5256","ENSG00000133858","ZFC3H1","12",72003252,72061505,58253
"5257","ENSG00000133863","TEX15","8",30689060,30748122,59062
"5258","ENSG00000133872","TMEM66","8",29920528,29940723,20195
"5259","ENSG00000133874","RNF122","8",33405273,33424643,19370
"5260","ENSG00000133878","DUSP26","8",33448856,33457624,8768
"5261","ENSG00000133884","DPF2","11",65101225,65120720,19495
"5262","ENSG00000133895","MEN1","11",64570982,64578766,7784
"5263","ENSG00000133935","C14orf1","14",76116134,76127532,11398
"5264","ENSG00000133943","C14orf159","14",91526677,91691976,165299
"5265","ENSG00000133958","UNC79","14",93799565,94174222,374657
"5266","ENSG00000133961","NUMB","14",73741815,73930348,188533
"5267","ENSG00000133983","COX16","14",70791798,70826448,34650
"5268","ENSG00000133985","TTC9","14",71108504,71142077,33573
"5269","ENSG00000133997","MED6","14",71047974,71067384,19410
"5270","ENSG00000134001","EIF2S1","14",67826714,67853233,26519
"5271","ENSG00000134007","ADAM20","14",70989075,71001732,12657
"5272","ENSG00000134013","LOXL2","8",23154702,23282841,128139
"5273","ENSG00000134014","ELP3","8",27947190,28048673,101483
"5274","ENSG00000134030","CTIF","18",46065417,46389588,324171
"5275","ENSG00000134046","MBD2","18",51679079,51751158,72079
"5276","ENSG00000134049","IER3IP1","18",44681413,44702745,21332
"5277","ENSG00000134056","MRPS36","5",68513587,68525956,12369
"5278","ENSG00000134057","CCNB1","5",68462837,68474072,11235
"5279","ENSG00000134058","CDK7","5",68530668,68573250,42582
"5280","ENSG00000134072","CAMK1","3",9799026,9811676,12650
"5281","ENSG00000134077","THUMPD3","3",9404526,9428475,23949
"5282","ENSG00000134086","VHL","3",10182692,10193904,11212
"5283","ENSG00000134107","BHLHE40","3",5020801,5027008,6207
"5284","ENSG00000134108","ARL8B","3",5163905,5222596,58691
"5285","ENSG00000134109","EDEM1","3",5229331,5261642,32311
"5286","ENSG00000134138","MEIS2","15",37181406,37393504,212098
"5287","ENSG00000134146","DPH6","15",35509546,35838394,328848
"5288","ENSG00000134152","KATNBL1","15",34432875,34502297,69422
"5289","ENSG00000134153","EMC7","15",34376218,34394149,17931
"5290","ENSG00000134186","PRPF38B","1",109234945,109244425,9480
"5291","ENSG00000134198","TSPAN2","1",115590632,115632121,41489
"5292","ENSG00000134202","GSTM3","1",110276554,110284384,7830
"5293","ENSG00000134207","SYT6","1",114631913,114696541,64628
"5294","ENSG00000134215","VAV3","1",108113782,108507766,393984
"5295","ENSG00000134222","PSRC1","1",109822178,109825808,3630
"5296","ENSG00000134243","SORT1","1",109852192,109940573,88381
"5297","ENSG00000134245","WNT2B","1",113009163,113072787,63624
"5298","ENSG00000134247","PTGFRN","1",117452679,117532980,80301
"5299","ENSG00000134248","LAMTOR5","1",110943871,110950564,6693
"5300","ENSG00000134250","NOTCH2","1",120454176,120612240,158064
"5301","ENSG00000134253","TRIM45","1",117653682,117665209,11527
"5302","ENSG00000134255","CEPT1","1",111682249,111727724,45475
"5303","ENSG00000134256","CD101","1",117544382,117579167,34785
"5304","ENSG00000134258","VTCN1","1",117686209,117753556,67347
"5305","ENSG00000134262","AP4B1","1",114437370,114447823,10453
"5306","ENSG00000134265","NAPG","18",10525902,10552758,26856
"5307","ENSG00000134278","SPIRE1","18",12446511,12658133,211622
"5308","ENSG00000134283","PPHLN1","12",42632249,42853517,221268
"5309","ENSG00000134285","FKBP11","12",49315301,49320257,4956
"5310","ENSG00000134287","ARF3","12",49329506,49351334,21828
"5311","ENSG00000134291","TMEM106C","12",48357352,48362661,5309
"5312","ENSG00000134294","SLC38A2","12",46751972,46766650,14678
"5313","ENSG00000134297","PLEKHA8P1","12",45566847,45609824,42977
"5314","ENSG00000134308","YWHAQ","2",9724101,9771143,47042
"5315","ENSG00000134313","KIDINS220","2",8865408,8977760,112352
"5316","ENSG00000134317","GRHL1","2",10085341,10142411,57070
"5317","ENSG00000134318","ROCK2","2",11319887,11488456,168569
"5318","ENSG00000134323","MYCN","2",16080686,16087129,6443
"5319","ENSG00000134324","LPIN1","2",11817721,11967535,149814
"5320","ENSG00000134330","IAH1","2",9613787,9636672,22885
"5321","ENSG00000134333","LDHA","11",18415935,18429972,14037
"5322","ENSG00000134343","ANO3","11",26210829,26684835,474006
"5323","ENSG00000134352","IL6ST","5",55230923,55290821,59898
"5324","ENSG00000134363","FST","5",52776239,52782964,6725
"5325","ENSG00000134369","NAV1","1",201592411,201796102,203691
"5326","ENSG00000134371","CDC73","1",193091147,193223031,131884
"5327","ENSG00000134375","TIMM17A","1",201924619,201939789,15170
"5328","ENSG00000134376","CRB1","1",197170592,197447585,276993
"5329","ENSG00000134419","RPS15A","16",18792617,18801705,9088
"5330","ENSG00000134440","NARS","18",55267888,55289445,21557
"5331","ENSG00000134444","KIAA1468","18",59854491,59974355,119864
"5332","ENSG00000134452","FBXO18","10",5931535,5979556,48021
"5333","ENSG00000134453","RBM17","10",6130950,6159420,28470
"5334","ENSG00000134461","ANKRD16","10",5903580,5931869,28289
"5335","ENSG00000134463","ECHDC3","10",11784365,11806069,21704
"5336","ENSG00000134480","CCNH","5",86687311,86708836,21525
"5337","ENSG00000134490","TMEM241","18",20777108,21017925,240817
"5338","ENSG00000134504","KCTD1","18",24034874,24237365,202491
"5339","ENSG00000134508","CABLES1","18",20714528,20840431,125903
"5340","ENSG00000134516","DOCK2","5",169064251,169510386,446135
"5341","ENSG00000134531","EMP1","12",13349650,13369708,20058
"5342","ENSG00000134532","SOX5","12",23682440,24103966,421526
"5343","ENSG00000134569","LRP4","11",46878419,46940193,61774
"5344","ENSG00000134574","DDB2","11",47236493,47260767,24274
"5345","ENSG00000134575","ACP2","11",47260853,47270457,9604
"5346","ENSG00000134590","FAM127A","X",134166333,134167576,1243
"5347","ENSG00000134594","RAB33A","X",129305623,129318844,13221
"5348","ENSG00000134595","SOX3","X",139585152,139587225,2073
"5349","ENSG00000134597","RBMX2","X",129535943,129547317,11374
"5350","ENSG00000134602","","X",131157293,131209971,52678
"5351","ENSG00000134644","PUM1","1",31404353,31538838,134485
"5352","ENSG00000134684","YARS","1",33240840,33283754,42914
"5353","ENSG00000134686","PHC2","1",33789224,33896653,107429
"5354","ENSG00000134690","CDCA8","1",38158090,38175391,17301
"5355","ENSG00000134697","GNL2","1",38032417,38061536,29119
"5356","ENSG00000134698","AGO4","1",36273773,36323491,49718
"5357","ENSG00000134709","HOOK1","1",60280458,60342050,61592
"5358","ENSG00000134716","CYP2J2","1",60358980,60392462,33482
"5359","ENSG00000134717","BTF3L4","1",52521797,52556388,34591
"5360","ENSG00000134744","ZCCHC11","1",52873954,53019159,145205
"5361","ENSG00000134748","PRPF38A","1",52870236,52886511,16275
"5362","ENSG00000134755","DSC2","18",28645940,28682378,36438
"5363","ENSG00000134758","RNF138","18",29671818,29711524,39706
"5364","ENSG00000134759","ELP2","18",33709407,33757909,48502
"5365","ENSG00000134762","DSC3","18",28569974,28622781,52807
"5366","ENSG00000134769","DTNA","18",32073254,32471808,398554
"5367","ENSG00000134775","FHOD3","18",33877677,34360018,482341
"5368","ENSG00000134779","TPGS2","18",34359987,34409158,49171
"5369","ENSG00000134780","DAGLA","11",61447905,61514473,66568
"5370","ENSG00000134802","SLC43A3","11",57174427,57195053,20626
"5371","ENSG00000134809","TIMM10","11",57295936,57298276,2340
"5372","ENSG00000134815","DHX34","19",47852538,47885961,33423
"5373","ENSG00000134824","FADS2","11",61560452,61634826,74374
"5374","ENSG00000134825","TMEM258","11",61535973,61560274,24301
"5375","ENSG00000134851","TMEM165","4",56262124,56319564,57440
"5376","ENSG00000134852","CLOCK","4",56294070,56413305,119235
"5377","ENSG00000134853","PDGFRA","4",55095264,55164414,69150
"5378","ENSG00000134864","GGACT","13",101183810,101241782,57972
"5379","ENSG00000134871","COL4A2","13",110958159,111165374,207215
"5380","ENSG00000134873","CLDN10","13",96085858,96232013,146155
"5381","ENSG00000134874","DZIP1","13",96230457,96296957,66500
"5382","ENSG00000134882","UBAC2","13",99853028,100038688,185660
"5383","ENSG00000134884","ARGLU1","13",107194021,107220512,26491
"5384","ENSG00000134897","BIVM","13",103451399,103493885,42486
"5385","ENSG00000134899","ERCC5","13",103497194,103528345,31151
"5386","ENSG00000134900","TPP2","13",103249353,103331521,82168
"5387","ENSG00000134901","KDELC1","13",103436631,103451357,14726
"5388","ENSG00000134905","CARS2","13",111293759,111365950,72191
"5389","ENSG00000134909","ARHGAP32","11",128834955,129149219,314264
"5390","ENSG00000134910","STT3A","11",125461607,125495110,33503
"5391","ENSG00000134954","ETS1","11",128328656,128457453,128797
"5392","ENSG00000134955","SLC37A2","11",124932963,124959131,26168
"5393","ENSG00000134970","TMED7","5",114949205,114968689,19484
"5394","ENSG00000134982","APC","5",112043195,112181936,138741
"5395","ENSG00000134986","NREP","5",110998318,111333161,334843
"5396","ENSG00000134987","WDR36","5",110427414,110466200,38786
"5397","ENSG00000134996","OSTF1","9",77703459,77762181,58722
"5398","ENSG00000135002","RFK","9",79000433,79009433,9000
"5399","ENSG00000135018","UBQLN1","9",86274878,86323118,48240
"5400","ENSG00000135040","NAA35","9",88556061,88637213,81152
"5401","ENSG00000135045","C9orf40","9",77561497,77567802,6305
"5402","ENSG00000135046","ANXA1","9",75766673,75785309,18636
"5403","ENSG00000135047","CTSL","9",90340434,90346308,5874
"5404","ENSG00000135048","TMEM2","9",74298282,74431606,133324
"5405","ENSG00000135049","AGTPBP1","9",88161455,88356944,195489
"5406","ENSG00000135052","GOLM1","9",88641061,88715088,74027
"5407","ENSG00000135063","FAM189A2","9",71939488,72007371,67883
"5408","ENSG00000135069","PSAT1","9",80912059,80945009,32950
"5409","ENSG00000135070","ISCA1","9",88879461,88897676,18215
"5410","ENSG00000135074","ADAM19","5",156822542,157002783,180241
"5411","ENSG00000135077","HAVCR2","5",156512843,156569880,57037
"5412","ENSG00000135083","CCNJL","5",159678659,159772403,93744
"5413","ENSG00000135090","TAOK3","12",118587606,118810750,223144
"5414","ENSG00000135093","USP30","12",109460894,109525831,64937
"5415","ENSG00000135097","MSI1","12",120779133,120806983,27850
"5416","ENSG00000135108","FBXO21","12",117581146,117628336,47190
"5417","ENSG00000135116","HRK","12",117293949,117319246,25297
"5418","ENSG00000135119","RNFT2","12",117176096,117291436,115340
"5419","ENSG00000135124","P2RX4","12",121647660,121671909,24249
"5420","ENSG00000135127","CCDC64","12",120427673,120532298,104625
"5421","ENSG00000135148","TRAFD1","12",112563305,112591407,28102
"5422","ENSG00000135164","DMTF1","7",86781677,86825653,43976
"5423","ENSG00000135185","TMEM243","7",86825478,86849903,24425
"5424","ENSG00000135205","CCDC146","7",76751751,76958850,207099
"5425","ENSG00000135211","TMEM60","7",77423045,77427897,4852
"5426","ENSG00000135213","POM121C","7",75046066,75115548,69482
"5427","ENSG00000135218","CD36","7",79998891,80308593,309702
"5428","ENSG00000135241","PNPLA8","7",108110866,108210110,99244
"5429","ENSG00000135245","HILPDA","7",128095903,128098472,2569
"5430","ENSG00000135249","RINT1","7",105172532,105208124,35592
"5431","ENSG00000135250","SRPK2","7",104751151,105039755,288604
"5432","ENSG00000135269","TES","7",115850547,115898837,48290
"5433","ENSG00000135272","MDFIC","7",114562209,114659256,97047
"5434","ENSG00000135297","MTO1","6",74171301,74218959,47658
"5435","ENSG00000135298","BAI3","6",69345259,70099403,754144
"5436","ENSG00000135299","ANKRD6","6",90142889,90343553,200664
"5437","ENSG00000135314","KHDC1","6",73951037,74020088,69051
"5438","ENSG00000135315","KIAA1009","6",84833960,84937353,103393
"5439","ENSG00000135316","SYNCRIP","6",86318053,86353510,35457
"5440","ENSG00000135317","SNX14","6",86215214,86303874,88660
"5441","ENSG00000135318","NT5E","6",86159809,86205500,45691
"5442","ENSG00000135324","MRAP2","6",84743475,84800600,57125
"5443","ENSG00000135333","EPHA7","6",93949738,94129265,179527
"5444","ENSG00000135334","AKIRIN2","6",88384790,88411927,27137
"5445","ENSG00000135336","ORC3","6",88299839,88377169,77330
"5446","ENSG00000135338","LCA5","6",80194708,80247175,52467
"5447","ENSG00000135341","MAP3K7","6",91223292,91296764,73472
"5448","ENSG00000135362","PRR5L","11",36317838,36486754,168916
"5449","ENSG00000135365","PHF21A","11",45950871,46142985,192114
"5450","ENSG00000135372","NAT10","11",34127149,34169217,42068
"5451","ENSG00000135387","CAPRIN1","11",34073230,34122703,49473
"5452","ENSG00000135390","ATP5G2","12",54026510,54071192,44682
"5453","ENSG00000135392","DNAJC14","12",56214744,56224608,9864
"5454","ENSG00000135404","CD63","12",56119107,56123491,4384
"5455","ENSG00000135407","AVIL","12",58191159,58212487,21328
"5456","ENSG00000135414","GDF11","12",56137064,56150911,13847
"5457","ENSG00000135424","ITGA7","12",56078352,56109827,31475
"5458","ENSG00000135437","RDH5","12",56114151,56118489,4338
"5459","ENSG00000135439","AGAP2","12",58118980,58135940,16960
"5460","ENSG00000135441","BLOC1S1","12",56109820,56113871,4051
"5461","ENSG00000135446","CDK4","12",58141510,58149796,8286
"5462","ENSG00000135447","PPP1R1A","12",54969171,54982443,13272
"5463","ENSG00000135451","TROAP","12",49717019,49725514,8495
"5464","ENSG00000135452","TSPAN31","12",58131796,58143994,12198
"5465","ENSG00000135454","B4GALNT1","12",58017193,58027138,9945
"5466","ENSG00000135457","TFCP2","12",51487446,51566926,79480
"5467","ENSG00000135469","COQ10A","12",56660642,56664750,4108
"5468","ENSG00000135472","FAIM2","12",50260679,50298000,37321
"5469","ENSG00000135473","PAN2","12",56710007,56727837,17830
"5470","ENSG00000135476","ESPL1","12",53662083,53687427,25344
"5471","ENSG00000135482","ZC3H10","12",56511943,56516278,4335
"5472","ENSG00000135486","HNRNPA1","12",54673977,54680872,6895
"5473","ENSG00000135502","SLC26A10","12",58013310,58019934,6624
"5474","ENSG00000135503","ACVR1B","12",52345451,52390862,45411
"5475","ENSG00000135506","OS9","12",58087738,58115340,27602
"5476","ENSG00000135521","LTV1","6",144164481,144184949,20468
"5477","ENSG00000135525","MAP7","6",136663875,136871957,208082
"5478","ENSG00000135535","CD164","6",109687717,109703762,16045
"5479","ENSG00000135537","LACE1","6",108616098,108847999,231901
"5480","ENSG00000135540","NHSL1","6",138743180,139013708,270528
"5481","ENSG00000135541","AHI1","6",135604670,135818914,214244
"5482","ENSG00000135549","PKIB","6",122793076,123047518,254442
"5483","ENSG00000135587","SMPD2","6",109761966,109765122,3156
"5484","ENSG00000135596","MICAL1","6",109765265,109787171,21906
"5485","ENSG00000135597","REPS1","6",139224630,139309398,84768
"5486","ENSG00000135617","PRADC1","2",73455134,73460366,5232
"5487","ENSG00000135622","SEMA4F","2",74881355,74909186,27831
"5488","ENSG00000135624","CCT7","2",73460548,73480149,19601
"5489","ENSG00000135631","RAB11FIP5","2",73300510,73383849,83339
"5490","ENSG00000135632","SMYD5","2",73441350,73454365,13015
"5491","ENSG00000135636","DYSF","2",71680852,71913898,233046
"5492","ENSG00000135637","CCDC142","2",74699113,74710535,11422
"5493","ENSG00000135643","KCNMB4","12",70760056,70828072,68016
"5494","ENSG00000135655","USP15","12",62654119,62811211,157092
"5495","ENSG00000135677","GNS","12",65107225,65153227,46002
"5496","ENSG00000135679","MDM2","12",69201956,69239214,37258
"5497","ENSG00000135686","KLHL36","16",84682131,84701292,19161
"5498","ENSG00000135697","BCMO1","16",81272053,81324747,52694
"5499","ENSG00000135698","MPHOSPH6","16",82181403,82203831,22428
"5500","ENSG00000135709","KIAA0513","16",85061375,85127836,66461
"5501","ENSG00000135720","DYNC1LI2","16",66754796,66785701,30905
"5502","ENSG00000135723","FHOD1","16",67263290,67281561,18271
"5503","ENSG00000135736","CCDC102A","16",57546090,57570511,24421
"5504","ENSG00000135740","SLC9A5","16",67271586,67306093,34507
"5505","ENSG00000135747","ZNF670","1",247108849,247242113,133264
"5506","ENSG00000135749","PCNXL2","1",233119181,233431459,312278
"5507","ENSG00000135763","URB2","1",229761981,229795946,33965
"5508","ENSG00000135766","EGLN1","1",231499497,231560790,61293
"5509","ENSG00000135773","CAPN9","1",230883130,230937749,54619
"5510","ENSG00000135775","COG2","1",230778235,230829728,51493
"5511","ENSG00000135776","ABCB10","1",229652329,229694442,42113
"5512","ENSG00000135778","NTPCR","1",233086351,233119628,33277
"5513","ENSG00000135801","TAF5L","1",229728858,229761794,32936
"5514","ENSG00000135821","GLUL","1",182350839,182361341,10502
"5515","ENSG00000135823","STX6","1",180941861,180992047,50186
"5516","ENSG00000135824","RGS8","1",182615239,182653711,38472
"5517","ENSG00000135828","RNASEL","1",182542769,182558391,15622
"5518","ENSG00000135829","DHX9","1",182808504,182856886,48382
"5519","ENSG00000135835","KIAA1614","1",180882290,180920750,38460
"5520","ENSG00000135837","CEP350","1",179923873,180084015,160142
"5521","ENSG00000135838","NPL","1",182758428,182799519,41091
"5522","ENSG00000135842","FAM129A","1",184759858,184943682,183824
"5523","ENSG00000135845","PIGC","1",172339329,172413230,73901
"5524","ENSG00000135847","ACBD6","1",180244515,180472089,227574
"5525","ENSG00000135862","LAMC1","1",182992595,183114727,122132
"5526","ENSG00000135870","RC3H1","1",173900352,173991435,91083
"5527","ENSG00000135899","SP110","2",231032009,231090444,58435
"5528","ENSG00000135900","MRPL44","2",224822121,224832431,10310
"5529","ENSG00000135903","PAX3","2",223064607,223163715,99108
"5530","ENSG00000135905","DOCK10","2",225629807,225907162,277355
"5531","ENSG00000135912","TTLL4","2",219575568,219620139,44571
"5532","ENSG00000135913","USP37","2",219314974,219433084,118110
"5533","ENSG00000135916","ITM2C","2",231729354,231743963,14609
"5534","ENSG00000135919","SERPINE2","2",224839829,224904036,64207
"5535","ENSG00000135924","DNAJB2","2",220143989,220151622,7633
"5536","ENSG00000135926","TMBIM1","2",219138915,219157309,18394
"5537","ENSG00000135929","CYP27A1","2",219646472,219680016,33544
"5538","ENSG00000135930","EIF4E2","2",233414762,233448354,33592
"5539","ENSG00000135931","ARMC9","2",232063260,232239548,176288
"5540","ENSG00000135932","CAB39","2",231577560,231685790,108230
"5541","ENSG00000135940","COX5B","2",98262503,98264846,2343
"5542","ENSG00000135945","REV1","2",100016938,100106497,89559
"5543","ENSG00000135951","TSGA10","2",99613724,99771427,157703
"5544","ENSG00000135953","MFSD9","2",103332299,103353347,21048
"5545","ENSG00000135956","TMEM127","2",96914254,96931732,17478
"5546","ENSG00000135966","TGFBRAP1","2",105880871,105946491,65620
"5547","ENSG00000135968","GCC2","2",109065017,109125871,60854
"5548","ENSG00000135972","MRPS9","2",105654441,105716418,61977
"5549","ENSG00000135974","C2orf49","2",105953816,105965668,11852
"5550","ENSG00000135976","ANKRD36","2",97779233,97930258,151025
"5551","ENSG00000135999","EPC2","2",149402009,149545130,143121
"5552","ENSG00000136002","ARHGEF4","2",131594489,131804836,210347
"5553","ENSG00000136003","ISCU","12",108956358,108963160,6802
"5554","ENSG00000136010","ALDH1L2","12",105413568,105478355,64787
"5555","ENSG00000136014","USP44","12",95910336,95945266,34930
"5556","ENSG00000136021","SCYL2","12",100660918,100735502,74584
"5557","ENSG00000136026","CKAP4","12",106631655,106698057,66402
"5558","ENSG00000136040","PLXNC1","12",94542499,94701451,158952
"5559","ENSG00000136044","APPL2","12",105567074,105630016,62942
"5560","ENSG00000136045","PWP1","12",108079509,108106944,27435
"5561","ENSG00000136048","DRAM1","12",102271129,102405908,134779
"5562","ENSG00000136051","KIAA1033","12",105501102,105562912,61810
"5563","ENSG00000136052","SLC41A2","12",105196331,105352522,156191
"5564","ENSG00000136059","VILL","3",38029550,38048679,19129
"5565","ENSG00000136068","FLNB","3",57994127,58157982,163855
"5566","ENSG00000136098","NEK3","13",52706775,52733996,27221
"5567","ENSG00000136099","PCDH8","13",53418109,53422775,4666
"5568","ENSG00000136100","VPS36","13",52986737,53024763,38026
"5569","ENSG00000136104","RNASEH2B","13",51483814,51544592,60778
"5570","ENSG00000136108","CKAP2","13",53029564,53050763,21199
"5571","ENSG00000136110","LECT1","13",53277399,53313947,36548
"5572","ENSG00000136111","TBC1D4","13",75858808,76056250,197442
"5573","ENSG00000136114","THSD1","13",52951305,52980629,29324
"5574","ENSG00000136122","BORA","13",73302061,73330336,28275
"5575","ENSG00000136141","LRCH1","13",47127303,47327175,199872
"5576","ENSG00000136143","SUCLA2","13",48510622,48612125,101503
"5577","ENSG00000136144","RCBTB1","13",50106082,50159719,53637
"5578","ENSG00000136146","MED4","13",48627459,48669267,41808
"5579","ENSG00000136147","PHF11","13",50069746,50103123,33377
"5580","ENSG00000136152","COG3","13",46039060,46110765,71705
"5581","ENSG00000136153","LMO7","13",76194570,76434004,239434
"5582","ENSG00000136156","ITM2B","13",48807294,48837063,29769
"5583","ENSG00000136158","SPRY2","13",80910111,80915086,4975
"5584","ENSG00000136159","NUDT15","13",48611703,48621358,9655
"5585","ENSG00000136160","EDNRB","13",78469616,78493903,24287
"5586","ENSG00000136161","RCBTB2","13",49063095,49107369,44274
"5587","ENSG00000136167","LCP1","13",46700055,46786006,85951
"5588","ENSG00000136169","SETDB2","13",50018429,50069138,50709
"5589","ENSG00000136193","SCRN1","7",29959719,30029905,70186
"5590","ENSG00000136197","C7orf25","7",42948325,42951904,3579
"5591","ENSG00000136205","TNS3","7",47314752,47622156,307404
"5592","ENSG00000136213","CHST12","7",2443223,2474242,31019
"5593","ENSG00000136231","IGF2BP3","7",23349828,23510086,160258
"5594","ENSG00000136237","RAPGEF5","7",22157856,22396763,238907
"5595","ENSG00000136238","RAC1","7",6414154,6443608,29454
"5596","ENSG00000136240","KDELR2","7",6485584,6523873,38289
"5597","ENSG00000136243","NUPL2","7",23221446,23240630,19184
"5598","ENSG00000136247","ZDHHC4","7",6617065,6629005,11940
"5599","ENSG00000136261","BZW2","7",16685756,16746148,60392
"5600","ENSG00000136267","DGKB","7",14184674,15014402,829728
"5601","ENSG00000136270","TBRG4","7",45139699,45151646,11947
"5602","ENSG00000136271","DDX56","7",44605016,44614650,9634
"5603","ENSG00000136273","HUS1","7",47735328,48019178,283850
"5604","ENSG00000136274","NACAD","7",45120037,45128513,8476
"5605","ENSG00000136279","DBNL","7",44084239,44109055,24816
"5606","ENSG00000136280","CCM2","7",45039074,45116068,76994
"5607","ENSG00000136295","TTYH3","7",2671585,2704436,32851
"5608","ENSG00000136319","TTC5","14",20724717,20774153,49436
"5609","ENSG00000136367","ZFHX2","14",23990066,24025401,35335
"5610","ENSG00000136371","MTHFS","15",80125927,80189721,63794
"5611","ENSG00000136378","ADAMTS7","15",79051545,79103773,52228
"5612","ENSG00000136379","ABHD17C","15",80972025,81047962,75937
"5613","ENSG00000136381","IREB2","15",78729773,78793798,64025
"5614","ENSG00000136383","ALPK3","15",85359911,85416713,56802
"5615","ENSG00000136425","CIB2","15",78396948,78423886,26938
"5616","ENSG00000136436","CALCOCO2","17",46908350,46943884,35534
"5617","ENSG00000136444","RSAD1","17",48556161,48563336,7175
"5618","ENSG00000136448","NMT1","17",43128978,43186384,57406
"5619","ENSG00000136450","SRSF1","17",56080721,56084707,3986
"5620","ENSG00000136451","VEZF1","17",56048910,56065620,16710
"5621","ENSG00000136463","TACO1","17",61678231,61685725,7494
"5622","ENSG00000136478","TEX2","17",62224587,62340661,116074
"5623","ENSG00000136485","DCAF7","17",61627822,61671639,43817
"5624","ENSG00000136490","LIMD2","17",61773262,61778532,5270
"5625","ENSG00000136492","BRIP1","17",59758627,59940882,182255
"5626","ENSG00000136504","KAT7","17",47865917,47906458,40541
"5627","ENSG00000136518","ACTL6A","3",179280668,179306196,25528
"5628","ENSG00000136521","NDUFB5","3",179322478,179345435,22957
"5629","ENSG00000136522","MRPL47","3",179306073,179322442,16369
"5630","ENSG00000136527","TRA2B","3",185633694,185655924,22230
"5631","ENSG00000136531","SCN2A","2",166095912,166248818,152906
"5632","ENSG00000136536","MARCH7","2",160569000,160627538,58538
"5633","ENSG00000136542","GALNT5","2",158114110,158170723,56613
"5634","ENSG00000136546","SCN7A","2",167260083,167350757,90674
"5635","ENSG00000136560","TANK","2",161993419,162092732,99313
"5636","ENSG00000136603","SKIL","3",170075466,170114623,39157
"5637","ENSG00000136628","EPRS","1",220141943,220220000,78057
"5638","ENSG00000136631","VPS45","1",150039369,150117505,78136
"5639","ENSG00000136636","KCTD3","1",215740735,215795149,54414
"5640","ENSG00000136643","RPS6KC1","1",213224589,213448116,223527
"5641","ENSG00000136653","RASSF5","1",206680879,206762616,81737
"5642","ENSG00000136682","CBWD2","2",114195268,114253766,58498
"5643","ENSG00000136699","SMPD4","2",130908981,130940323,31342
"5644","ENSG00000136709","WDR33","2",128458596,128568761,110165
"5645","ENSG00000136710","CCDC115","2",131095814,131099922,4108
"5646","ENSG00000136715","SAP130","2",128698791,128785694,86903
"5647","ENSG00000136717","BIN1","2",127805603,127864931,59328
"5648","ENSG00000136718","IMP4","2",131099798,131105383,5585
"5649","ENSG00000136720","HS6ST1","2",128994290,129076151,81861
"5650","ENSG00000136731","UGGT1","2",128848774,128953251,104477
"5651","ENSG00000136732","GYPC","2",127413509,127454246,40737
"5652","ENSG00000136738","STAM","10",17686124,17757913,71789
"5653","ENSG00000136754","ABI1","10",27035522,27150016,114494
"5654","ENSG00000136758","YME1L1","10",27399383,27444195,44812
"5655","ENSG00000136770","DNAJC1","10",22045466,22292698,247232
"5656","ENSG00000136783","NIPSNAP3A","9",107509969,107522403,12434
"5657","ENSG00000136802","LRRC8A","9",131644391,131680318,35927
"5658","ENSG00000136807","CDK9","9",130547958,130553066,5108
"5659","ENSG00000136810","TXN","9",113006091,113018920,12829
"5660","ENSG00000136811","ODF2","9",131217465,131263571,46106
"5661","ENSG00000136813","KIAA0368","9",114122972,114247025,124053
"5662","ENSG00000136816","TOR1B","9",132565432,132573560,8128
"5663","ENSG00000136819","C9orf78","9",132589569,132598142,8573
"5664","ENSG00000136824","SMC2","9",106856541,106903698,47157
"5665","ENSG00000136826","KLF4","9",110247133,110252763,5630
"5666","ENSG00000136827","TOR1A","9",132575223,132586413,11190
"5667","ENSG00000136828","RALGPS1","9",129677053,129985445,308392
"5668","ENSG00000136830","FAM129B","9",130267618,130341268,73650
"5669","ENSG00000136840","ST6GALNAC4","9",130670165,130679317,9152
"5670","ENSG00000136848","DAB2IP","9",124329336,124547809,218473
"5671","ENSG00000136854","STXBP1","9",130374544,130457460,82916
"5672","ENSG00000136856","SLC2A8","9",130159421,130170703,11282
"5673","ENSG00000136859","ANGPTL2","9",129849611,129885162,35551
"5674","ENSG00000136861","CDK5RAP2","9",123151147,123342448,191301
"5675","ENSG00000136866","ZFP37","9",115800660,115819039,18379
"5676","ENSG00000136867","SLC31A2","9",115913222,115926417,13195
"5677","ENSG00000136868","SLC31A1","9",115983808,116028674,44866
"5678","ENSG00000136869","TLR4","9",120466610,120479149,12539
"5679","ENSG00000136870","ZNF189","9",104161155,104172942,11787
"5680","ENSG00000136874","STX17","9",102668915,102732618,63703
"5681","ENSG00000136875","PRPF4","9",116037623,116055185,17562
"5682","ENSG00000136877","FPGS","9",130556876,130576606,19730
"5683","ENSG00000136878","USP20","9",132596977,132644107,47130
"5684","ENSG00000136888","ATP6V1G1","9",117350026,117360653,10627
"5685","ENSG00000136891","TEX10","9",103064359,103115221,50862
"5686","ENSG00000136895","GARNL3","9",129986544,130155939,169395
"5687","ENSG00000136897","MRPL50","9",104149915,104160896,10981
"5688","ENSG00000136908","DPM2","9",130697378,130700763,3385
"5689","ENSG00000136925","TSTD2","9",100362362,100395962,33600
"5690","ENSG00000136930","PSMB7","9",127115745,127177723,61978
"5691","ENSG00000136932","C9orf156","9",100666771,100684852,18081
"5692","ENSG00000136933","RABEPK","9",127962821,127996437,33616
"5693","ENSG00000136935","GOLGA1","9",127640646,127710771,70125
"5694","ENSG00000136936","XPA","9",100437191,100459639,22448
"5695","ENSG00000136937","NCBP1","9",100395908,100436030,40122
"5696","ENSG00000136938","ANP32B","9",100745643,100778225,32582
"5697","ENSG00000136940","PDCL","9",125560668,125590910,30242
"5698","ENSG00000136942","RPL35","9",127620159,127624260,4101
"5699","ENSG00000136943","CTSV","9",99794940,99801925,6985
"5700","ENSG00000136944","LMX1B","9",129376722,129463311,86589
"5701","ENSG00000136950","ARPC5L","9",127624409,127640003,15594
"5702","ENSG00000136960","ENPP2","8",120569326,120685693,116367
"5703","ENSG00000136982","DSCC1","8",120846216,120868250,22034
"5704","ENSG00000136986","DERL1","8",124025404,124054663,29259
"5705","ENSG00000136997","MYC","8",128747680,128753674,5994
"5706","ENSG00000136999","NOV","8",120428546,120436593,8047
"5707","ENSG00000137038","TMEM261","9",7796490,7888380,91890
"5708","ENSG00000137040","RANBP6","9",6011043,6015618,4575
"5709","ENSG00000137054","POLR1E","9",37485932,37503694,17762
"5710","ENSG00000137055","PLAA","9",26904081,26947461,43380
"5711","ENSG00000137070","IL11RA","9",34650699,34661889,11190
"5712","ENSG00000137073","UBAP2","9",33921691,34048947,127256
"5713","ENSG00000137074","APTX","9",32972604,33025166,52562
"5714","ENSG00000137075","RNF38","9",36336393,36487545,151152
"5715","ENSG00000137076","TLN1","9",35696945,35732392,35447
"5716","ENSG00000137094","DNAJB5","9",34989638,34998897,9259
"5717","ENSG00000137098","SPAG8","9",35808042,35812269,4227
"5718","ENSG00000137100","DCTN3","9",34613548,34620515,6967
"5719","ENSG00000137103","TMEM8B","9",35814448,35854844,40396
"5720","ENSG00000137106","GRHPR","9",37422663,37436987,14324
"5721","ENSG00000137124","ALDH1B1","9",38392661,38398658,5997
"5722","ENSG00000137133","HINT2","9",35812957,35815351,2394
"5723","ENSG00000137135","ARHGEF39","9",35658872,35675863,16991
"5724","ENSG00000137142","IGFBPL1","9",38408991,38424444,15453
"5725","ENSG00000137145","DENND4C","9",19230433,19374139,143706
"5726","ENSG00000137154","RPS6","9",19375713,19380252,4539
"5727","ENSG00000137161","CNPY3","6",42896938,42907025,10087
"5728","ENSG00000137166","FOXP4","6",41514164,41570122,55958
"5729","ENSG00000137168","PPIL1","6",36822603,36842800,20197
"5730","ENSG00000137171","KLC4","6",43008515,43042837,34322
"5731","ENSG00000137177","KIF13A","6",17759414,17987854,228440
"5732","ENSG00000137185","ZSCAN9","6",28192664,28201260,8596
"5733","ENSG00000137193","PIM1","6",37137979,37143202,5223
"5734","ENSG00000137200","CMTR1","6",37400995,37450603,49608
"5735","ENSG00000137203","TFAP2A","6",10393419,10419892,26473
"5736","ENSG00000137207","YIPF3","6",43479565,43484728,5163
"5737","ENSG00000137210","TMEM14B","6",10747992,10852986,104994
"5738","ENSG00000137216","TMEM63B","6",44094651,44123256,28605
"5739","ENSG00000137218","FRS3","6",41737914,41754280,16366
"5740","ENSG00000137221","TJAP1","6",43445261,43474294,29033
"5741","ENSG00000137252","HCRTR2","6",55039050,55147418,108368
"5742","ENSG00000137259","HIST1H2AB","6",26033320,26033796,476
"5743","ENSG00000137261","KIAA0319","6",24544332,24646383,102051
"5744","ENSG00000137266","SLC22A23","6",3269196,3457256,188060
"5745","ENSG00000137267","TUBB2A","6",3153903,3157760,3857
"5746","ENSG00000137269","LRRC1","6",53659295,53788919,129624
"5747","ENSG00000137274","BPHL","6",3118608,3153812,35204
"5748","ENSG00000137275","RIPK1","6",3064225,3115421,51196
"5749","ENSG00000137285","TUBB2B","6",3224495,3231964,7469
"5750","ENSG00000137288","UQCC2","6",33662070,33679504,17434
"5751","ENSG00000137309","HMGA1","6",34204650,34214008,9358
"5752","ENSG00000137310","TCF19","6",31126319,31134936,8617
"5753","ENSG00000137312","FLOT1","6",30695486,30710510,15024
"5754","ENSG00000137331","IER3","6",30710976,30712331,1355
"5755","ENSG00000137337","MDC1","6",30667584,30685666,18082
"5756","ENSG00000137338","PGBD1","6",28249314,28270326,21012
"5757","ENSG00000137343","ATAT1","6",30594619,30614600,19981
"5758","ENSG00000137364","TPMT","6",18128542,18155305,26763
"5759","ENSG00000137393","RNF144B","6",18368779,18469105,100326
"5760","ENSG00000137404","NRM","6",30655824,30659197,3373
"5761","ENSG00000137409","MTCH1","6",36935917,36954074,18157
"5762","ENSG00000137411","VARS2","6",30876019,30894236,18217
"5763","ENSG00000137413","TAF8","6",42018251,42055199,36948
"5764","ENSG00000137414","FAM8A1","6",17600586,17611950,11364
"5765","ENSG00000137434","C6orf52","6",10671651,10695030,23379
"5766","ENSG00000137449","CPEB2","4",15004298,15071777,67479
"5767","ENSG00000137460","FHDC1","4",153857504,153900848,43344
"5768","ENSG00000137478","FCHSD2","11",72547790,72853306,305516
"5769","ENSG00000137486","ARRB1","11",74975226,75062873,87647
"5770","ENSG00000137491","SLCO2B1","11",74811608,74917594,105986
"5771","ENSG00000137492","PRKRIR","11",76061000,76092015,31015
"5772","ENSG00000137494","ANKRD42","11",82904781,82971736,66955
"5773","ENSG00000137496","IL18BP","11",71709587,71716761,7174
"5774","ENSG00000137497","NUMA1","11",71713910,71791739,77829
"5775","ENSG00000137500","CCDC90B","11",82970139,82997450,27311
"5776","ENSG00000137501","SYTL2","11",85405267,85522184,116917
"5777","ENSG00000137502","RAB30","11",82684175,82782965,98790
"5778","ENSG00000137504","CREBZF","11",85370752,85393951,23199
"5779","ENSG00000137509","PRCP","11",82534544,82681626,147082
"5780","ENSG00000137513","NARS2","11",78147007,78285919,138912
"5781","ENSG00000137522","RNF121","11",71639747,71708643,68896
"5782","ENSG00000137547","MRPL15","8",55047770,55060461,12691
"5783","ENSG00000137558","PI15","8",75736772,75767264,30492
"5784","ENSG00000137561","TTPA","8",63961112,63998612,37500
"5785","ENSG00000137563","GGH","8",63927638,63951730,24092
"5786","ENSG00000137571","SLCO5A1","8",70579282,70747299,168017
"5787","ENSG00000137573","SULF1","8",70378859,70573150,194291
"5788","ENSG00000137574","TGS1","8",56685701,56738007,52306
"5789","ENSG00000137575","SDCBP","8",59465483,59495419,29936
"5790","ENSG00000137601","NEK1","4",170314426,170533780,219354
"5791","ENSG00000137628","DDX60","4",169137444,169239958,102514
"5792","ENSG00000137642","SORL1","11",121322912,121504402,181490
"5793","ENSG00000137656","BUD13","11",116618886,116643704,24818
"5794","ENSG00000137691","C11orf70","11",101918174,101955291,37117
"5795","ENSG00000137692","DCUN1D5","11",102932805,102962944,30139
"5796","ENSG00000137693","YAP1","11",101981192,102104154,122962
"5797","ENSG00000137700","SLC37A4","11",118894824,118901616,6792
"5798","ENSG00000137710","RDX","11",110045605,110167447,121842
"5799","ENSG00000137713","PPP2R1B","11",111597632,111637151,39519
"5800","ENSG00000137714","FDX1","11",110300607,110335605,34998
"5801","ENSG00000137720","C11orf1","11",111749659,111756699,7040
"5802","ENSG00000137726","FXYD6","11",117707693,117748201,40508
"5803","ENSG00000137760","ALKBH8","11",107373452,107436472,63020
"5804","ENSG00000137764","MAP2K5","15",67835047,68099461,264414
"5805","ENSG00000137766","UNC13C","15",54305101,54920806,615705
"5806","ENSG00000137770","CTDSPL2","15",44719432,44821236,101804
"5807","ENSG00000137776","SLTM","15",59171244,59225852,54608
"5808","ENSG00000137801","THBS1","15",39873280,39891667,18387
"5809","ENSG00000137802","MAPKBP1","15",42066632,42120053,53421
"5810","ENSG00000137804","NUSAP1","15",41624892,41673248,48356
"5811","ENSG00000137806","NDUFAF1","15",41679551,41694717,15166
"5812","ENSG00000137807","KIF23","15",69706585,69740764,34179
"5813","ENSG00000137809","ITGA11","15",68594050,68724501,130451
"5814","ENSG00000137812","CASC5","15",40886218,40956540,70322
"5815","ENSG00000137814","HAUS2","15",42841008,42862192,21184
"5816","ENSG00000137815","RTF1","15",41700606,41775761,75155
"5817","ENSG00000137817","PARP6","15",72533522,72565340,31818
"5818","ENSG00000137818","RPLP1","15",69745123,69748255,3132
"5819","ENSG00000137821","LRRC49","15",71145578,71342414,196836
"5820","ENSG00000137822","TUBGCP4","15",43661419,43699293,37874
"5821","ENSG00000137824","RMDN3","15",41028082,41048049,19967
"5822","ENSG00000137831","UACA","15",70946893,71055932,109039
"5823","ENSG00000137834","SMAD6","15",66994566,67074338,79772
"5824","ENSG00000137841","PLCB2","15",40570377,40600136,29759
"5825","ENSG00000137842","TMEM62","15",43415477,43477344,61867
"5826","ENSG00000137845","ADAM10","15",58887403,59042177,154774
"5827","ENSG00000137868","STRA6","15",74471807,74504608,32801
"5828","ENSG00000137871","ZNF280D","15",56922379,57210769,288390
"5829","ENSG00000137872","SEMA6D","15",47476298,48066420,590122
"5830","ENSG00000137876","RSL24D1","15",55473004,55489265,16261
"5831","ENSG00000137877","SPTBN5","15",42140345,42186275,45930
"5832","ENSG00000137880","GCHFR","15",41056218,41059906,3688
"5833","ENSG00000137936","BCAR3","1",94027347,94312706,285359
"5834","ENSG00000137941","TTLL7","1",84330711,84464833,134122
"5835","ENSG00000137942","FNBP1L","1",93913688,94020218,106530
"5836","ENSG00000137944","CCBL2","1",89401456,89458636,57180
"5837","ENSG00000137947","GTF2B","1",89318615,89357627,39012
"5838","ENSG00000137955","RABGGTB","1",76251879,76260764,8885
"5839","ENSG00000137959","IFI44L","1",79085607,79111830,26223
"5840","ENSG00000137962","ARHGAP29","1",94614544,94740624,126080
"5841","ENSG00000137965","IFI44","1",79115481,79129763,14282
"5842","ENSG00000137968","SLC44A5","1",75667816,76076801,408985
"5843","ENSG00000137970","RPL7P9","1",97144430,97145176,746
"5844","ENSG00000137992","DBT","1",100652475,100715390,62915
"5845","ENSG00000137996","RTCA","1",100731763,100758325,26562
"5846","ENSG00000138002","IFT172","2",27667238,27712656,45418
"5847","ENSG00000138018","EPT1","2",26531415,26618759,87344
"5848","ENSG00000138028","CGREF1","2",27321757,27341995,20238
"5849","ENSG00000138029","HADHB","2",26466038,26513336,47298
"5850","ENSG00000138030","KHK","2",27309615,27323640,14025
"5851","ENSG00000138031","ADCY3","2",25042038,25142708,100670
"5852","ENSG00000138032","PPM1B","2",44395108,44471523,76415
"5853","ENSG00000138035","PNPT1","2",55861400,55921045,59645
"5854","ENSG00000138036","DYNC2LI1","2",44001178,44037149,35971
"5855","ENSG00000138039","LHCGR","2",48859428,48982880,123452
"5856","ENSG00000138041","SMEK2","2",55774428,55846015,71587
"5857","ENSG00000138050","THUMPD2","2",39963200,40006407,43207
"5858","ENSG00000138061","CYP1B1","2",38294116,38337044,42928
"5859","ENSG00000138069","RAB1A","2",65297835,65357240,59405
"5860","ENSG00000138071","ACTR2","2",65454887,65498387,43500
"5861","ENSG00000138073","PREB","2",27353624,27357543,3919
"5862","ENSG00000138074","SLC5A6","2",27422455,27435826,13371
"5863","ENSG00000138078","PREPL","2",44543420,44589001,45581
"5864","ENSG00000138080","EMILIN1","2",27301435,27309271,7836
"5865","ENSG00000138081","FBXO11","2",48016455,48132932,116477
"5866","ENSG00000138085","ATRAID","2",27434895,27440046,5151
"5867","ENSG00000138092","CENPO","2",25016005,25045245,29240
"5868","ENSG00000138095","LRPPRC","2",44113647,44223144,109497
"5869","ENSG00000138101","DTNB","2",25600067,25896503,296436
"5870","ENSG00000138107","ACTR1A","10",104238986,104262482,23496
"5871","ENSG00000138111","TMEM180","10",104221149,104236802,15653
"5872","ENSG00000138119","MYOF","10",95066186,95242074,175888
"5873","ENSG00000138134","STAMBPL1","10",90639491,90734910,95419
"5874","ENSG00000138138","ATAD1","10",89511269,89601100,89831
"5875","ENSG00000138160","KIF11","10",94353043,94415150,62107
"5876","ENSG00000138161","CUZD1","10",124591665,124639146,47481
"5877","ENSG00000138162","TACC2","10",123748689,124014060,265371
"5878","ENSG00000138166","DUSP5","10",112257596,112271302,13706
"5879","ENSG00000138172","CALHM2","10",105206543,105212660,6117
"5880","ENSG00000138175","ARL3","10",104433488,104474164,40676
"5881","ENSG00000138180","CEP55","10",95256389,95288849,32460
"5882","ENSG00000138182","KIF20B","10",91461367,91534700,73333
"5883","ENSG00000138185","ENTPD1","10",97471536,97637023,165487
"5884","ENSG00000138190","EXOC6","10",94590935,94819250,228315
"5885","ENSG00000138193","PLCE1","10",95753746,96092580,338834
"5886","ENSG00000138231","DBR1","3",137879854,137893791,13937
"5887","ENSG00000138246","DNAJC13","3",132136370,132257876,121506
"5888","ENSG00000138279","ANXA7","10",75134859,75173834,38975
"5889","ENSG00000138286","FAM149B1","10",74927924,75004262,76338
"5890","ENSG00000138293","NCOA4","10",51565108,51590734,25626
"5891","ENSG00000138297","TIMM23","10",51592080,51623365,31285
"5892","ENSG00000138303","ASCC1","10",73856278,73976892,120614
"5893","ENSG00000138311","ZNF365","10",64133951,64431771,297820
"5894","ENSG00000138316","ADAMTS14","10",72432559,72522197,89638
"5895","ENSG00000138326","RPS24","10",79793518,79816570,23052
"5896","ENSG00000138336","TET1","10",70320413,70454239,133826
"5897","ENSG00000138346","DNA2","10",70173821,70231879,58058
"5898","ENSG00000138356","AOX1","2",201450591,201541787,91196
"5899","ENSG00000138363","ATIC","2",216176540,216214487,37947
"5900","ENSG00000138375","SMARCAL1","2",217277137,217347776,70639
"5901","ENSG00000138376","BARD1","2",215590370,215674428,84058
"5902","ENSG00000138378","STAT4","2",191894302,192016322,122020
"5903","ENSG00000138380","CARF","2",203776937,203851786,74849
"5904","ENSG00000138381","ASNSD1","2",190526111,190535557,9446
"5905","ENSG00000138382","METTL5","2",170666591,170681441,14850
"5906","ENSG00000138385","SSB","2",170648443,170668574,20131
"5907","ENSG00000138386","NAB1","2",191511472,191557492,46020
"5908","ENSG00000138398","PPIG","2",170440850,170497916,57066
"5909","ENSG00000138399","FASTKD1","2",170386259,170430385,44126
"5910","ENSG00000138400","MDH1B","2",207602487,207630271,27784
"5911","ENSG00000138411","HECW2","2",197059094,197458416,399322
"5912","ENSG00000138413","IDH1","2",209100951,209130798,29847
"5913","ENSG00000138430","OLA1","2",174937175,175113426,176251
"5914","ENSG00000138433","CIR1","2",175212750,175260443,47693
"5915","ENSG00000138434","SSFA2","2",182756560,182795465,38905
"5916","ENSG00000138435","CHRNA1","2",175612320,175629200,16880
"5917","ENSG00000138439","FAM117B","2",203499901,203634480,134579
"5918","ENSG00000138442","WDR12","2",203739505,203879521,140016
"5919","ENSG00000138443","ABI2","2",204192942,204312446,119504
"5920","ENSG00000138448","ITGAV","2",187454792,187545628,90836
"5921","ENSG00000138449","SLC40A1","2",190425305,190448484,23179
"5922","ENSG00000138459","SLC35A5","3",112280556,112304424,23868
"5923","ENSG00000138463","DIRC2","3",122513642,122599986,86344
"5924","ENSG00000138468","SENP7","3",101043049,101232085,189036
"5925","ENSG00000138495","COX17","3",119373360,119396301,22941
"5926","ENSG00000138496","PARP9","3",122246771,122283424,36653
"5927","ENSG00000138587","MNS1","15",56713742,56757335,43593
"5928","ENSG00000138592","USP8","15",50716577,50793280,76703
"5929","ENSG00000138593","SECISBP2L","15",49280673,49338760,58087
"5930","ENSG00000138594","TMOD3","15",52121825,52239492,117667
"5931","ENSG00000138600","SPPL2A","15",50999506,51058005,58499
"5932","ENSG00000138604","GLCE","15",69452923,69564556,111633
"5933","ENSG00000138606","SHF","15",45459412,45493373,33961
"5934","ENSG00000138613","APH1B","15",63568217,63601325,33108
"5935","ENSG00000138614","VWA9","15",65871091,65903627,32536
"5936","ENSG00000138617","PARP16","15",65526798,65592956,66158
"5937","ENSG00000138621","PPCDC","15",75315896,75409803,93907
"5938","ENSG00000138622","HCN4","15",73612200,73661605,49405
"5939","ENSG00000138623","SEMA7A","15",74701630,74726808,25178
"5940","ENSG00000138629","UBL7","15",74738318,74753523,15205
"5941","ENSG00000138639","ARHGAP24","4",86396267,86923823,527556
"5942","ENSG00000138640","FAM13A","4",89647106,90032549,385443
"5943","ENSG00000138641","HERC3","4",89442199,89629693,187494
"5944","ENSG00000138642","HERC6","4",89299891,89364263,64372
"5945","ENSG00000138646","HERC5","4",89378268,89427314,49046
"5946","ENSG00000138650","PCDH10","4",134070470,134129356,58886
"5947","ENSG00000138653","NDST4","4",115748919,116035032,286113
"5948","ENSG00000138658","C4orf21","4",113460492,113558151,97659
"5949","ENSG00000138660","AP1AR","4",113152893,113191203,38310
"5950","ENSG00000138663","COPS4","4",83955600,83996971,41371
"5951","ENSG00000138668","HNRNPD","4",83273651,83295656,22005
"5952","ENSG00000138669","PRKG2","4",82009837,82136218,126381
"5953","ENSG00000138670","RASGEF1B","4",82347547,82965397,617850
"5954","ENSG00000138674","SEC31A","4",83739814,83822319,82505
"5955","ENSG00000138685","FGF2","4",123747863,123819391,71528
"5956","ENSG00000138686","BBS7","4",122745595,122791652,46057
"5957","ENSG00000138688","KIAA1109","4",123073488,123283913,210425
"5958","ENSG00000138696","BMPR1B","4",95679119,96079599,400480
"5959","ENSG00000138698","RAP1GDS1","4",99182535,99365012,182477
"5960","ENSG00000138709","LARP1B","4",128982423,129144086,161663
"5961","ENSG00000138722","MMRN1","4",90800683,90875780,75097
"5962","ENSG00000138735","PDE5A","4",120415550,120550146,134596
"5963","ENSG00000138738","PRDM5","4",121606074,121844025,237951
"5964","ENSG00000138741","TRPC3","4",122800182,122872909,72727
"5965","ENSG00000138744","NAAA","4",76831809,76862204,30395
"5966","ENSG00000138750","NUP54","4",77035812,77069668,33856
"5967","ENSG00000138756","BMP2K","4",79697496,79837526,140030
"5968","ENSG00000138757","G3BP2","4",76567966,76649709,81743
"5969","ENSG00000138758","SEPT11","4",77870856,77961537,90681
"5970","ENSG00000138759","FRAS1","4",78978724,79465423,486699
"5971","ENSG00000138760","SCARB2","4",77079890,77135046,55156
"5972","ENSG00000138764","CCNG2","4",78078304,78354542,276238
"5973","ENSG00000138767","CNOT6L","4",78634541,78740769,106228
"5974","ENSG00000138768","USO1","4",76649777,76735382,85605
"5975","ENSG00000138769","CDKL2","4",76503215,76555900,52685
"5976","ENSG00000138771","SHROOM3","4",77356253,77704406,348153
"5977","ENSG00000138772","ANXA3","4",79472673,79531597,58924
"5978","ENSG00000138777","PPA2","4",106290234,106395238,105004
"5979","ENSG00000138778","CENPE","4",104026963,104119566,92603
"5980","ENSG00000138780","GSTCD","4",106629935,106768885,138950
"5981","ENSG00000138785","INTS12","4",106603784,106817143,213359
"5982","ENSG00000138792","ENPEP","4",111286889,111486441,199552
"5983","ENSG00000138794","CASP6","4",110609785,110624739,14954
"5984","ENSG00000138795","LEF1","4",108968701,109090112,121411
"5985","ENSG00000138796","HADH","4",108910870,108956331,45461
"5986","ENSG00000138798","EGF","4",110834040,110933422,99382
"5987","ENSG00000138801","PAPSS1","4",108511433,108641608,130175
"5988","ENSG00000138802","SEC24B","4",110354928,110462052,107124
"5989","ENSG00000138814","PPP3CA","4",101944566,102269435,324869
"5990","ENSG00000138821","SLC39A8","4",103172198,103352415,180217
"5991","ENSG00000138823","MTTP","4",100484918,100545156,60238
"5992","ENSG00000138829","FBN2","5",127593601,127994878,401277
"5993","ENSG00000138834","MAPK8IP3","16",1756184,1820318,64134
"5994","ENSG00000138835","RGS3","9",116207011,116360018,153007
"5995","ENSG00000138867","GUCD1","22",24936406,24951903,15497
"5996","ENSG00000138942","RNF185","22",31556168,31603005,46837
"5997","ENSG00000138944","KIAA1644","22",44639547,44708731,69184
"5998","ENSG00000139044","B4GALNT3","12",569530,672675,103145
"5999","ENSG00000139083","ETV6","12",11802788,12048336,245548
"6000","ENSG00000139112","GABARAPL1","12",10365057,10375727,10670
"6001","ENSG00000139116","KIF21A","12",39687030,39837192,150162
"6002","ENSG00000139117","CPNE8","12",39040624,39301232,260608
"6003","ENSG00000139131","YARS2","12",32880424,32908836,28412
"6004","ENSG00000139132","FGD4","12",32552463,32798984,246521
"6005","ENSG00000139133","ALG10","12",34175216,34182629,7413
"6006","ENSG00000139146","FAM60A","12",31433518,31479992,46474
"6007","ENSG00000139154","AEBP2","12",19556979,19873735,316756
"6008","ENSG00000139155","SLCO1C1","12",20848289,20906320,58031
"6009","ENSG00000139160","METTL20","12",31800094,31826048,25954
"6010","ENSG00000139163","ETNK1","12",22778009,22843599,65590
"6011","ENSG00000139168","ZCRB1","12",42705880,42719920,14040
"6012","ENSG00000139173","TMEM117","12",44229770,44783545,553775
"6013","ENSG00000139174","PRICKLE1","12",42852140,42984157,132017
"6014","ENSG00000139178","C1RL","12",7242183,7261869,19686
"6015","ENSG00000139180","NDUFA9","12",4758261,4798454,40193
"6016","ENSG00000139182","CLSTN3","12",7282294,7311541,29247
"6017","ENSG00000139187","KLRG1","12",9102640,9163356,60716
"6018","ENSG00000139190","VAMP1","12",6571403,6580153,8750
"6019","ENSG00000139197","PEX5","12",7341281,7371170,29889
"6020","ENSG00000139200","PIANP","12",6802958,6809966,7008
"6021","ENSG00000139209","SLC38A4","12",47158546,47226191,67645
"6022","ENSG00000139211","AMIGO2","12",47469490,47473734,4244
"6023","ENSG00000139218","SCAF11","12",46312914,46385903,72989
"6024","ENSG00000139219","COL2A1","12",48366748,48398269,31521
"6025","ENSG00000139220","PPFIA2","12",81652045,82153332,501287
"6026","ENSG00000139233","LLPH","12",66516842,66524548,7706
"6027","ENSG00000139239","RPL14P1","12",63359095,63359764,669
"6028","ENSG00000139263","LRIG3","12",59265931,59314303,48372
"6029","ENSG00000139266","MARCH9","12",58148881,58154190,5309
"6030","ENSG00000139278","GLIPR1","12",75874460,75897633,23173
"6031","ENSG00000139289","PHLDA1","12",76419227,76427712,8485
"6032","ENSG00000139291","TMEM19","12",72079867,72097836,17969
"6033","ENSG00000139292","LGR5","12",71833550,71980090,146540
"6034","ENSG00000139318","DUSP6","12",89741009,89747048,6039
"6035","ENSG00000139323","POC1B","12",89813495,89919801,106306
"6036","ENSG00000139324","TMTC3","12",88536073,88593664,57591
"6037","ENSG00000139329","LUM","12",91496406,91505608,9202
"6038","ENSG00000139343","SNRPF","12",96252706,96297606,44900
"6039","ENSG00000139350","NEDD1","12",97301001,97347129,46128
"6040","ENSG00000139352","ASCL1","12",103351464,103354294,2830
"6041","ENSG00000139354","GAS2L3","12",100967461,101022064,54603
"6042","ENSG00000139364","TMEM132B","12",125671382,126146917,475535
"6043","ENSG00000139370","SLC15A4","12",129277739,129308528,30789
"6044","ENSG00000139372","TDG","12",104359582,104382652,23070
"6045","ENSG00000139405","RITA1","12",113623331,113630173,6842
"6046","ENSG00000139410","SDSL","12",113860042,113876081,16039
"6047","ENSG00000139428","MMAB","12",109991542,110011679,20137
"6048","ENSG00000139433","GLTP","12",110288748,110318293,29545
"6049","ENSG00000139436","GIT2","12",110367607,110434194,66587
"6050","ENSG00000139437","TCHP","12",110338069,110421646,83577
"6051","ENSG00000139438","FAM222A","12",110152033,110208312,56279
"6052","ENSG00000139496","NUPL1","13",25875662,25923938,48276
"6053","ENSG00000139505","MTMR6","13",25802307,25862147,59840
"6054","ENSG00000139508","SLC46A3","13",29274201,29293107,18906
"6055","ENSG00000139514","SLC7A1","13",30083547,30169825,86278
"6056","ENSG00000139517","LNX2","13",28120050,28194541,74491
"6057","ENSG00000139531","SUOX","12",56390964,56400425,9461
"6058","ENSG00000139537","CCDC65","12",49297893,49325623,27730
"6059","ENSG00000139546","TARBP2","12",53894705,53900215,5510
"6060","ENSG00000139547","RDH16","12",57345219,57353158,7939
"6061","ENSG00000139579","NABP2","12",56615799,56623638,7839
"6062","ENSG00000139597","N4BP2L1","13",32974861,33002315,27454
"6063","ENSG00000139613","SMARCC2","12",56556767,56583351,26584
"6064","ENSG00000139618","BRCA2","13",32889611,32973805,84194
"6065","ENSG00000139620","KANSL2","12",49047184,49076021,28837
"6066","ENSG00000139624","CERS5","12",50523575,50561288,37713
"6067","ENSG00000139625","MAP3K12","12",53874274,53893847,19573
"6068","ENSG00000139629","GALNT6","12",51745031,51786651,41620
"6069","ENSG00000139631","CSAD","12",53551447,53575135,23688
"6070","ENSG00000139636","LMBR1L","12",49490919,49504683,13764
"6071","ENSG00000139637","C12orf10","12",53693470,53700961,7491
"6072","ENSG00000139641","ESYT1","12",56512034,56538455,26421
"6073","ENSG00000139644","TMBIM6","12",50101508,50158717,57209
"6074","ENSG00000139645","ANKRD52","12",56631591,56652175,20584
"6075","ENSG00000139651","ZNF740","12",53574484,53584596,10112
"6076","ENSG00000139668","WDFY2","13",52158644,52336171,177527
"6077","ENSG00000139675","HNRNPA1L2","13",53191605,53217919,26314
"6078","ENSG00000139679","LPAR6","13",48963707,49018840,55133
"6079","ENSG00000139684","ESD","13",47345391,47371367,25976
"6080","ENSG00000139687","RB1","13",48877887,49056122,178235
"6081","ENSG00000139697","SBNO1","12",123773656,123849390,75734
"6082","ENSG00000139718","SETD1B","12",122242086,122270562,28476
"6083","ENSG00000139719","VPS33A","12",122714111,122751068,36957
"6084","ENSG00000139722","VPS37B","12",123349882,123380991,31109
"6085","ENSG00000139725","RHOF","12",122215664,122241309,25645
"6086","ENSG00000139726","DENR","12",123237321,123255611,18290
"6087","ENSG00000139734","DIAPH3","13",60239717,60738121,498404
"6088","ENSG00000139737","SLAIN1","13",78272023,78338377,66354
"6089","ENSG00000139746","RBM26","13",79885962,79980612,94650
"6090","ENSG00000139767","SRRM4","12",119419300,119600856,181556
"6091","ENSG00000139793","MBNL2","13",97873688,98046374,172686
"6092","ENSG00000139800","ZIC5","13",100615218,100624163,8945
"6093","ENSG00000139826","ABHD13","13",108870727,108886603,15876
"6094","ENSG00000139832","RAB20","13",111175417,111214080,38663
"6095","ENSG00000139835","GRTP1","13",113978505,114018446,39941
"6096","ENSG00000139842","CUL4A","13",113862552,113919399,56847
"6097","ENSG00000139880","CDH24","14",23516271,23526747,10476
"6098","ENSG00000139890","REM2","14",23352374,23356895,4521
"6099","ENSG00000139910","NOVA1","14",26912299,27066960,154661
"6100","ENSG00000139915","MDGA2","14",47308826,48144157,835331
"6101","ENSG00000139921","TMX1","14",51706880,51722759,15879
"6102","ENSG00000139926","FRMD6","14",51955818,52197445,241627
"6103","ENSG00000139946","PELI2","14",56584532,56768244,183712
"6104","ENSG00000139970","RTN1","14",60062694,60337684,274990
"6105","ENSG00000139971","C14orf37","14",58466453,58764857,298404
"6106","ENSG00000139973","SYT16","14",62453803,62568431,114628
"6107","ENSG00000139974","SLC38A6","14",61447832,61550451,102619
"6108","ENSG00000139977","NAA30","14",57857262,57882635,25373
"6109","ENSG00000139990","DCAF5","14",69517598,69619867,102269
"6110","ENSG00000139998","RAB15","14",65412532,65439494,26962
"6111","ENSG00000140006","WDR89","14",64063757,64108579,44822
"6112","ENSG00000140015","KCNH5","14",63173287,63568755,395468
"6113","ENSG00000140022","STON2","14",81727000,81902809,175809
"6114","ENSG00000140025","EFCAB11","14",90261013,90421121,160108
"6115","ENSG00000140043","PTGR2","14",74318547,74353530,34983
"6116","ENSG00000140044","JDP2","14",75894419,75940814,46395
"6117","ENSG00000140057","AK7","14",96858448,96955764,97316
"6118","ENSG00000140067","FAM181A","14",94385240,94395954,10714
"6119","ENSG00000140104","C14orf79","14",105452112,105476819,24707
"6120","ENSG00000140105","WARS","14",100800125,100843142,43017
"6121","ENSG00000140153","WDR20","14",102605840,102691184,85344
"6122","ENSG00000140157","NIPA2","15",23004684,23034427,29743
"6123","ENSG00000140181","HERC2P2","15",23282281,23378228,95947
"6124","ENSG00000140199","SLC12A6","15",34525460,34630261,104801
"6125","ENSG00000140259","MFAP1","15",44096690,44117000,20310
"6126","ENSG00000140262","TCF12","15",57210821,57591479,380658
"6127","ENSG00000140263","SORD","15",45315302,45369383,54081
"6128","ENSG00000140264","SERF2","15",44069285,44094787,25502
"6129","ENSG00000140265","ZSCAN29","15",43650370,43663223,12853
"6130","ENSG00000140280","LYSMD2","15",52015208,52043782,28574
"6131","ENSG00000140299","BNIP2","15",59951345,59981733,30388
"6132","ENSG00000140307","GTF2A2","15",59930261,59949740,19479
"6133","ENSG00000140319","SRP14","15",40327940,40331389,3449
"6134","ENSG00000140320","BAHD1","15",40731920,40760441,28521
"6135","ENSG00000140323","DISP2","15",40650436,40663257,12821
"6136","ENSG00000140326","CDAN1","15",43015757,43029324,13567
"6137","ENSG00000140332","TLE3","15",70340129,70390515,50386
"6138","ENSG00000140350","ANP32A","15",69070874,69113236,42362
"6139","ENSG00000140365","COMMD4","15",75628232,75634268,6036
"6140","ENSG00000140367","UBE2Q2","15",76135622,76193419,57797
"6141","ENSG00000140374","ETFA","15",76507696,76603813,96117
"6142","ENSG00000140382","HMG20A","15",77712754,77777949,65195
"6143","ENSG00000140386","SCAPER","15",76640526,77197785,557259
"6144","ENSG00000140391","TSPAN3","15",77336359,77376326,39967
"6145","ENSG00000140395","WDR61","15",78570177,78592136,21959
"6146","ENSG00000140396","NCOA2","8",71021997,71316040,294043
"6147","ENSG00000140398","NEIL1","15",75639296,75647592,8296
"6148","ENSG00000140400","MAN2C1","15",75648133,75660971,12838
"6149","ENSG00000140403","DNAJA4","15",78556428,78574538,18110
"6150","ENSG00000140406","MESDC1","15",81293295,81296342,3047
"6151","ENSG00000140416","TPM1","15",63334831,63364114,29283
"6152","ENSG00000140443","IGF1R","15",99192200,99507759,315559
"6153","ENSG00000140450","ARRDC4","15",98462784,98517068,54284
"6154","ENSG00000140451","PIF1","15",65107831,65117867,10036
"6155","ENSG00000140455","USP3","15",63796793,63886839,90046
"6156","ENSG00000140463","BBS4","15",72978527,73030817,52290
"6157","ENSG00000140464","PML","15",74287014,74340153,53139
"6158","ENSG00000140471","LINS","15",101099574,101143435,43861
"6159","ENSG00000140474","ULK3","15",75128457,75135687,7230
"6160","ENSG00000140479","PCSK6","15",101840818,102065405,224587
"6161","ENSG00000140497","SCAMP2","15",75136071,75165706,29635
"6162","ENSG00000140511","HAPLN3","15",89420519,89438857,18338
"6163","ENSG00000140521","POLG","15",89859534,89878092,18558
"6164","ENSG00000140525","FANCI","15",89787180,89860492,73312
"6165","ENSG00000140526","ABHD2","15",89630690,89745591,114901
"6166","ENSG00000140534","TICRR","15",90118713,90174287,55574
"6167","ENSG00000140538","NTRK3","15",88418230,88799999,381769
"6168","ENSG00000140543","DET1","15",89054790,89089906,35116
"6169","ENSG00000140545","MFGE8","15",89441916,89456642,14726
"6170","ENSG00000140548","ZNF710","15",90544624,90625438,80814
"6171","ENSG00000140553","UNC45A","15",91473410,91497323,23913
"6172","ENSG00000140557","ST8SIA2","15",92937058,93011958,74900
"6173","ENSG00000140564","FURIN","15",91411822,91426688,14866
"6174","ENSG00000140575","IQGAP1","15",90931450,91045475,114025
"6175","ENSG00000140577","CRTC3","15",91073157,91188577,115420
"6176","ENSG00000140598","EFTUD1","15",82422571,82555104,132533
"6177","ENSG00000140600","SH3GL3","15",84115980,84287495,171515
"6178","ENSG00000140612","SEC11A","15",85212775,85259947,47172
"6179","ENSG00000140632","GLYR1","16",4853204,4897343,44139
"6180","ENSG00000140650","PMM2","16",8882680,8943188,60508
"6181","ENSG00000140682","TGFB1I1","16",31482906,31489281,6375
"6182","ENSG00000140688","C16orf58","16",31500792,31520630,19838
"6183","ENSG00000140691","ARMC5","16",31469401,31478487,9086
"6184","ENSG00000140694","PARN","16",14529558,14726585,197027
"6185","ENSG00000140718","FTO","16",53737875,54155853,417978
"6186","ENSG00000140740","UQCRC2","16",21963981,21994981,31000
"6187","ENSG00000140743","CDR2","16",22357257,22448486,91229
"6188","ENSG00000140750","ARHGAP17","16",24930706,25026987,96281
"6189","ENSG00000140795","MYLK3","16",46740891,46824319,83428
"6190","ENSG00000140807","NKD1","16",50582241,50670647,88406
"6191","ENSG00000140829","DHX38","16",72127461,72146811,19350
"6192","ENSG00000140830","TXNL4B","16",72078188,72128330,50142
"6193","ENSG00000140836","ZFHX3","16",72816784,73093597,276813
"6194","ENSG00000140839","CLEC18B","16",74442529,74455368,12839
"6195","ENSG00000140848","CPNE2","16",57126449,57181878,55429
"6196","ENSG00000140853","NLRC5","16",57023397,57117443,94046
"6197","ENSG00000140854","KATNB1","16",57769642,57791162,21520
"6198","ENSG00000140859","KIFC3","16",57792129,57896957,104828
"6199","ENSG00000140873","ADAMTS18","16",77281710,77469011,187301
"6200","ENSG00000140876","NUDT7","16",77756411,77776157,19746
"6201","ENSG00000140905","GCSH","16",81115566,81130008,14442
"6202","ENSG00000140931","CMTM3","16",66637777,66647795,10018
"6203","ENSG00000140937","CDH11","16",64977656,65160015,182359
"6204","ENSG00000140939","NOL3","16",67204057,67209643,5586
"6205","ENSG00000140941","MAP1LC3B","16",87417601,87438385,20784
"6206","ENSG00000140943","MBTPS1","16",84087368,84150511,63143
"6207","ENSG00000140945","CDH13","16",82660408,83830204,1169796
"6208","ENSG00000140948","ZCCHC14","16",87439852,87525651,85799
"6209","ENSG00000140950","TLDC1","16",84511681,84587639,75958
"6210","ENSG00000140961","OSGIN1","16",83981887,83999937,18050
"6211","ENSG00000140983","RHOT2","16",718086,724174,6088
"6212","ENSG00000140987","ZSCAN32","16",3432085,3451065,18980
"6213","ENSG00000140988","RPS2","16",2012053,2014861,2808
"6214","ENSG00000140990","NDUFB10","16",2009509,2011976,2467
"6215","ENSG00000140992","PDPK1","16",2587965,2653189,65224
"6216","ENSG00000140993","TIGD7","16",3348832,3355729,6897
"6217","ENSG00000140995","DEF8","16",90014333,90034468,20135
"6218","ENSG00000141002","TCF25","16",89940000,89977792,37792
"6219","ENSG00000141012","GALNS","16",88880142,88923378,43236
"6220","ENSG00000141013","GAS8","16",90086037,90111383,25346
"6221","ENSG00000141026","MED9","17",17380300,17396540,16240
"6222","ENSG00000141027","NCOR1","17",15932471,16121499,189028
"6223","ENSG00000141030","COPS3","17",17150141,17184607,34466
"6224","ENSG00000141034","GID4","17",17942606,17971718,29112
"6225","ENSG00000141040","ZNF287","17",16454701,16472520,17819
"6226","ENSG00000141052","MYOCD","17",12569207,12672266,103059
"6227","ENSG00000141068","KSR1","17",25783670,25953461,169791
"6228","ENSG00000141076","CIRH1A","16",69165194,69265033,99839
"6229","ENSG00000141084","RANBP10","16",67757005,67840555,83550
"6230","ENSG00000141098","GFOD2","16",67708434,67753324,44890
"6231","ENSG00000141101","NOB1","16",69775770,69788843,13073
"6232","ENSG00000141127","PRPSAP2","17",18743398,18834581,91183
"6233","ENSG00000141140","MYO19","17",34851477,34899284,47807
"6234","ENSG00000141141","DDX52","17",35969787,36003493,33706
"6235","ENSG00000141150","RASL10B","17",34058668,34070540,11872
"6236","ENSG00000141179","PCTP","17",53828340,53920191,91851
"6237","ENSG00000141198","TOM1L1","17",52976748,53039310,62562
"6238","ENSG00000141219","C17orf80","17",71228372,71245091,16719
"6239","ENSG00000141232","TOB1","17",48939584,48945339,5755
"6240","ENSG00000141252","VPS53","17",411908,624957,213049
"6241","ENSG00000141258","SGSM2","17",2240792,2284352,43560
"6242","ENSG00000141279","NPEPPS","17",45600308,45700642,100334
"6243","ENSG00000141295","SCRN2","17",45915058,45918699,3641
"6244","ENSG00000141298","SSH2","17",27952956,28257294,304338
"6245","ENSG00000141314","RHBDL3","17",30593195,30651680,58485
"6246","ENSG00000141337","ARSG","17",66255323,66418872,163549
"6247","ENSG00000141338","ABCA8","17",66863433,66951533,88100
"6248","ENSG00000141349","G6PC3","17",42148103,42153709,5606
"6249","ENSG00000141367","CLTC","17",57697219,57773671,76452
"6250","ENSG00000141376","BCAS3","17",58754814,59470199,715385
"6251","ENSG00000141378","PTRH2","17",57751997,57784987,32990
"6252","ENSG00000141380","SS18","18",23596578,23671181,74603
"6253","ENSG00000141384","TAF4B","18",23805900,23971649,165749
"6254","ENSG00000141385","AFG3L2","18",12328943,12377313,48370
"6255","ENSG00000141391","SLMO1","18",12407895,12432237,24342
"6256","ENSG00000141401","IMPA2","18",11981024,12030876,49852
"6257","ENSG00000141404","GNAL","18",11688955,11885684,196729
"6258","ENSG00000141424","SLC39A6","18",33688495,33709348,20853
"6259","ENSG00000141425","RPRD1A","18",33564350,33647539,83189
"6260","ENSG00000141428","C18orf21","18",33552046,33559241,7195
"6261","ENSG00000141429","GALNT1","18",33161081,33291798,130717
"6262","ENSG00000141431","ASXL3","18",31158579,31331156,172577
"6263","ENSG00000141433","ADCYAP1","18",904944,912173,7229
"6264","ENSG00000141441","GAREM","18",29704840,30050447,345607
"6265","ENSG00000141446","ESCO1","18",19109242,19180845,71603
"6266","ENSG00000141447","OSBPL1A","18",21742008,21977844,235836
"6267","ENSG00000141449","GREB1L","18",18822203,19105378,283175
"6268","ENSG00000141452","C18orf8","18",21083473,21111746,28273
"6269","ENSG00000141456","PELP1","17",4574679,4607632,32953
"6270","ENSG00000141458","NPC1","18",21086148,21166862,80714
"6271","ENSG00000141480","ARRB2","17",4613784,4624794,11010
"6272","ENSG00000141499","WRAP53","17",7589389,7606820,17431
"6273","ENSG00000141503","MINK1","17",4736683,4801356,64673
"6274","ENSG00000141504","SAT2","17",7529552,7531194,1642
"6275","ENSG00000141505","ASGR1","17",7076750,7082883,6133
"6276","ENSG00000141510","TP53","17",7565097,7590856,25759
"6277","ENSG00000141519","CCDC40","17",78010435,78074412,63977
"6278","ENSG00000141522","ARHGDIA","17",79825597,79829282,3685
"6279","ENSG00000141524","TMC6","17",76106539,76128488,21949
"6280","ENSG00000141540","TTYH2","17",72209653,72258155,48502
"6281","ENSG00000141542","RAB40B","17",80612849,80656604,43755
"6282","ENSG00000141543","EIF4A3","17",78109013,78120982,11969
"6283","ENSG00000141551","CSNK1D","17",80196899,80231607,34708
"6284","ENSG00000141552","ANAPC11","17",79848666,79858867,10201
"6285","ENSG00000141556","TBCD","17",80709940,80900724,190784
"6286","ENSG00000141560","FN3KRP","17",80674559,80688204,13645
"6287","ENSG00000141562","NARF","17",80416056,80448413,32357
"6288","ENSG00000141564","RPTOR","17",78518619,78940171,421552
"6289","ENSG00000141568","FOXK2","17",80477589,80602538,124949
"6290","ENSG00000141569","TRIM65","17",73876416,73893084,16668
"6291","ENSG00000141570","CBX8","17",77765931,77775482,9551
"6292","ENSG00000141576","RNF157","17",74138534,74236454,97920
"6293","ENSG00000141577","AZI1","17",79163393,79196799,33406
"6294","ENSG00000141580","WDR45B","17",80572438,80606429,33991
"6295","ENSG00000141582","CBX4","17",77806955,77813228,6273
"6296","ENSG00000141622","RNF165","18",43906772,44043103,136331
"6297","ENSG00000141627","DYM","18",46570039,46987717,417678
"6298","ENSG00000141639","MAPK4","18",48086448,48258194,171746
"6299","ENSG00000141642","ELAC1","18",48494361,48514491,20130
"6300","ENSG00000141644","MBD1","18",47793252,47808144,14892
"6301","ENSG00000141646","SMAD4","18",48494410,48611415,117005
"6302","ENSG00000141664","ZCCHC2","18",60190240,60254942,64702
"6303","ENSG00000141665","FBXO15","18",71740588,71815100,74512
"6304","ENSG00000141668","CBLN2","18",70203915,70305756,101841
"6305","ENSG00000141682","PMAIP1","18",57567180,57571538,4358
"6306","ENSG00000141696","LEPREL4","17",39958199,39968856,10657
"6307","ENSG00000141698","NT5C3B","17",39981335,39992523,11188
"6308","ENSG00000141699","FAM134C","17",40731531,40762641,31110
"6309","ENSG00000141720","PIP4K2B","17",36921942,36956379,34437
"6310","ENSG00000141736","ERBB2","17",37844167,37886679,42512
"6311","ENSG00000141741","MIEN1","17",37884749,37887040,2291
"6312","ENSG00000141753","IGFBP4","17",38599702,38613983,14281
"6313","ENSG00000141756","FKBP10","17",39968932,39979465,10533
"6314","ENSG00000141759","TXNL4A","18",77732867,77793949,61082
"6315","ENSG00000141837","CACNA1A","19",13317256,13734804,417548
"6316","ENSG00000141858","SAMD1","19",14198652,14201848,3196
"6317","ENSG00000141867","BRD4","19",15347647,15443356,95709
"6318","ENSG00000141873","SLC39A3","19",2732202,2740150,7948
"6319","ENSG00000141905","NFIC","19",3359561,3469215,109654
"6320","ENSG00000141933","TPGS1","19",507299,519654,12355
"6321","ENSG00000141956","PRDM15","21",43218385,43299591,81206
"6322","ENSG00000141959","PFKL","21",45719934,45747259,27325
"6323","ENSG00000141965","FEM1A","19",4791728,4795571,3843
"6324","ENSG00000141971","MVB12A","19",17516531,17544533,28002
"6325","ENSG00000141985","SH3GL1","19",4360367,4400544,40177
"6326","ENSG00000141994","DUS3L","19",5784843,5791249,6406
"6327","ENSG00000142002","DPP9","19",4675236,4724685,49449
"6328","ENSG00000142039","CCDC97","19",41816094,41830788,14694
"6329","ENSG00000142046","TMEM91","19",41856816,41889988,33172
"6330","ENSG00000142065","ZFP14","19",36827162,36870101,42939
"6331","ENSG00000142082","SIRT3","11",215458,236931,21473
"6332","ENSG00000142089","IFITM3","11",319669,327537,7868
"6333","ENSG00000142102","ATHL1","11",289135,296107,6972
"6334","ENSG00000142149","HUNK","21",33245628,33416946,171318
"6335","ENSG00000142156","COL6A1","21",47401651,47424964,23313
"6336","ENSG00000142166","IFNAR1","21",34696734,34732168,35434
"6337","ENSG00000142168","SOD1","21",33031935,33041244,9309
"6338","ENSG00000142173","COL6A2","21",47518011,47552763,34752
"6339","ENSG00000142178","SIK1","21",44834395,44847008,12613
"6340","ENSG00000142186","SCYL1","11",65292548,65306175,13627
"6341","ENSG00000142188","TMEM50B","21",34804792,34852318,47526
"6342","ENSG00000142192","APP","21",27252861,27543446,290585
"6343","ENSG00000142197","DOPEY2","21",37529080,37666572,137492
"6344","ENSG00000142207","URB1","21",33683329,33765335,82006
"6345","ENSG00000142208","AKT1","14",105235686,105262088,26402
"6346","ENSG00000142227","EMP3","19",48824766,48833810,9044
"6347","ENSG00000142230","SAE1","19",47616531,47713886,97355
"6348","ENSG00000142235","LMTK3","19",48988528,49016446,27918
"6349","ENSG00000142252","GEMIN7","19",45582453,45594782,12329
"6350","ENSG00000142279","WTIP","19",34971874,34997258,25384
"6351","ENSG00000142303","ADAMTS10","19",8645126,8675620,30494
"6352","ENSG00000142327","RNPEPL1","2",241505221,241520789,15568
"6353","ENSG00000142330","CAPN10","2",241526133,241557122,30989
"6354","ENSG00000142396","ERVK3-1","19",58816715,58827023,10308
"6355","ENSG00000142408","CACNG8","19",54466294,54493469,27175
"6356","ENSG00000142409","ZNF787","19",56598732,56632649,33917
"6357","ENSG00000142444","C19orf52","19",11039409,11044211,4802
"6358","ENSG00000142449","FBN3","19",8130286,8214730,84444
"6359","ENSG00000142453","CARM1","19",10982189,11033453,51264
"6360","ENSG00000142459","EVI5L","19",7895119,7929862,34743
"6361","ENSG00000142494","SLC47A1","17",19398698,19482347,83649
"6362","ENSG00000142507","PSMB6","17",4699439,4701790,2351
"6363","ENSG00000142528","ZNF473","19",50528971,50556671,27700
"6364","ENSG00000142534","RPS11","19",49999622,50002946,3324
"6365","ENSG00000142541","RPL13A","19",49990811,49995565,4754
"6366","ENSG00000142544","CTU1","19",51600863,51611627,10764
"6367","ENSG00000142546","NOSIP","19",50058968,50093519,34551
"6368","ENSG00000142549","IGLON5","19",51815102,51833608,18506
"6369","ENSG00000142552","RCN3","19",50030875,50050219,19344
"6370","ENSG00000142556","ZNF614","19",52516018,52533493,17475
"6371","ENSG00000142599","RERE","1",8412457,8877702,465245
"6372","ENSG00000142611","PRDM16","1",2985732,3355185,369453
"6373","ENSG00000142621","FHAD1","1",15573768,15726779,153011
"6374","ENSG00000142627","EPHA2","1",16450832,16482582,31750
"6375","ENSG00000142632","ARHGEF19","1",16524349,16539104,14755
"6376","ENSG00000142634","EFHD2","1",15736391,15756839,20448
"6377","ENSG00000142655","PEX14","1",10532345,10690815,158470
"6378","ENSG00000142657","PGD","1",10458649,10480201,21552
"6379","ENSG00000142669","SH3BGRL3","1",26605667,26608007,2340
"6380","ENSG00000142675","CNKSR1","1",26503894,26516377,12483
"6381","ENSG00000142676","RPL11","1",24018269,24022915,4646
"6382","ENSG00000142684","ZNF593","1",26496362,26498551,2189
"6383","ENSG00000142686","C1orf216","1",36179476,36185073,5597
"6384","ENSG00000142687","KIAA0319L","1",35899091,36023551,124460
"6385","ENSG00000142694","EVA1B","1",36787632,36789755,2123
"6386","ENSG00000142731","PLK4","4",128802016,128820350,18334
"6387","ENSG00000142733","MAP3K6","1",27681675,27693383,11708
"6388","ENSG00000142751","GPN2","1",27202624,27216788,14164
"6389","ENSG00000142784","WDTC1","1",27561007,27635110,74103
"6390","ENSG00000142794","NBPF3","1",21766621,21811498,44877
"6391","ENSG00000142798","HSPG2","1",22148738,22263790,115052
"6392","ENSG00000142856","ITGB3BP","1",63906441,64059392,152951
"6393","ENSG00000142864","SERBP1","1",67873493,67896098,22605
"6394","ENSG00000142867","BCL10","1",85731931,85742773,10842
"6395","ENSG00000142871","CYR61","1",86046444,86049645,3201
"6396","ENSG00000142875","PRKACB","1",84543745,84704181,160436
"6397","ENSG00000142892","PIGK","1",77554675,77685115,130440
"6398","ENSG00000142920","ADC","1",33546705,33586131,39426
"6399","ENSG00000142937","RPS8","1",45240923,45244451,3528
"6400","ENSG00000142945","KIF2C","1",45205490,45233439,27949
"6401","ENSG00000142949","PTPRF","1",43990858,44089343,98485
"6402","ENSG00000142961","MOB3C","1",47073387,47082563,9176
"6403","ENSG00000143013","LMO4","1",87794151,87814606,20455
"6404","ENSG00000143033","MTF2","1",93544792,93604638,59846
"6405","ENSG00000143036","SLC44A3","1",95285898,95360802,74904
"6406","ENSG00000143061","IGSF3","1",117117031,117210375,93344
"6407","ENSG00000143067","ZNF697","1",120162045,120190396,28351
"6408","ENSG00000143079","CTTNBP2NL","1",112938803,113006078,67275
"6409","ENSG00000143093","STRIP1","1",110574199,110617263,43064
"6410","ENSG00000143106","PSMA5","1",109941653,109969062,27409
"6411","ENSG00000143126","CELSR2","1",109792641,109818372,25731
"6412","ENSG00000143127","ITGA10","1",145524891,145543868,18977
"6413","ENSG00000143147","GPR161","1",168053997,168106821,52824
"6414","ENSG00000143149","ALDH9A1","1",165631453,165668100,36647
"6415","ENSG00000143153","ATP1B1","1",169074935,169101960,27025
"6416","ENSG00000143155","TIPRL","1",168148171,168169950,21779
"6417","ENSG00000143156","NME7","1",169101769,169337205,235436
"6418","ENSG00000143157","POGK","1",166808681,166825581,16900
"6419","ENSG00000143158","MPC2","1",167885967,167906278,20311
"6420","ENSG00000143162","CREG1","1",167498914,167523004,24090
"6421","ENSG00000143164","DCAF6","1",167905021,168045081,140060
"6422","ENSG00000143178","TBX19","1",168250278,168283664,33386
"6423","ENSG00000143179","UCK2","1",165796768,165880855,84087
"6424","ENSG00000143183","TMCO1","1",165696032,165796992,100960
"6425","ENSG00000143190","POU2F1","1",167190066,167396582,206516
"6426","ENSG00000143195","ILDR2","1",166882443,166944719,62276
"6427","ENSG00000143198","MGST3","1",165600098,165631033,30935
"6428","ENSG00000143207","RFWD2","1",175913967,176176629,262662
"6429","ENSG00000143222","UFC1","1",161122566,161128646,6080
"6430","ENSG00000143224","PPOX","1",161136200,161147803,11603
"6431","ENSG00000143228","NUF2","1",163236366,163325554,89188
"6432","ENSG00000143248","RGS5","1",163080911,163291577,210666
"6433","ENSG00000143252","SDHC","1",161284047,161332984,48937
"6434","ENSG00000143256","PFDN2","1",161070346,161087901,17555
"6435","ENSG00000143258","USP21","1",161129240,161135513,6273
"6436","ENSG00000143294","PRCC","1",156720402,156770607,50205
"6437","ENSG00000143303","RRNAD1","1",156698234,156706752,8518
"6438","ENSG00000143314","MRPL24","1",156707095,156711382,4287
"6439","ENSG00000143315","PIGM","1",159997462,160001783,4321
"6440","ENSG00000143319","ISG20L2","1",156691683,156698591,6908
"6441","ENSG00000143320","CRABP2","1",156669398,156675608,6210
"6442","ENSG00000143321","HDGF","1",156711899,156736717,24818
"6443","ENSG00000143322","ABL2","1",179068462,179198819,130357
"6444","ENSG00000143324","XPR1","1",180601140,180859387,258247
"6445","ENSG00000143333","RGS16","1",182567758,182573543,5785
"6446","ENSG00000143337","TOR1AIP1","1",179851177,179894135,42958
"6447","ENSG00000143341","HMCN1","1",185703683,186160085,456402
"6448","ENSG00000143344","RGL1","1",183605220,183897665,292445
"6449","ENSG00000143353","LYPLAL1","1",219347186,219386207,39021
"6450","ENSG00000143355","LHX9","1",197881037,197904608,23571
"6451","ENSG00000143363","PRUNE","1",150980896,151008189,27293
"6452","ENSG00000143367","TUFT1","1",151512781,151556059,43278
"6453","ENSG00000143368","SF3B4","1",149895209,149900236,5027
"6454","ENSG00000143369","ECM1","1",150480538,150486265,5727
"6455","ENSG00000143373","ZNF687","1",151254094,151264656,10562
"6456","ENSG00000143374","TARS2","1",150459887,150480078,20191
"6457","ENSG00000143375","CGN","1",151482986,151511168,28182
"6458","ENSG00000143376","SNX27","1",151584541,151671567,87026
"6459","ENSG00000143379","SETDB1","1",150898739,150937213,38474
"6460","ENSG00000143384","MCL1","1",150547032,150552066,5034
"6461","ENSG00000143387","CTSK","1",150768684,150780799,12115
"6462","ENSG00000143390","RFX5","1",151313116,151319833,6717
"6463","ENSG00000143393","PI4KB","1",151264273,151300191,35918
"6464","ENSG00000143398","PIP5K1A","1",151170425,151222012,51587
"6465","ENSG00000143401","ANP32E","1",150190717,150208504,17787
"6466","ENSG00000143409","FAM63A","1",150969025,150980851,11826
"6467","ENSG00000143416","SELENBP1","1",151336778,151345209,8431
"6468","ENSG00000143418","CERS2","1",150933059,150947479,14420
"6469","ENSG00000143420","ENSA","1",150573327,150602088,28761
"6470","ENSG00000143429","","2",91805186,91847998,42812
"6471","ENSG00000143434","SEMA6C","1",151104161,151119104,14943
"6472","ENSG00000143436","MRPL9","1",151732119,151736040,3921
"6473","ENSG00000143437","ARNT","1",150782181,150849244,67063
"6474","ENSG00000143442","POGZ","1",151375200,151431941,56741
"6475","ENSG00000143443","C1orf56","1",151020216,151024462,4246
"6476","ENSG00000143450","OAZ3","1",151735445,151743808,8363
"6477","ENSG00000143457","GOLPH3L","1",150618701,150669630,50929
"6478","ENSG00000143458","GABPB2","1",151043054,151098018,54964
"6479","ENSG00000143466","IKBKE","1",206643791,206670223,26432
"6480","ENSG00000143469","SYT14","1",210111538,210337636,226098
"6481","ENSG00000143473","KCNH1","1",210856555,211307457,450902
"6482","ENSG00000143476","DTL","1",212208919,212280742,71823
"6483","ENSG00000143479","DYRK3","1",206808881,206857764,48883
"6484","ENSG00000143486","EIF2D","1",206744620,206785904,41284
"6485","ENSG00000143493","INTS7","1",212113741,212208884,95143
"6486","ENSG00000143494","VASH2","1",213123862,213165379,41517
"6487","ENSG00000143498","TAF1A","1",222731244,222763275,32031
"6488","ENSG00000143499","SMYD2","1",214454445,214510474,56029
"6489","ENSG00000143507","DUSP10","1",221874766,221915518,40752
"6490","ENSG00000143514","TP53BP2","1",223967601,224033674,66073
"6491","ENSG00000143515","ATP8B2","1",154298029,154323783,25754
"6492","ENSG00000143537","ADAM15","1",155023042,155035252,12210
"6493","ENSG00000143543","JTB","1",153946745,153950164,3419
"6494","ENSG00000143545","RAB13","1",153954127,153958834,4707
"6495","ENSG00000143549","TPM3","1",154127784,154167124,39340
"6496","ENSG00000143553","SNAPIN","1",153631130,153634306,3176
"6497","ENSG00000143554","SLC27A3","1",153746830,153752633,5803
"6498","ENSG00000143569","UBAP2L","1",154192655,154243986,51331
"6499","ENSG00000143570","SLC39A1","1",153931575,153940188,8613
"6500","ENSG00000143575","HAX1","1",154244987,154248351,3364
"6501","ENSG00000143578","CREB3L4","1",153940010,153946839,6829
"6502","ENSG00000143590","EFNA3","1",155036224,155060014,23790
"6503","ENSG00000143603","KCNN3","1",154669931,154842756,172825
"6504","ENSG00000143612","C1orf43","1",154179182,154193104,13922
"6505","ENSG00000143614","GATAD2B","1",153777201,153895451,118250
"6506","ENSG00000143621","ILF2","1",153634512,153643524,9012
"6507","ENSG00000143622","RIT1","1",155867599,155881195,13596
"6508","ENSG00000143624","INTS3","1",153700543,153746555,46012
"6509","ENSG00000143630","HCN3","1",155247374,155259639,12265
"6510","ENSG00000143631","FLG","1",152274651,152297679,23028
"6511","ENSG00000143633","C1orf131","1",231359509,231376933,17424
"6512","ENSG00000143641","GALNT2","1",230193536,230417870,224334
"6513","ENSG00000143643","TTC13","1",231041989,231114621,72632
"6514","ENSG00000143653","SCCPDH","1",246887349,246931439,44090
"6515","ENSG00000143669","LYST","1",235824341,236046940,222599
"6516","ENSG00000143674","","1",233463514,233520894,57380
"6517","ENSG00000143702","CEP170","1",243287730,243418650,130920
"6518","ENSG00000143727","ACP1","2",264140,278283,14143
"6519","ENSG00000143740","SNAP47","1",227916240,227968927,52687
"6520","ENSG00000143742","SRP9","1",225965531,225978168,12637
"6521","ENSG00000143748","NVL","1",224415036,224518089,103053
"6522","ENSG00000143751","SDE2","1",226170403,226187032,16629
"6523","ENSG00000143753","DEGS1","1",224363458,224381143,17685
"6524","ENSG00000143756","FBXO28","1",224301789,224349749,47960
"6525","ENSG00000143761","ARF1","1",228270361,228286912,16551
"6526","ENSG00000143771","CNIH4","1",224544552,224567161,22609
"6527","ENSG00000143772","ITPKB","1",226819391,226927024,107633
"6528","ENSG00000143774","GUK1","1",228327663,228336685,9022
"6529","ENSG00000143776","CDC42BPA","1",227177566,227506175,328609
"6530","ENSG00000143786","CNIH3","1",224622362,224928251,305889
"6531","ENSG00000143793","C1orf35","1",228288427,228293112,4685
"6532","ENSG00000143797","MBOAT2","2",8992820,9143942,151122
"6533","ENSG00000143799","PARP1","1",226548392,226595780,47388
"6534","ENSG00000143801","PSEN2","1",227057885,227083806,25921
"6535","ENSG00000143811","PYCR2","1",226107578,226111978,4400
"6536","ENSG00000143815","LBR","1",225589204,225616627,27423
"6537","ENSG00000143816","WNT9A","1",228106357,228135599,29242
"6538","ENSG00000143819","EPHX1","1",225997794,226033260,35466
"6539","ENSG00000143842","SOX13","1",204042243,204096863,54620
"6540","ENSG00000143845","ETNK2","1",204100190,204121307,21117
"6541","ENSG00000143847","PPFIA4","1",202995626,203047868,52242
"6542","ENSG00000143850","PLEKHA6","1",204187979,204346793,158814
"6543","ENSG00000143858","SYT2","1",202559724,202679545,119821
"6544","ENSG00000143862","ARL8A","1",202102532,202113869,11337
"6545","ENSG00000143869","GDF7","2",20866424,20873418,6994
"6546","ENSG00000143870","PDIA6","2",10923517,10978103,54586
"6547","ENSG00000143878","RHOB","2",20646835,20649200,2365
"6548","ENSG00000143889","HNRNPLL","2",38789120,38830728,41608
"6549","ENSG00000143891","GALM","2",38893052,38968379,75327
"6550","ENSG00000143919","CAMKMT","2",44589089,44999731,410642
"6551","ENSG00000143924","EML4","2",42396490,42559688,163198
"6552","ENSG00000143933","CALM2","2",47387221,47403740,16519
"6553","ENSG00000143942","CHAC2","2",53994929,54002333,7404
"6554","ENSG00000143947","RPS27A","2",55459039,55462989,3950
"6555","ENSG00000143951","WDPCP","2",63348518,64054977,706459
"6556","ENSG00000143952","VPS54","2",64119280,64246206,126926
"6557","ENSG00000143970","ASXL2","2",25956622,26101385,144763
"6558","ENSG00000143971","ETAA1","2",67624451,67637677,13226
"6559","ENSG00000143977","SNRPG","2",70508494,70520903,12409
"6560","ENSG00000143995","MEIS1","2",66660584,66801001,140417
"6561","ENSG00000144021","CIAO1","2",96931870,96939087,7217
"6562","ENSG00000144026","ZNF514","2",95813075,95831158,18083
"6563","ENSG00000144028","SNRNP200","2",96940074,96971297,31223
"6564","ENSG00000144029","MRPS5","2",95752952,95815179,62227
"6565","ENSG00000144034","TPRKB","2",73956231,73964527,8296
"6566","ENSG00000144036","EXOC6B","2",72403113,73053170,650057
"6567","ENSG00000144040","SFXN5","2",73169165,73302747,133582
"6568","ENSG00000144043","TEX261","2",71213068,71222075,9007
"6569","ENSG00000144048","DUSP11","2",73989311,74007284,17973
"6570","ENSG00000144057","ST6GAL2","2",107418056,107503564,85508
"6571","ENSG00000144061","NPHP1","2",110879888,110962643,82755
"6572","ENSG00000144115","THNSL2","2",88469835,88486146,16311
"6573","ENSG00000144118","RALB","2",120997640,121052289,54649
"6574","ENSG00000144120","TMEM177","2",120436743,120444083,7340
"6575","ENSG00000144134","RABL2A","2",114384806,114400973,16167
"6576","ENSG00000144136","SLC20A1","2",113403434,113421404,17970
"6577","ENSG00000144152","FBLN7","2",112895962,112945791,49829
"6578","ENSG00000144161","ZC3H8","2",112969102,113012713,43611
"6579","ENSG00000144182","LIPT1","2",99771418,99779620,8202
"6580","ENSG00000144191","CNGA3","2",98962618,99015064,52446
"6581","ENSG00000144199","FAHD2B","2",97749320,97760619,11299
"6582","ENSG00000144214","LYG1","2",99900701,99921205,20504
"6583","ENSG00000144218","AFF3","2",100162323,100759201,596878
"6584","ENSG00000144224","UBXN4","2",136499189,136542625,43436
"6585","ENSG00000144227","NXPH2","2",139428342,139537918,109576
"6586","ENSG00000144228","SPOPL","2",139259371,139331117,71746
"6587","ENSG00000144229","THSD7B","2",137523115,138435287,912172
"6588","ENSG00000144230","GPR17","2",128403439,128410213,6774
"6589","ENSG00000144231","POLR2D","2",128603840,128615731,11891
"6590","ENSG00000144233","AMMECR1L","2",128619204,128643496,24292
"6591","ENSG00000144278","GALNT13","2",154728426,155310361,581935
"6592","ENSG00000144283","PKP4","2",159313476,159539391,225915
"6593","ENSG00000144285","SCN1A","2",166845670,166984523,138853
"6594","ENSG00000144306","SCRN3","2",175260458,175294303,33845
"6595","ENSG00000144320","KIAA1715","2",176788620,176867567,78947
"6596","ENSG00000144331","ZNF385B","2",180306709,180726232,419523
"6597","ENSG00000144339","TMEFF2","2",192813769,193060435,246666
"6598","ENSG00000144354","CDCA7","2",174219548,174233725,14177
"6599","ENSG00000144357","UBR3","2",170683968,170940641,256673
"6600","ENSG00000144362","PHOSPHO2","2",170550975,170558218,7243
"6601","ENSG00000144366","GULP1","2",189156396,189460653,304257
"6602","ENSG00000144369","FAM171B","2",187558698,187630685,71987
"6603","ENSG00000144381","HSPD1","2",198351305,198381461,30156
"6604","ENSG00000144395","CCDC150","2",197504278,197628214,123936
"6605","ENSG00000144401","METTL21A","2",208445355,208490652,45297
"6606","ENSG00000144406","UNC80","2",210636717,210864024,227307
"6607","ENSG00000144426","NBEAL1","2",203879602,204091101,211499
"6608","ENSG00000144445","KANSL1L","2",210886147,211036107,149960
"6609","ENSG00000144451","SPAG16","2",214149113,215275225,1126112
"6610","ENSG00000144452","ABCA12","2",215796266,216003151,206885
"6611","ENSG00000144455","SUMF1","3",3742498,4508965,766467
"6612","ENSG00000144468","RHBDD1","2",227700297,227863931,163634
"6613","ENSG00000144476","ACKR3","2",237476430,237491001,14571
"6614","ENSG00000144485","HES6","2",239146908,239149303,2395
"6615","ENSG00000144504","ANKMY1","2",241418839,241508626,89787
"6616","ENSG00000144524","COPS7B","2",232646381,232673963,27582
"6617","ENSG00000144535","DIS3L2","2",232825955,233209060,383105
"6618","ENSG00000144554","FANCD2","3",10068098,10143614,75516
"6619","ENSG00000144559","TAMM41","3",11831916,11888393,56477
"6620","ENSG00000144560","VGLL4","3",11597544,11762220,164676
"6621","ENSG00000144566","RAB5A","3",19988571,20026667,38096
"6622","ENSG00000144567","FAM134A","2",220040947,220050201,9254
"6623","ENSG00000144579","CTDSP1","2",219262979,219270664,7685
"6624","ENSG00000144580","RQCD1","2",219433303,219461803,28500
"6625","ENSG00000144589","STK11IP","2",220462582,220481173,18591
"6626","ENSG00000144591","GMPPA","2",220363589,220371710,8121
"6627","ENSG00000144596","GRIP2","3",14530619,14583588,52969
"6628","ENSG00000144597","EAF1","3",15468862,15484120,15258
"6629","ENSG00000144635","DYNC1LI1","3",32567463,32612366,44903
"6630","ENSG00000144642","RBMS3","3",29322473,30051886,729413
"6631","ENSG00000144645","OSBPL10","3",31699382,32119072,419690
"6632","ENSG00000144647","POMGNT2","3",43120724,43147568,26844
"6633","ENSG00000144655","CSRNP1","3",39183346,39196053,12707
"6634","ENSG00000144659","SLC25A38","3",39424839,39438842,14003
"6635","ENSG00000144668","ITGA9","3",37493606,37865005,371399
"6636","ENSG00000144674","GOLGA4","3",37284668,37408242,123574
"6637","ENSG00000144677","CTDSPL","3",37903451,38025960,122509
"6638","ENSG00000144681","STAC","3",36421836,36589499,167663
"6639","ENSG00000144711","IQSEC1","3",12938719,13114617,175898
"6640","ENSG00000144712","CAND2","3",12837971,12913415,75444
"6641","ENSG00000144713","RPL32","3",12875984,12883087,7103
"6642","ENSG00000144724","PTPRG","3",61547243,62283288,736045
"6643","ENSG00000144730","IL17RD","3",57124010,57204334,80324
"6644","ENSG00000144736","SHQ1","3",72798428,72911065,112637
"6645","ENSG00000144741","SLC25A26","3",66119285,66438540,319255
"6646","ENSG00000144744","UBA3","3",69103881,69129559,25678
"6647","ENSG00000144746","ARL6IP5","3",69134095,69155217,21122
"6648","ENSG00000144747","TMF1","3",69068978,69101484,32506
"6649","ENSG00000144749","LRIG1","3",66429221,66551687,122466
"6650","ENSG00000144771","LRTM1","3",54952264,55001115,48851
"6651","ENSG00000144791","LIMD1","3",45596886,45727830,130944
"6652","ENSG00000144792","ZNF660","3",44619715,44641186,21471
"6653","ENSG00000144802","NFKBIZ","3",101546835,101579866,33031
"6654","ENSG00000144810","COL8A1","3",99357319,99518070,160751
"6655","ENSG00000144815","NXPE3","3",101498046,101547073,49027
"6656","ENSG00000144821","MYH15","3",108099216,108248169,148953
"6657","ENSG00000144824","PHLDB2","3",111451344,111695364,244020
"6658","ENSG00000144827","ABHD10","3",111697857,111712210,14353
"6659","ENSG00000144834","TAGLN3","3",111717511,111732734,15223
"6660","ENSG00000144840","RABL3","3",120405528,120461840,56312
"6661","ENSG00000144843","ADPRH","3",119298115,119308792,10677
"6662","ENSG00000144847","IGSF11","3",118619404,118864915,245511
"6663","ENSG00000144848","ATG3","3",112251356,112280893,29537
"6664","ENSG00000144857","BOC","3",112929850,113006303,76453
"6665","ENSG00000144867","SRPRB","3",133502877,133544616,41739
"6666","ENSG00000144868","TMEM108","3",132757235,133116636,359401
"6667","ENSG00000144891","AGTR1","3",148415571,148460795,45224
"6668","ENSG00000144893","MED12L","3",150803484,151154860,351376
"6669","ENSG00000144895","EIF2A","3",150264465,150302029,37564
"6670","ENSG00000144909","OSBPL11","3",125247702,125313934,66232
"6671","ENSG00000144935","TRPC1","3",142442916,142526730,83814
"6672","ENSG00000144959","NCEH1","3",172348039,172429008,80969
"6673","ENSG00000145012","LPP","3",187871072,188608460,737388
"6674","ENSG00000145014","TMEM44","3",194308402,194354418,46016
"6675","ENSG00000145016","KIAA0226","3",197398264,197476598,78334
"6676","ENSG00000145020","AMT","3",49454211,49460186,5975
"6677","ENSG00000145022","TCTA","3",49449639,49453908,4269
"6678","ENSG00000145029","NICN1","3",49460379,49466759,6380
"6679","ENSG00000145041","VPRBP","3",51433298,51534010,100712
"6680","ENSG00000145050","MANF","3",51422478,51426828,4350
"6681","ENSG00000145087","STXBP5L","3",120626919,121143608,516689
"6682","ENSG00000145088","EAF2","3",121554030,121605373,51343
"6683","ENSG00000145147","SLIT2","4",20254883,20622184,367301
"6684","ENSG00000145191","EIF2B5","3",183852826,184402546,549720
"6685","ENSG00000145194","ECE2","3",183967438,184010819,43381
"6686","ENSG00000145214","DGKQ","4",952675,980683,28008
"6687","ENSG00000145216","FIP1L1","4",54243810,55161439,917629
"6688","ENSG00000145220","LYAR","4",4269428,4291896,22468
"6689","ENSG00000145241","CENPC","4",68337521,68411324,73803
"6690","ENSG00000145242","EPHA5","4",66185281,66536213,350932
"6691","ENSG00000145246","ATP10D","4",47487305,47595503,108198
"6692","ENSG00000145247","OCIAD2","4",48887036,48908954,21918
"6693","ENSG00000145248","SLC10A4","4",48485360,48491213,5853
"6694","ENSG00000145284","SCD5","4",83550692,83720010,169318
"6695","ENSG00000145293","ENOPH1","4",83351715,83382244,30529
"6696","ENSG00000145331","TRMT10A","4",100467866,100485189,17323
"6697","ENSG00000145332","KLHL8","4",88081255,88161466,80211
"6698","ENSG00000145335","SNCA","4",90645250,90759466,114216
"6699","ENSG00000145337","PYURF","4",89442136,89444964,2828
"6700","ENSG00000145348","TBCK","4",106962756,107242652,279896
"6701","ENSG00000145349","CAMK2D","4",114372188,114683083,310895
"6702","ENSG00000145354","CISD2","4",103790135,103810399,20264
"6703","ENSG00000145358","DDIT4L","4",101107027,101111939,4912
"6704","ENSG00000145362","ANK2","4",113739265,114304896,565631
"6705","ENSG00000145365","TIFA","4",113195698,113207059,11361
"6706","ENSG00000145375","SPATA5","4",123844229,124240605,396376
"6707","ENSG00000145386","CCNA2","4",122737599,122745087,7488
"6708","ENSG00000145388","METTL14","4",119606523,119636588,30065
"6709","ENSG00000145390","USP53","4",120133742,120216672,82930
"6710","ENSG00000145391","SETD7","4",140417095,140527853,110758
"6711","ENSG00000145414","NAF1","4",164031225,164088073,56848
"6712","ENSG00000145416","MARCH1","4",164445450,165305202,859752
"6713","ENSG00000145423","SFRP2","4",154701744,154710272,8528
"6714","ENSG00000145425","RPS3A","4",152020725,152025804,5079
"6715","ENSG00000145428","RNF175","4",154631277,154681387,50110
"6716","ENSG00000145431","PDGFC","4",157681606,157892546,210940
"6717","ENSG00000145439","CBR4","4",169784921,169931426,146505
"6718","ENSG00000145451","GLRA3","4",175558065,175750465,192400
"6719","ENSG00000145476","CYP4V2","4",187112674,187134610,21936
"6720","ENSG00000145494","NDUFS6","5",1801514,1816719,15205
"6721","ENSG00000145495","MARCH6","5",10353815,10440500,86685
"6722","ENSG00000145506","NKD2","5",1008944,1039058,30114
"6723","ENSG00000145526","CDH18","5",19473060,20575982,1102922
"6724","ENSG00000145536","ADAMTS16","5",5140443,5320417,179974
"6725","ENSG00000145545","SRD5A1","5",6633456,6669675,36219
"6726","ENSG00000145555","MYO10","5",16665395,16936372,270977
"6727","ENSG00000145569","FAM105A","5",14581884,14615116,33232
"6728","ENSG00000145592","RPL37","5",40825364,40835437,10073
"6729","ENSG00000145604","SKP2","5",36152091,36184421,32330
"6730","ENSG00000145623","OSMR","5",38845960,38945698,99738
"6731","ENSG00000145632","PLK2","5",57749809,57756087,6278
"6732","ENSG00000145675","PIK3R1","5",67511548,67597649,86101
"6733","ENSG00000145681","HAPLN1","5",82933624,83017432,83808
"6734","ENSG00000145685","LHFPL2","5",77781038,78065844,284806
"6735","ENSG00000145687","SSBP2","5",80708840,81047616,338776
"6736","ENSG00000145700","ANKRD31","5",74364100,74532703,168603
"6737","ENSG00000145703","IQGAP2","5",75699074,76003957,304883
"6738","ENSG00000145715","RASA1","5",86563705,86687748,124043
"6739","ENSG00000145721","LIX1","5",96427574,96478576,51002
"6740","ENSG00000145723","GIN1","5",102421704,102455855,34151
"6741","ENSG00000145725","PPIP5K2","5",102455853,102548500,92647
"6742","ENSG00000145730","PAM","5",102089685,102366809,277124
"6743","ENSG00000145734","BDP1","5",70751442,70863649,112207
"6744","ENSG00000145736","GTF2H2","5",70330784,70363516,32732
"6745","ENSG00000145740","SLC30A5","5",68389473,68426896,37423
"6746","ENSG00000145741","BTF3","5",72794233,72801460,7227
"6747","ENSG00000145743","FBXL17","5",107194736,107717799,523063
"6748","ENSG00000145779","TNFAIP8","5",118604387,118735383,130996
"6749","ENSG00000145780","FEM1C","5",114856608,114880591,23983
"6750","ENSG00000145781","COMMD10","5",115420688,115748459,327771
"6751","ENSG00000145782","ATG12","5",115163893,115177555,13662
"6752","ENSG00000145794","MEGF10","5",126626523,126801429,174906
"6753","ENSG00000145808","ADAMTS19","5",128795958,129074376,278418
"6754","ENSG00000145817","YIPF5","5",143537723,143550278,12555
"6755","ENSG00000145819","ARHGAP26","5",142149949,142608576,458627
"6756","ENSG00000145824","CXCL14","5",134906373,134914969,8596
"6757","ENSG00000145833","DDX46","5",134094469,134190823,96354
"6758","ENSG00000145860","RNF145","5",158584417,158637061,52644
"6759","ENSG00000145861","C1QTNF2","5",159774758,159797648,22890
"6760","ENSG00000145868","FBXO38","5",147763498,147822399,58901
"6761","ENSG00000145882","PCYOX1L","5",148737570,148749216,11646
"6762","ENSG00000145901","TNIP1","5",150409506,150473138,63632
"6763","ENSG00000145907","G3BP1","5",151150606,151192346,41740
"6764","ENSG00000145908","ZNF300","5",150273954,150284545,10591
"6765","ENSG00000145911","N4BP3","5",177540444,177553088,12644
"6766","ENSG00000145912","NHP2","5",177576461,177580968,4507
"6767","ENSG00000145916","RMND5B","5",177557997,177577566,19569
"6768","ENSG00000145919","BOD1","5",173034517,173043663,9146
"6769","ENSG00000145920","CPLX2","5",175223313,175311023,87710
"6770","ENSG00000145934","TENM2","5",166711804,167691162,979358
"6771","ENSG00000145936","KCNMB1","5",169801675,169816681,15006
"6772","ENSG00000145945","FAM50B","6",3849620,3851551,1931
"6773","ENSG00000145949","MYLK4","6",2663863,2751200,87337
"6774","ENSG00000145979","TBC1D7","6",13266774,13328815,62041
"6775","ENSG00000145982","FARS2","6",5261277,5771813,510536
"6776","ENSG00000145990","GFOD1","6",13358062,13487894,129832
"6777","ENSG00000145996","CDKAL1","6",20534688,21232635,697947
"6778","ENSG00000146001","PCDHB18","5",140613938,140617101,3163
"6779","ENSG00000146005","PSD2","5",139175406,139224051,48645
"6780","ENSG00000146006","LRRTM2","5",138204612,138211057,6445
"6781","ENSG00000146007","ZMAT2","5",140078265,140086248,7983
"6782","ENSG00000146021","KLHL3","5",136953189,137071779,118590
"6783","ENSG00000146038","DCDC2","6",24171984,24358280,186296
"6784","ENSG00000146063","TRIM41","5",180649499,180662809,13310
"6785","ENSG00000146066","HIGD2A","5",175815748,175816772,1024
"6786","ENSG00000146067","FAM193B","5",176946789,176981542,34753
"6787","ENSG00000146072","TNFRSF21","6",47199268,47277641,78373
"6788","ENSG00000146083","RNF44","5",175953698,175965026,11328
"6789","ENSG00000146085","MUT","6",49398073,49430904,32831
"6790","ENSG00000146094","DOK3","5",176928908,176938275,9367
"6791","ENSG00000146109","ABT1","6",26597180,26600278,3098
"6792","ENSG00000146112","PPP1R18","6",30644166,30655672,11506
"6793","ENSG00000146122","DAAM2","6",39760142,39872648,112506
"6794","ENSG00000146143","PRIM2","6",57179603,57513375,333772
"6795","ENSG00000146147","MLIP","6",53794780,54131078,336298
"6796","ENSG00000146151","HMGCLL1","6",55299167,55444012,144845
"6797","ENSG00000146166","LGSN","6",63985856,64029882,44026
"6798","ENSG00000146197","SCUBE3","6",35182190,35220856,38666
"6799","ENSG00000146216","TTBK1","6",43211418,43255997,44579
"6800","ENSG00000146223","RPL7L1","6",42847356,42857663,10307
"6801","ENSG00000146232","NFKBIE","6",44225903,44233500,7597
"6802","ENSG00000146242","TPBG","6",83072923,83080545,7622
"6803","ENSG00000146243","IRAK1BP1","6",79577189,79656157,78968
"6804","ENSG00000146247","PHIP","6",79645584,79787953,142369
"6805","ENSG00000146250","PRSS35","6",84222194,84235423,13229
"6806","ENSG00000146263","MMS22L","6",97590037,97731093,141056
"6807","ENSG00000146267","FAXC","6",99719045,99797938,78893
"6808","ENSG00000146278","PNRC1","6",89790470,89794879,4409
"6809","ENSG00000146281","PM20D2","6",89855769,89875284,19515
"6810","ENSG00000146282","RARS2","6",88224096,88299721,75625
"6811","ENSG00000146350","TBC1D32","6",121400640,121655891,255251
"6812","ENSG00000146352","CLVS2","6",123317116,123394072,76956
"6813","ENSG00000146373","RNF217","6",125283691,125413779,130088
"6814","ENSG00000146374","RSPO3","6",127439749,127518910,79161
"6815","ENSG00000146376","ARHGAP18","6",129897277,130031370,134093
"6816","ENSG00000146386","ABRACL","6",139349819,139364439,14620
"6817","ENSG00000146409","SLC18B1","6",133090509,133119701,29192
"6818","ENSG00000146410","MTFR2","6",136552162,136571473,19311
"6819","ENSG00000146411","SLC2A12","6",134309835,134373774,63939
"6820","ENSG00000146414","SHPRH","6",146185381,146285559,100178
"6821","ENSG00000146416","AIG1","6",143381633,143661441,279808
"6822","ENSG00000146425","DYNLT1","6",159057506,159065771,8265
"6823","ENSG00000146426","TIAM2","6",155153831,155578857,425026
"6824","ENSG00000146433","TMEM181","6",158957468,159056460,98992
"6825","ENSG00000146457","WTAP","6",160146617,160177351,30734
"6826","ENSG00000146463","ZMYM4","1",35734568,35887659,153091
"6827","ENSG00000146476","C6orf211","6",151773422,151791236,17814
"6828","ENSG00000146530","VWDE","7",12370511,12443567,73056
"6829","ENSG00000146535","GNA12","7",2767746,2883958,116212
"6830","ENSG00000146540","C7orf50","7",1036622,1177896,141274
"6831","ENSG00000146555","SDK1","7",3341080,4308632,967552
"6832","ENSG00000146556","WASH2P","2",114341664,114356655,14991
"6833","ENSG00000146574","CCZ1B","7",6833765,6866401,32636
"6834","ENSG00000146576","C7orf26","7",6629648,6648357,18709
"6835","ENSG00000146587","RBAK","7",5085452,5109119,23667
"6836","ENSG00000146592","CREB5","7",28338940,28865511,526571
"6837","ENSG00000146648","EGFR","7",55086714,55324313,237599
"6838","ENSG00000146670","CDCA5","11",64833772,64851636,17864
"6839","ENSG00000146674","IGFBP3","7",45951949,45961473,9524
"6840","ENSG00000146676","PURB","7",44915896,44924960,9064
"6841","ENSG00000146701","MDH2","7",75677369,75696826,19457
"6842","ENSG00000146707","POMZP3","7",76239303,76256578,17275
"6843","ENSG00000146729","GBAS","7",56019486,56067874,48388
"6844","ENSG00000146731","CCT6A","7",56119323,56131682,12359
"6845","ENSG00000146733","PSPH","7",56078744,56119297,40553
"6846","ENSG00000146757","ZNF92","7",64838712,64866038,27326
"6847","ENSG00000146776","ATXN7L1","7",105245514,105517050,271536
"6848","ENSG00000146802","TMEM168","7",112402437,112430647,28210
"6849","ENSG00000146826","C7orf43","7",99752043,99756338,4295
"6850","ENSG00000146828","SLC12A9","7",100424442,100464631,40189
"6851","ENSG00000146830","GIGYF1","7",100277130,100287071,9941
"6852","ENSG00000146833","TRIM4","7",99474581,99517223,42642
"6853","ENSG00000146834","MEPCE","7",100026413,100031741,5328
"6854","ENSG00000146842","TMEM209","7",129804555,129847610,43055
"6855","ENSG00000146856","AGBL3","7",134671259,134832715,161456
"6856","ENSG00000146858","ZC3HAV1L","7",138710452,138720775,10323
"6857","ENSG00000146872","TLK2","17",60536019,60692842,156823
"6858","ENSG00000146909","NOM1","7",156742417,156765876,23459
"6859","ENSG00000146910","CNPY1","7",155266901,155326557,59656
"6860","ENSG00000146918","NCAPG2","7",158424003,158497520,73517
"6861","ENSG00000146938","NLGN4X","X",5758678,6146904,388226
"6862","ENSG00000146950","SHROOM2","X",9754496,9917483,162987
"6863","ENSG00000146963","C7orf55-LUC7L2","7",139025105,139108198,83093
"6864","ENSG00000146966","DENND2A","7",140218220,140373793,155573
"6865","ENSG00000147010","SH3KBP1","X",19552093,19905719,353626
"6866","ENSG00000147027","TMEM47","X",34645181,34675405,30224
"6867","ENSG00000147036","LANCL3","X",37430822,37543716,112894
"6868","ENSG00000147041","SYTL5","X",37865835,37988072,122237
"6869","ENSG00000147044","CASK","X",41374187,41782716,408529
"6870","ENSG00000147050","KDM6A","X",44732757,44971847,239090
"6871","ENSG00000147065","MSN","X",64808257,64961791,153534
"6872","ENSG00000147082","CCNB3","X",49967364,50094909,127545
"6873","ENSG00000147099","HDAC8","X",71549366,71792953,243587
"6874","ENSG00000147100","SLC16A2","X",73641085,73753752,112667
"6875","ENSG00000147117","ZNF157","X",47229982,47273704,43722
"6876","ENSG00000147118","ZNF182","X",47834250,47863377,29127
"6877","ENSG00000147119","CHST7","X",46433219,46457843,24624
"6878","ENSG00000147121","KRBOX4","X",46306292,46356857,50565
"6879","ENSG00000147123","NDUFB11","X",47001615,47004903,3288
"6880","ENSG00000147124","ZNF41","X",47305278,47342345,37067
"6881","ENSG00000147130","ZMYM3","X",70459474,70474996,15522
"6882","ENSG00000147133","TAF1","X",70586114,70752224,166110
"6883","ENSG00000147140","NONO","X",70503042,70521018,17976
"6884","ENSG00000147144","CCDC120","X",48911101,48927509,16408
"6885","ENSG00000147145","LPAR4","X",78003206,78012591,9385
"6886","ENSG00000147155","EBP","X",48379546,48387104,7558
"6887","ENSG00000147162","OGT","X",70752933,70795747,42814
"6888","ENSG00000147164","SNX12","X",70279094,70288273,9179
"6889","ENSG00000147166","ITGB1BP2","X",70521584,70525221,3637
"6890","ENSG00000147174","ACRC","X",70798261,70833433,35172
"6891","ENSG00000147180","ZNF711","X",84498997,84528368,29371
"6892","ENSG00000147202","DIAPH2","X",95939662,96859996,920334
"6893","ENSG00000147224","PRPS1","X",106871737,106894256,22519
"6894","ENSG00000147231","CXorf57","X",105855160,105922672,67512
"6895","ENSG00000147234","FRMPD3","X",106765680,106848481,82801
"6896","ENSG00000147251","DOCK11","X",117629861,117820126,190265
"6897","ENSG00000147255","IGSF1","X",130407480,130533677,126197
"6898","ENSG00000147257","GPC3","X",132669773,133119922,450149
"6899","ENSG00000147274","RBMX","X",135930163,135962923,32760
"6900","ENSG00000147316","MCPH1","8",6264113,6501144,237031
"6901","ENSG00000147324","MFHAS1","8",8640864,8751155,110291
"6902","ENSG00000147364","FBXO25","8",356428,421225,64797
"6903","ENSG00000147382","FAM58A","X",152853377,152865500,12123
"6904","ENSG00000147383","NSDHL","X",151999511,152038273,38762
"6905","ENSG00000147394","ZNF185","X",152082986,152142024,59038
"6906","ENSG00000147400","CETN2","X",151995517,151999321,3804
"6907","ENSG00000147403","RPL10","X",153618315,153637504,19189
"6908","ENSG00000147408","CSGALNACT1","8",19261672,19615540,353868
"6909","ENSG00000147416","ATP6V1B2","8",20054878,20084330,29452
"6910","ENSG00000147419","CCDC25","8",27590835,27630170,39335
"6911","ENSG00000147421","HMBOX1","8",28747911,28922281,174370
"6912","ENSG00000147437","GNRH1","8",25276776,25282170,5394
"6913","ENSG00000147439","BIN3","8",22477931,22526661,48730
"6914","ENSG00000147454","SLC25A37","8",23386318,23432976,46658
"6915","ENSG00000147457","CHMP7","8",23101150,23119512,18362
"6916","ENSG00000147459","DOCK5","8",25042238,25275598,233360
"6917","ENSG00000147465","STAR","8",38001167,38008783,7616
"6918","ENSG00000147471","PROSC","8",37620111,37637283,17172
"6919","ENSG00000147475","ERLIN2","8",37594117,37616619,22502
"6920","ENSG00000147481","SNTG1","8",50822349,51706678,884329
"6921","ENSG00000147485","PXDNL","8",52232138,52722005,489867
"6922","ENSG00000147488","ST18","8",53023399,53373519,350120
"6923","ENSG00000147509","RGS20","8",54764368,54871863,107495
"6924","ENSG00000147526","TACC1","8",38585704,38710546,124842
"6925","ENSG00000147533","GOLGA7","8",41347915,41368499,20584
"6926","ENSG00000147535","PPAPDC1B","8",38120648,38126761,6113
"6927","ENSG00000147536","GINS4","8",41386725,41402565,15840
"6928","ENSG00000147548","WHSC1L1","8",38127215,38239790,112575
"6929","ENSG00000147576","ADHFE1","8",67342420,67383836,41416
"6930","ENSG00000147586","MRPS28","8",80830952,80942524,111572
"6931","ENSG00000147592","LACTB2","8",71547553,71581409,33856
"6932","ENSG00000147601","TERF1","8",73921099,73960357,39258
"6933","ENSG00000147604","RPL7","8",74202506,74208024,5518
"6934","ENSG00000147642","SYBU","8",110586207,110704020,117813
"6935","ENSG00000147649","MTDH","8",98656407,98740998,84591
"6936","ENSG00000147650","LRP12","8",105501459,105601252,99793
"6937","ENSG00000147654","EBAG9","8",110551940,110578225,26285
"6938","ENSG00000147669","POLR2K","8",101162812,101166230,3418
"6939","ENSG00000147676","MAL2","8",120177273,120257913,80640
"6940","ENSG00000147677","EIF3H","8",117654369,117779164,124795
"6941","ENSG00000147679","UTP23","8",117778742,117861702,82960
"6942","ENSG00000147684","NDUFB9","8",125551344,125580751,29407
"6943","ENSG00000147687","TATDN1","8",125500726,125551699,50973
"6944","ENSG00000147789","ZNF7","8",146052849,146072894,20045
"6945","ENSG00000147799","ARHGAP39","8",145754563,145911194,156631
"6946","ENSG00000147813","NAPRT1","8",144656955,144660819,3864
"6947","ENSG00000147852","VLDLR","9",2621834,2660053,38219
"6948","ENSG00000147853","AK3","9",4711155,4742043,30888
"6949","ENSG00000147854","UHRF2","9",6413151,6507054,93903
"6950","ENSG00000147862","NFIB","9",14081842,14398982,317140
"6951","ENSG00000147872","PLIN2","9",19108373,19149288,40915
"6952","ENSG00000147874","HAUS6","9",19053141,19103117,49976
"6953","ENSG00000147883","CDKN2B","9",22002902,22009362,6460
"6954","ENSG00000147889","CDKN2A","9",21967751,21995300,27549
"6955","ENSG00000147894","C9orf72","9",27546544,27573864,27320
"6956","ENSG00000147905","ZCCHC7","9",37120536,37358146,237610
"6957","ENSG00000147912","FBXO10","9",37510889,37588871,77982
"6958","ENSG00000147955","SIGMAR1","9",34634719,34637806,3087
"6959","ENSG00000147996","CBWD5","9",70432004,70497240,65236
"6960","ENSG00000148019","CEP78","9",80850978,80894606,43628
"6961","ENSG00000148053","NTRK2","9",87283466,87638505,355039
"6962","ENSG00000148057","IDNK","9",86237964,86259045,21081
"6963","ENSG00000148082","SHC3","9",91628060,91793682,165622
"6964","ENSG00000148090","AUH","9",93976097,94124195,148098
"6965","ENSG00000148110","HIATL1","9",97136833,97223324,86491
"6966","ENSG00000148120","C9orf3","9",97488983,97849441,360458
"6967","ENSG00000148123","","9",103790991,104087417,296426
"6968","ENSG00000148143","ZNF462","9",109625378,109775915,150537
"6969","ENSG00000148153","INIP","9",115446206,115480516,34310
"6970","ENSG00000148154","UGCG","9",114659046,114697649,38603
"6971","ENSG00000148158","SNX30","9",115513118,115643951,130833
"6972","ENSG00000148175","STOM","9",124101355,124132531,31176
"6973","ENSG00000148180","GSN","9",123970072,124095121,125049
"6974","ENSG00000148187","MRRF","9",125026882,125085743,58861
"6975","ENSG00000148200","NR6A1","9",127279554,127533589,254035
"6976","ENSG00000148204","CRB2","9",126118449,126142603,24154
"6977","ENSG00000148218","ALAD","9",116148597,116163613,15016
"6978","ENSG00000148219","ASTN2","9",119187504,120177348,989844
"6979","ENSG00000148225","WDR31","9",116075502,116102578,27076
"6980","ENSG00000148229","POLE3","9",116169515,116172952,3437
"6981","ENSG00000148248","SURF4","9",136228325,136242970,14645
"6982","ENSG00000148288","GBGT1","9",136028340,136039332,10992
"6983","ENSG00000148290","SURF1","9",136218610,136223552,4942
"6984","ENSG00000148291","SURF2","9",136223428,136228045,4617
"6985","ENSG00000148296","SURF6","9",136197552,136203235,5683
"6986","ENSG00000148297","MED22","9",136205160,136214986,9826
"6987","ENSG00000148300","REXO4","9",136271186,136283164,11978
"6988","ENSG00000148303","RPL7A","9",136215069,136218281,3212
"6989","ENSG00000148308","GTF3C5","9",135906076,135933890,27814
"6990","ENSG00000148331","ASB6","9",132399171,132404444,5273
"6991","ENSG00000148334","PTGES2","9",130882972,130890741,7769
"6992","ENSG00000148335","NTMT1","9",132371163,132398209,27046
"6993","ENSG00000148337","CIZ1","9",130928343,130966662,38319
"6994","ENSG00000148339","SLC25A25","9",130830480,130871524,41044
"6995","ENSG00000148341","SH3GLB2","9",131769315,131790582,21267
"6996","ENSG00000148343","FAM73B","9",131798900,131834361,35461
"6997","ENSG00000148356","LRSAM1","9",130213765,130265780,52015
"6998","ENSG00000148358","GPR107","9",132815705,132902448,86743
"6999","ENSG00000148362","C9orf142","9",139886870,139888436,1566
"7000","ENSG00000148384","INPP5E","9",139323071,139334274,11203
"7001","ENSG00000148396","SEC16A","9",139334549,139372141,37592
"7002","ENSG00000148399","DPH7","9",140449356,140473387,24031
"7003","ENSG00000148400","NOTCH1","9",139388896,139440314,51418
"7004","ENSG00000148408","CACNA1B","9",140772241,141019076,246835
"7005","ENSG00000148411","NACC2","9",138898383,138987131,88748
"7006","ENSG00000148429","USP6NL","10",11495945,11653753,157808
"7007","ENSG00000148444","COMMD3","10",22604903,22609235,4332
"7008","ENSG00000148450","MSRB2","10",23384435,23410942,26507
"7009","ENSG00000148459","PDSS1","10",26986588,27035727,49139
"7010","ENSG00000148468","FAM171A1","10",15253642,15413061,159419
"7011","ENSG00000148481","FAM188A","10",15820169,15902519,82350
"7012","ENSG00000148484","RSU1","10",16632610,16859527,226917
"7013","ENSG00000148498","PARD3","10",34398488,35104253,705765
"7014","ENSG00000148516","ZEB1","10",31607424,31818742,211318
"7015","ENSG00000148541","FAM13C","10",61005890,61122939,117049
"7016","ENSG00000148572","NRBF2","10",64893050,64914783,21733
"7017","ENSG00000148600","CDHR1","10",85954410,85979377,24967
"7018","ENSG00000148606","POLR3A","10",79734907,79789303,54396
"7019","ENSG00000148634","HERC4","10",69681665,69835105,153440
"7020","ENSG00000148660","CAMK2G","10",75572259,75634343,62084
"7021","ENSG00000148672","GLUD1","10",88810243,88854623,44380
"7022","ENSG00000148677","ANKRD1","10",92671853,92681033,9180
"7023","ENSG00000148688","RPP30","10",92631473,92668312,36839
"7024","ENSG00000148690","FRA10AC1","10",95427640,95462329,34689
"7025","ENSG00000148700","ADD3","10",111756126,111895323,139197
"7026","ENSG00000148719","DNAJB12","10",74092588,74114988,22400
"7027","ENSG00000148730","EIF4EBP2","10",72164135,72188374,24239
"7028","ENSG00000148737","TCF7L2","10",114710009,114927437,217428
"7029","ENSG00000148773","MKI67","10",129894923,129924649,29726
"7030","ENSG00000148798","INA","10",105036920,105050108,13188
"7031","ENSG00000148803","FUOM","10",135168658,135171529,2871
"7032","ENSG00000148814","LRRC27","10",134145614,134195010,49396
"7033","ENSG00000148824","MTG1","10",135207598,135234811,27213
"7034","ENSG00000148832","PAOX","10",135192695,135205198,12503
"7035","ENSG00000148834","GSTO1","10",105995114,106027217,32103
"7036","ENSG00000148835","TAF5","10",105127724,105148822,21098
"7037","ENSG00000148840","PPRC1","10",103892787,103910082,17295
"7038","ENSG00000148841","ITPRIP","10",106071894,106098162,26268
"7039","ENSG00000148842","CNNM2","10",104678050,104849978,171928
"7040","ENSG00000148843","PDCD11","10",105156405,105206049,49644
"7041","ENSG00000148848","ADAM12","10",127700950,128077024,376074
"7042","ENSG00000148908","RGS10","10",121259340,121302220,42880
"7043","ENSG00000148925","BTBD10","11",13409548,13484844,75296
"7044","ENSG00000148926","ADM","11",10326227,10328944,2717
"7045","ENSG00000148935","GAS2","11",22647188,22834601,187413
"7046","ENSG00000148942","SLC5A12","11",26688566,26744974,56408
"7047","ENSG00000148943","LIN7C","11",27516123,27528320,12197
"7048","ENSG00000148948","LRRC4C","11",40135753,41481323,1345570
"7049","ENSG00000148950","IMMP1L","11",31453948,31531192,77244
"7050","ENSG00000148985","PGAP2","11",3818954,3847601,28647
"7051","ENSG00000149016","TUT1","11",62342517,62359649,17132
"7052","ENSG00000149050","ZNF214","11",7020549,7041599,21050
"7053","ENSG00000149054","ZNF215","11",6947635,7005863,58228
"7054","ENSG00000149084","HSD17B12","11",43577986,43878167,300181
"7055","ENSG00000149089","APIP","11",34874641,34938046,63405
"7056","ENSG00000149091","DGKZ","11",46354455,46402104,47649
"7057","ENSG00000149100","EIF3M","11",32605344,32627808,22464
"7058","ENSG00000149115","TNKS1BP1","11",57067112,57092426,25314
"7059","ENSG00000149131","SERPING1","11",57364860,57382326,17466
"7060","ENSG00000149136","SSRP1","11",57093459,57103351,9892
"7061","ENSG00000149150","SLC43A1","11",57252007,57283259,31252
"7062","ENSG00000149177","PTPRJ","11",48002113,48189670,187557
"7063","ENSG00000149179","C11orf49","11",46958240,47185936,227696
"7064","ENSG00000149182","ARFGAP2","11",47185848,47198676,12828
"7065","ENSG00000149187","CELF1","11",47487496,47587121,99625
"7066","ENSG00000149196","C11orf73","11",86013253,86056969,43716
"7067","ENSG00000149201","CCDC81","11",86085778,86134151,48373
"7068","ENSG00000149212","SESN3","11",94898704,94965705,67001
"7069","ENSG00000149218","ENDOD1","11",94822974,94865809,42835
"7070","ENSG00000149231","CCDC82","11",96085933,96123087,37154
"7071","ENSG00000149243","KLHL35","11",75133438,75141674,8236
"7072","ENSG00000149256","TENM4","11",78363876,79151992,788116
"7073","ENSG00000149257","SERPINH1","11",75273101,75283828,10727
"7074","ENSG00000149260","CAPN5","11",76777979,76837201,59222
"7075","ENSG00000149262","INTS4","11",77589766,77705724,115958
"7076","ENSG00000149269","PAK1","11",77032752,77185680,152928
"7077","ENSG00000149273","RPS3","11",75110530,75133324,22794
"7078","ENSG00000149289","ZC3H12C","11",109964087,110042566,78479
"7079","ENSG00000149292","TTC12","11",113185251,113254266,69015
"7080","ENSG00000149294","NCAM1","11",112831997,113149158,317161
"7081","ENSG00000149308","NPAT","11",108027942,108093369,65427
"7082","ENSG00000149311","ATM","11",108093211,108239829,146618
"7083","ENSG00000149313","AASDHPPT","11",105946228,105969437,23209
"7084","ENSG00000149328","GLB1L2","11",134201768,134248235,46467
"7085","ENSG00000149346","SLX4IP","20",10415951,10617477,201526
"7086","ENSG00000149357","LAMTOR1","11",71796941,71814433,17492
"7087","ENSG00000149380","P4HA3","11",73946846,74022702,75856
"7088","ENSG00000149403","GRIK4","11",120382468,120859613,477145
"7089","ENSG00000149428","HYOU1","11",118914900,118927913,13013
"7090","ENSG00000149474","CSRP2BP","20",18118762,18169031,50269
"7091","ENSG00000149476","DAK","11",61100682,61120767,20085
"7092","ENSG00000149480","MTA2","11",62360686,62369312,8626
"7093","ENSG00000149483","TMEM138","11",61129473,61136981,7508
"7094","ENSG00000149485","FADS1","11",61567099,61596790,29691
"7095","ENSG00000149489","ROM1","11",62379194,62382592,3398
"7096","ENSG00000149499","EML3","11",62369690,62380237,10547
"7097","ENSG00000149503","INCENP","11",61891445,61920635,29190
"7098","ENSG00000149531","FRG1B","20",29611857,29634010,22153
"7099","ENSG00000149532","CPSF7","11",61170121,61197503,27382
"7100","ENSG00000149541","B3GAT3","11",62382768,62389647,6879
"7101","ENSG00000149547","EI24","11",125439112,125454575,15463
"7102","ENSG00000149548","CCDC15","11",124824017,124911385,87368
"7103","ENSG00000149554","CHEK1","11",125495036,125546150,51114
"7104","ENSG00000149557","FEZ1","11",125315646,125366213,50567
"7105","ENSG00000149564","ESAM","11",124622026,124632186,10160
"7106","ENSG00000149571","KIRREL3","11",126293254,126873355,580101
"7107","ENSG00000149577","SIDT2","11",117049449,117068160,18711
"7108","ENSG00000149582","TMEM25","11",118401756,118417995,16239
"7109","ENSG00000149591","TAGLN","11",117070037,117075498,5461
"7110","ENSG00000149600","COMMD7","20",31290493,31331803,41310
"7111","ENSG00000149633","KIAA1755","20",36838890,36889174,50284
"7112","ENSG00000149634","SPATA25","20",44515128,44516274,1146
"7113","ENSG00000149636","DSN1","20",35380194,35402221,22027
"7114","ENSG00000149639","SOGA1","20",35405845,35492089,86244
"7115","ENSG00000149657","LSM14B","20",60697517,60710434,12917
"7116","ENSG00000149658","YTHDF1","20",61826781,61847586,20805
"7117","ENSG00000149679","CABLES2","20",60963688,60982341,18653
"7118","ENSG00000149716","ORAOV1","11",69467844,69490184,22340
"7119","ENSG00000149743","TRPT1","11",63991271,63993726,2455
"7120","ENSG00000149761","NUDT22","11",63993413,63998158,4745
"7121","ENSG00000149781","FERMT3","11",63974150,63991354,17204
"7122","ENSG00000149782","PLCB3","11",64018995,64036622,17627
"7123","ENSG00000149792","MRPL49","11",64889655,64894843,5188
"7124","ENSG00000149798","CDC42EP2","11",65082289,65089900,7611
"7125","ENSG00000149806","FAU","11",64888100,64889945,1845
"7126","ENSG00000149809","TM7SF2","11",64879317,64883856,4539
"7127","ENSG00000149823","VPS51","11",64856796,64879332,22536
"7128","ENSG00000149923","PPP4C","16",30087299,30096698,9399
"7129","ENSG00000149925","ALDOA","16",30064411,30081778,17367
"7130","ENSG00000149926","FAM57B","16",30035748,30064299,28551
"7131","ENSG00000149927","DOC2A","16",30016830,30034591,17761
"7132","ENSG00000149929","HIRIP3","16",30003645,30007757,4112
"7133","ENSG00000149930","TAOK2","16",29984962,30003582,18620
"7134","ENSG00000149932","TMEM219","16",29952206,29984373,32167
"7135","ENSG00000149948","HMGA2","12",66217911,66360075,142164
"7136","ENSG00000149970","CNKSR2","X",21392536,21672813,280277
"7137","ENSG00000150054","MPP7","10",28339922,28623415,283493
"7138","ENSG00000150076","","10",32832297,33171802,339505
"7139","ENSG00000150093","ITGB1","10",33189247,33294720,105473
"7140","ENSG00000150244","TRIM48","11",55029658,55038595,8937
"7141","ENSG00000150275","PCDH15","10",55562531,57387702,1825171
"7142","ENSG00000150281","CTF1","16",30907928,30914881,6953
"7143","ENSG00000150316","CWC15","11",94695787,94706776,10989
"7144","ENSG00000150347","ARID5B","10",63661059,63856703,195644
"7145","ENSG00000150361","KLHL1","13",70274726,70682591,407865
"7146","ENSG00000150394","CDH8","16",61681146,62070939,389793
"7147","ENSG00000150401","DCUN1D2","13",114110134,114145267,35133
"7148","ENSG00000150403","TMCO3","13",114145310,114204542,59232
"7149","ENSG00000150433","TMEM218","11",124966398,124981659,15261
"7150","ENSG00000150455","TIRAP","11",126152960,126168740,15780
"7151","ENSG00000150456","N6AMT2","13",21302870,21348097,45227
"7152","ENSG00000150457","LATS2","13",21547171,21635686,88515
"7153","ENSG00000150459","SAP18","13",21714653,21723221,8568
"7154","ENSG00000150471","LPHN3","4",62066976,62944053,877077
"7155","ENSG00000150477","KIAA1328","18",34409069,34812135,403066
"7156","ENSG00000150510","FAM124A","13",51796503,51858377,61874
"7157","ENSG00000150527","CTAGE5","14",39734488,39856156,121668
"7158","ENSG00000150540","HNMT","2",138721590,138773930,52340
"7159","ENSG00000150551","LYPD1","2",133402426,133429152,26726
"7160","ENSG00000150556","LYPD6B","2",149894621,150071776,177155
"7161","ENSG00000150593","PDCD4","10",112631565,112659764,28199
"7162","ENSG00000150625","GPM6A","4",176554085,176923815,369730
"7163","ENSG00000150627","WDR17","4",176986985,177103978,116993
"7164","ENSG00000150630","VEGFC","4",177604689,177713881,109192
"7165","ENSG00000150636","CCDC102B","18",66382446,66722426,339980
"7166","ENSG00000150637","CD226","18",67498394,67629039,130645
"7167","ENSG00000150667","FSIP1","15",39892232,40075031,182799
"7168","ENSG00000150672","DLG2","11",83166055,85338966,2172911
"7169","ENSG00000150687","PRSS23","11",86502101,86663952,161851
"7170","ENSG00000150712","MTMR12","5",32227100,32313115,86015
"7171","ENSG00000150753","CCT5","5",10250033,10266524,16491
"7172","ENSG00000150756","FAM173B","5",10226442,10250009,23567
"7173","ENSG00000150760","DOCK1","10",128593978,129250781,656803
"7174","ENSG00000150764","DIXDC1","11",111797868,111893308,95440
"7175","ENSG00000150768","DLAT","11",111895538,111935114,39576
"7176","ENSG00000150773","PIH1D2","11",111934734,111944998,10264
"7177","ENSG00000150776","C11orf57","11",111944810,111955874,11064
"7178","ENSG00000150779","TIMM8B","11",111955524,111957522,1998
"7179","ENSG00000150787","PTS","11",112097088,112140678,43590
"7180","ENSG00000150867","PIP4K2A","10",22823778,23003484,179706
"7181","ENSG00000150893","FREM2","13",39261266,39460074,198808
"7182","ENSG00000150907","FOXO1","13",41129804,41240734,110930
"7183","ENSG00000150938","CRIM1","2",36583069,36778278,195209
"7184","ENSG00000150961","SEC24D","4",119643978,119759838,115860
"7185","ENSG00000150967","ABCB9","12",123405498,123466196,60698
"7186","ENSG00000150977","RILPL2","12",123899936,123921264,21328
"7187","ENSG00000150990","DHX37","12",125431371,125473668,42297
"7188","ENSG00000150991","UBC","12",125396150,125401914,5764
"7189","ENSG00000150995","ITPR1","3",4535032,4889524,354492
"7190","ENSG00000151006","PRSS53","16",31094746,31100949,6203
"7191","ENSG00000151012","SLC7A11","4",139085251,139163503,78252
"7192","ENSG00000151014","CCRN4L","4",139936943,139966906,29963
"7193","ENSG00000151023","ENKUR","10",25270908,25305089,34181
"7194","ENSG00000151025","GPR158","10",25463991,25891155,427164
"7195","ENSG00000151065","DCP1B","12",2055220,2113701,58481
"7196","ENSG00000151067","CACNA1C","12",2079952,2802108,722156
"7197","ENSG00000151079","KCNA6","12",4918342,4960277,41935
"7198","ENSG00000151090","THRB","3",24158651,24536773,378122
"7199","ENSG00000151092","NGLY1","3",25760435,25831530,71095
"7200","ENSG00000151093","OXSM","3",25824408,25836025,11617
"7201","ENSG00000151116","UEVLD","11",18551156,18610294,59138
"7202","ENSG00000151117","TMEM86A","11",18714669,18726332,11663
"7203","ENSG00000151131","C12orf45","12",105380088,105443515,63427
"7204","ENSG00000151135","C12orf23","12",107349497,107372556,23059
"7205","ENSG00000151136","BTBD11","12",107712190,108053419,341229
"7206","ENSG00000151148","UBE3B","12",109915207,109974507,59300
"7207","ENSG00000151150","ANK3","10",61786056,62493248,707192
"7208","ENSG00000151151","IPMK","10",59951278,60027694,76416
"7209","ENSG00000151164","RAD9B","12",110939460,110969891,30431
"7210","ENSG00000151176","PLBD2","12",113796371,113827203,30832
"7211","ENSG00000151208","DLG5","10",79550549,79686378,135829
"7212","ENSG00000151229","SLC2A13","12",40148823,40499891,351068
"7213","ENSG00000151233","GXYLT1","12",42475647,42538681,63034
"7214","ENSG00000151239","TWF1","12",44187526,44200178,12652
"7215","ENSG00000151240","DIP2C","10",320130,735683,415553
"7216","ENSG00000151247","EIF4E","4",99792835,99851788,58953
"7217","ENSG00000151276","MAGI1","3",65339200,66024509,685309
"7218","ENSG00000151287","TEX30","13",103418340,103426161,7821
"7219","ENSG00000151292","CSNK1G3","5",122847793,122952739,104946
"7220","ENSG00000151304","SRFBP1","5",121297656,121411265,113609
"7221","ENSG00000151320","AKAP6","14",32798479,33300567,502088
"7222","ENSG00000151322","NPAS3","14",33404139,34273382,869243
"7223","ENSG00000151327","FAM177A1","14",35514113,35582336,68223
"7224","ENSG00000151332","MBIP","14",36767770,36789882,22112
"7225","ENSG00000151338","MIPOL1","14",37667118,38021566,354448
"7226","ENSG00000151348","EXT2","11",44117099,44266979,149880
"7227","ENSG00000151353","TMEM18","2",667335,677439,10104
"7228","ENSG00000151364","KCTD14","11",77726761,77757237,30476
"7229","ENSG00000151366","NDUFC2","11",77779350,77791265,11915
"7230","ENSG00000151376","ME3","11",86152150,86383678,231528
"7231","ENSG00000151388","ADAMTS12","5",33523640,33892297,368657
"7232","ENSG00000151413","NUBPL","14",31959162,32330430,371268
"7233","ENSG00000151414","NEK7","1",198126093,198291550,165457
"7234","ENSG00000151422","FER","5",108083523,108532542,449019
"7235","ENSG00000151445","VIPAS39","14",77893018,77924295,31277
"7236","ENSG00000151458","ANKRD50","4",125585207,125633887,48680
"7237","ENSG00000151461","UPF2","10",11962021,12085169,123148
"7238","ENSG00000151465","CDC123","10",12237964,12292588,54624
"7239","ENSG00000151466","SCLT1","4",129786076,130014764,228688
"7240","ENSG00000151468","CCDC3","10",12938627,13141652,203025
"7241","ENSG00000151470","C4orf33","4",130014472,130037795,23323
"7242","ENSG00000151474","FRMD4A","10",13685706,14504141,818435
"7243","ENSG00000151490","PTPRO","12",15475331,15750333,275002
"7244","ENSG00000151491","EPS8","12",15773092,16035263,262171
"7245","ENSG00000151498","ACAD8","11",134123389,134135749,12360
"7246","ENSG00000151500","THYN1","11",134118173,134123264,5091
"7247","ENSG00000151502","VPS26B","11",134094539,134117686,23147
"7248","ENSG00000151503","NCAPD3","11",134020014,134095348,75334
"7249","ENSG00000151532","VTI1A","10",114206756,114578503,371747
"7250","ENSG00000151552","QDPR","4",17461884,17513857,51973
"7251","ENSG00000151553","FAM160B1","10",116581503,116659591,78088
"7252","ENSG00000151572","ANO4","12",101111304,101522419,411115
"7253","ENSG00000151575","TEX9","15",56536207,56738195,201988
"7254","ENSG00000151576","QTRTD1","3",113724680,113807269,82589
"7255","ENSG00000151611","MMAA","4",146539415,146581187,41772
"7256","ENSG00000151612","ZNF827","4",146678779,146859787,181008
"7257","ENSG00000151615","POU4F2","4",147560045,147563626,3581
"7258","ENSG00000151617","EDNRA","4",148402069,148466106,64037
"7259","ENSG00000151623","NR3C2","4",148999913,149365850,365937
"7260","ENSG00000151632","AKR1C2","10",5029967,5060223,30256
"7261","ENSG00000151640","DPYSL4","10",134000404,134019280,18876
"7262","ENSG00000151657","KIN","10",7792925,7829990,37065
"7263","ENSG00000151665","PIGF","2",46808076,46844258,36182
"7264","ENSG00000151687","ANKAR","2",190539016,190625919,86903
"7265","ENSG00000151689","INPP1","2",191208196,191236391,28195
"7266","ENSG00000151690","MFSD6","2",191273081,191373931,100850
"7267","ENSG00000151692","RNF144A","2",7057523,7208417,150894
"7268","ENSG00000151693","ASAP2","2",9346894,9545812,198918
"7269","ENSG00000151694","ADAM17","2",9628615,9695921,67306
"7270","ENSG00000151702","FLI1","11",128556430,128683162,126732
"7271","ENSG00000151718","WWC2","4",184020446,184241930,221484
"7272","ENSG00000151725","CENPU","4",185615772,185655287,39515
"7273","ENSG00000151726","ACSL1","4",185676749,185747972,71223
"7274","ENSG00000151729","SLC25A4","4",186064395,186071536,7141
"7275","ENSG00000151743","AMN1","12",31824071,31882108,58037
"7276","ENSG00000151746","BICD1","12",32259769,32536567,276798
"7277","ENSG00000151748","SAV1","14",51098776,51135049,36273
"7278","ENSG00000151773","CCDC122","13",44398045,44453827,55782
"7279","ENSG00000151778","SERP2","13",44947801,44971850,24049
"7280","ENSG00000151779","NBAS","2",15307032,15701454,394422
"7281","ENSG00000151789","ZNF385D","3",21459915,22414812,954897
"7282","ENSG00000151806","GUF1","4",44680444,44702943,22499
"7283","ENSG00000151835","SACS","13",23902965,24007841,104876
"7284","ENSG00000151849","CENPJ","13",25457171,25497018,39847
"7285","ENSG00000151876","FBXO4","5",41925356,41941845,16489
"7286","ENSG00000151881","C5orf28","5",43444354,43483995,39641
"7287","ENSG00000151883","PARP8","5",49961733,50142356,180623
"7288","ENSG00000151892","GFRA1","10",117816444,118032979,216535
"7289","ENSG00000151893","CACUL1","10",120433679,120514761,81082
"7290","ENSG00000151914","DST","6",56322785,56819426,496641
"7291","ENSG00000151917","BEND6","6",56819773,56892140,72367
"7292","ENSG00000151923","TIAL1","10",121334199,121356541,22342
"7293","ENSG00000151929","BAG3","10",121410882,121437331,26449
"7294","ENSG00000151967","SCHIP1","3",159557650,159615149,57499
"7295","ENSG00000152022","LIX1L","1",145477085,145501669,24584
"7296","ENSG00000152042","NBPF11","1",146032647,146082765,50118
"7297","ENSG00000152056","AP1S3","2",224616403,224702744,86341
"7298","ENSG00000152061","RABGAP1L","1",174128548,174964445,835897
"7299","ENSG00000152076","CCDC74B","2",130896860,130902707,5847
"7300","ENSG00000152078","TMEM56","1",95582894,95663163,80269
"7301","ENSG00000152082","MZT2B","2",130939310,130948302,8992
"7302","ENSG00000152092","ASTN1","1",176826438,177134109,307671
"7303","ENSG00000152102","FAM168B","2",131805449,131851033,45584
"7304","ENSG00000152104","PTPN14","1",214522039,214725792,203753
"7305","ENSG00000152117","","2",132250386,132279146,28760
"7306","ENSG00000152127","MGAT5","2",134877554,135212192,334638
"7307","ENSG00000152128","TMEM163","2",135213330,135476570,263240
"7308","ENSG00000152133","GPATCH11","2",37311594,37326387,14793
"7309","ENSG00000152147","GEMIN6","2",38978676,39012142,33466
"7310","ENSG00000152154","TMEM178A","2",39892122,39945103,52981
"7311","ENSG00000152192","POU4F1","13",79172497,79177673,5176
"7312","ENSG00000152193","RNF219","13",79188426,79233314,44888
"7313","ENSG00000152208","GRID2","4",93225550,94695707,1470157
"7314","ENSG00000152217","SETBP1","18",42260138,42648475,388337
"7315","ENSG00000152219","ARL14EP","11",30344598,30359774,15176
"7316","ENSG00000152223","EPG5","18",43427574,43547240,119666
"7317","ENSG00000152229","PSTPIP2","18",43563502,43652238,88736
"7318","ENSG00000152234","ATP5A1","18",43664110,43684300,20190
"7319","ENSG00000152240","HAUS1","18",43684298,43708299,24001
"7320","ENSG00000152242","C18orf25","18",43753519,43846949,93430
"7321","ENSG00000152253","SPC25","2",169690642,169769881,79239
"7322","ENSG00000152256","PDK1","2",173420101,173489823,69722
"7323","ENSG00000152268","SPON1","11",13983914,14289646,305732
"7324","ENSG00000152270","PDE3B","11",14665269,14892350,227081
"7325","ENSG00000152284","TCF7L1","2",85360533,85537511,176978
"7326","ENSG00000152291","TGOLN2","2",85545147,85555548,10401
"7327","ENSG00000152332","UHMK1","1",162467041,162499419,32378
"7328","ENSG00000152348","ATG10","5",81267844,81572676,304832
"7329","ENSG00000152359","POC5","5",74969949,75013313,43364
"7330","ENSG00000152377","SPOCK1","5",136310987,136934068,623081
"7331","ENSG00000152380","FAM151B","5",79783788,79838382,54594
"7332","ENSG00000152382","TADA1","1",166825747,166845564,19817
"7333","ENSG00000152402","GUCY1A2","11",106544738,106889250,344512
"7334","ENSG00000152404","CWF19L2","11",107197071,107328572,131501
"7335","ENSG00000152409","JMY","5",78532012,78623038,91026
"7336","ENSG00000152413","HOMER1","5",78668459,78810040,141581
"7337","ENSG00000152422","XRCC4","5",82373317,82649606,276289
"7338","ENSG00000152433","ZNF547","19",57874845,57890933,16088
"7339","ENSG00000152439","ZNF773","19",58011283,58029772,18489
"7340","ENSG00000152443","ZNF776","19",58258164,58269527,11363
"7341","ENSG00000152454","ZNF256","19",58452201,58459043,6842
"7342","ENSG00000152455","SUV39H2","10",14920819,14946314,25495
"7343","ENSG00000152457","DCLRE1C","10",14939358,14996431,57073
"7344","ENSG00000152464","RPP38","10",15139179,15181817,42638
"7345","ENSG00000152465","NMT2","10",15144583,15210692,66109
"7346","ENSG00000152475","ZNF837","19",58878985,58892427,13442
"7347","ENSG00000152484","USP12","13",27640293,27746033,105740
"7348","ENSG00000152487","ARL5B-AS1","10",18940195,18948214,8019
"7349","ENSG00000152492","CCDC50","3",191046866,191116459,69593
"7350","ENSG00000152495","CAMK4","5",110559351,110830584,271233
"7351","ENSG00000152503","TRIM36","5",114460459,114516243,55784
"7352","ENSG00000152518","ZFP36L2","2",43449541,43453748,4207
"7353","ENSG00000152520","PAN3","13",28712643,28869475,156832
"7354","ENSG00000152527","PLEKHH2","2",43864412,43995126,130714
"7355","ENSG00000152556","PFKM","12",48498922,48540187,41265
"7356","ENSG00000152558","TMEM123","11",102267063,102341115,74052
"7357","ENSG00000152578","GRIA4","11",105480721,105852819,372098
"7358","ENSG00000152580","IGSF10","3",151143172,151176497,33325
"7359","ENSG00000152582","SPEF2","5",35617946,35814713,196767
"7360","ENSG00000152583","SPARCL1","4",88394487,88452213,57726
"7361","ENSG00000152601","MBNL1","3",151961617,152183569,221952
"7362","ENSG00000152620","NADK2","5",36192694,36242381,49687
"7363","ENSG00000152642","GPD1L","3",32147181,32210205,63024
"7364","ENSG00000152661","GJA1","6",121756838,121770873,14035
"7365","ENSG00000152683","SLC30A6","2",32390933,32449448,58515
"7366","ENSG00000152684","PELO","5",52083774,52099880,16106
"7367","ENSG00000152700","SAR1B","5",133936834,133984961,48127
"7368","ENSG00000152726","FAM21B","10",47894023,47949412,55389
"7369","ENSG00000152749","GPR180","13",95254157,95286899,32742
"7370","ENSG00000152763","WDR78","1",67278568,67390570,112002
"7371","ENSG00000152767","FARP1","13",98794816,99102027,307211
"7372","ENSG00000152778","IFIT5","10",91174343,91180758,6415
"7373","ENSG00000152782","PANK1","10",91342745,91405215,62470
"7374","ENSG00000152784","PRDM8","4",81105033,81125483,20450
"7375","ENSG00000152785","BMP3","4",81952119,81978685,26566
"7376","ENSG00000152795","HNRNPDL","4",83343717,83351294,7577
"7377","ENSG00000152804","HHEX","10",94447945,94455403,7458
"7378","ENSG00000152818","UTRN","6",144606837,145174170,567333
"7379","ENSG00000152822","GRM1","6",146348782,146758734,409952
"7380","ENSG00000152894","PTPRK","6",128289924,128841870,551946
"7381","ENSG00000152904","GGPS1","1",235490665,235507847,17182
"7382","ENSG00000152926","ZNF117","7",64432154,64467062,34908
"7383","ENSG00000152932","RAB3C","5",57878048,58155213,277165
"7384","ENSG00000152939","MARVELD2","5",68710939,68740157,29218
"7385","ENSG00000152942","RAD17","5",68665120,68710628,45508
"7386","ENSG00000152944","MED21","12",27175479,27219276,43797
"7387","ENSG00000152952","PLOD2","3",145787227,145881440,94213
"7388","ENSG00000152953","STK32B","4",5053169,5502725,449556
"7389","ENSG00000152977","ZIC1","3",147111209,147228080,116871
"7390","ENSG00000152990","GPR125","4",22346694,22517677,170983
"7391","ENSG00000153006","SREK1IP1","5",64013971,64064512,50541
"7392","ENSG00000153012","LGI2","4",25000469,25032501,32032
"7393","ENSG00000153015","CWC27","5",64064757,64314590,249833
"7394","ENSG00000153037","SRP19","5",112196919,112205485,8566
"7395","ENSG00000153044","CENPH","5",68485375,68506184,20809
"7396","ENSG00000153046","CDYL","6",4706393,4955785,249392
"7397","ENSG00000153048","CARHSP1","16",8946799,8962866,16067
"7398","ENSG00000153066","TXNDC11","16",11772936,11836734,63798
"7399","ENSG00000153071","DAB2","5",39371780,39462402,90622
"7400","ENSG00000153094","BCL2L11","2",111876955,111926024,49069
"7401","ENSG00000153107","ANAPC1","2",112523848,112642267,118419
"7402","ENSG00000153113","CAST","5",95860971,96115299,254328
"7403","ENSG00000153130","SCOC","4",141178440,141306880,128440
"7404","ENSG00000153132","CLGN","4",141309609,141349122,39513
"7405","ENSG00000153140","CETN3","5",89688078,89705603,17525
"7406","ENSG00000153147","SMARCA5","4",144434616,144478639,44023
"7407","ENSG00000153157","SYCP2L","6",10748027,10979553,231526
"7408","ENSG00000153162","BMP6","6",7727030,7881655,154625
"7409","ENSG00000153165","RGPD3","2",107021446,107084832,63386
"7410","ENSG00000153179","RASSF3","12",65004293,65091347,87054
"7411","ENSG00000153187","HNRNPU","1",245014468,245027844,13376
"7412","ENSG00000153201","RANBP2","2",109335937,109402267,66330
"7413","ENSG00000153207","AHCTF1","1",247002400,247095280,92880
"7414","ENSG00000153208","MERTK","2",112656056,112787138,131082
"7415","ENSG00000153214","TMEM87B","2",112812800,112876895,64095
"7416","ENSG00000153234","NR4A2","2",157180944,157198860,17916
"7417","ENSG00000153237","CCDC148","2",159027593,159313265,285672
"7418","ENSG00000153246","PLA2R1","2",160788519,160919121,130602
"7419","ENSG00000153250","RBMS1","2",161128662,161350305,221643
"7420","ENSG00000153253","SCN3A","2",165944032,166060577,116545
"7421","ENSG00000153291","SLC25A27","6",46620678,46645930,25252
"7422","ENSG00000153292","GPR110","6",46965440,47010099,44659
"7423","ENSG00000153310","FAM49B","8",130851839,131029375,177536
"7424","ENSG00000153317","ASAP1","8",131064353,131455906,391553
"7425","ENSG00000153339","TRAPPC8","18",29409136,29533099,123963
"7426","ENSG00000153363","LINC00467","1",211556145,211605878,49733
"7427","ENSG00000153391","INO80C","18",33032194,33077955,45761
"7428","ENSG00000153395","LPCAT1","5",1456595,1524092,67497
"7429","ENSG00000153404","PLEKHG4B","5",140373,190085,49712
"7430","ENSG00000153406","NMRAL1","16",4511681,4545764,34083
"7431","ENSG00000153443","UBALD1","16",4658884,4665028,6144
"7432","ENSG00000153485","TMEM251","14",93651296,93653434,2138
"7433","ENSG00000153487","ING1","13",111365083,111373421,8338
"7434","ENSG00000153531","ADPRHL1","13",114076260,114107839,31579
"7435","ENSG00000153551","CMTM7","3",32433163,32524559,91396
"7436","ENSG00000153558","FBXL2","3",33318517,33445154,126637
"7437","ENSG00000153560","UBP1","3",33429828,33482863,53035
"7438","ENSG00000153561","RMND5A","2",86947296,87005164,57868
"7439","ENSG00000153574","RPIA","2",88991162,89050452,59290
"7440","ENSG00000153575","TUBGCP5","15",22833395,22873892,40497
"7441","ENSG00000153707","PTPRD","9",8314246,10612723,2298477
"7442","ENSG00000153721","CNKSR3","6",154708638,154831793,123155
"7443","ENSG00000153767","GTF2E1","3",120461484,120501916,40432
"7444","ENSG00000153774","CFDP1","16",75327596,75467383,139787
"7445","ENSG00000153786","ZDHHC7","16",85007787,85045141,37354
"7446","ENSG00000153790","C7orf31","7",25174316,25219975,45659
"7447","ENSG00000153814","JAZF1","7",27870192,28220362,350170
"7448","ENSG00000153815","CMIP","16",81478775,81745367,266592
"7449","ENSG00000153823","PID1","2",229715242,230136001,420759
"7450","ENSG00000153827","TRIP12","2",230628554,230787955,159401
"7451","ENSG00000153832","FBXO36","2",230787018,230877825,90807
"7452","ENSG00000153879","CEBPG","19",33864236,33873592,9356
"7453","ENSG00000153885","KCTD15","19",34286838,34306668,19830
"7454","ENSG00000153896","ZNF599","19",35248981,35264134,15153
"7455","ENSG00000153904","DDAH1","1",85784164,86043933,259769
"7456","ENSG00000153914","SREK1","5",65435799,65479443,43644
"7457","ENSG00000153922","CHD1","5",98190908,98262240,71332
"7458","ENSG00000153933","DGKE","17",54911460,54946036,34576
"7459","ENSG00000153936","HS2ST1","1",87380331,87602334,222003
"7460","ENSG00000153944","MSI2","17",55333212,55762046,428834
"7461","ENSG00000153956","CACNA2D1","7",81575760,82073114,497354
"7462","ENSG00000153975","ZUFSP","6",116956781,116989957,33176
"7463","ENSG00000153976","HS3ST3A1","17",13399006,13505244,106238
"7464","ENSG00000153982","GDPD1","17",57297828,57353328,55500
"7465","ENSG00000153989","NUS1","6",117996665,118031803,35138
"7466","ENSG00000153993","SEMA3D","7",84624869,84816171,191302
"7467","ENSG00000154001","PPP2R5E","14",63838075,64010092,172017
"7468","ENSG00000154016","GRAP","17",18923986,18950950,26964
"7469","ENSG00000154027","AK5","1",77747736,78025651,277915
"7470","ENSG00000154035","C17orf103","17",21142183,21156722,14539
"7471","ENSG00000154040","CABYR","18",21718942,21741567,22625
"7472","ENSG00000154059","IMPACT","18",22006580,22033499,26919
"7473","ENSG00000154065","ANKRD29","18",21178890,21242849,63959
"7474","ENSG00000154079","C6orf57","6",71276620,71299272,22652
"7475","ENSG00000154080","CHST9","18",24495595,24765281,269686
"7476","ENSG00000154096","THY1","11",119288090,119295695,7605
"7477","ENSG00000154114","TBCEL","11",120894781,120961484,66703
"7478","ENSG00000154122","ANKH","5",14704910,14871887,166977
"7479","ENSG00000154124","FAM105B","5",14664773,14699820,35047
"7480","ENSG00000154127","UBASH3B","11",122526383,122685181,158798
"7481","ENSG00000154134","ROBO3","11",124735282,124751366,16084
"7482","ENSG00000154144","TBRG1","11",124492732,124505287,12555
"7483","ENSG00000154146","NRGN","11",124609742,124617106,7364
"7484","ENSG00000154162","CDH12","5",21750782,22853731,1102949
"7485","ENSG00000154174","TOMM70A","3",100082275,100120242,37967
"7486","ENSG00000154188","ANGPT1","8",108261721,108510283,248562
"7487","ENSG00000154217","PITPNC1","17",65373575,65693372,319797
"7488","ENSG00000154222","CC2D1B","1",52811395,52831865,20470
"7489","ENSG00000154229","PRKCA","17",64298754,64806861,508107
"7490","ENSG00000154237","LRRK1","15",101459420,101610317,150897
"7491","ENSG00000154240","CEP112","17",63631656,64188202,556546
"7492","ENSG00000154265","ABCA5","17",67240452,67323385,82933
"7493","ENSG00000154274","C4orf19","4",37455563,37625117,169554
"7494","ENSG00000154277","UCHL1","4",41258430,41270472,12042
"7495","ENSG00000154305","MIA3","1",222791428,222841354,49926
"7496","ENSG00000154309","DISP1","1",222988406,223179337,190931
"7497","ENSG00000154310","TNIK","3",170779128,171178197,399069
"7498","ENSG00000154319","FAM167A","8",11278972,11332224,53252
"7499","ENSG00000154328","NEIL2","8",11627148,11644855,17707
"7500","ENSG00000154330","PGM5","9",70943224,71145977,202753
"7501","ENSG00000154342","WNT3A","1",228194752,228248961,54209
"7502","ENSG00000154358","OBSCN","1",228395831,228566577,170746
"7503","ENSG00000154359","LONRF1","8",12579403,12613582,34179
"7504","ENSG00000154370","TRIM11","1",228581374,228594541,13167
"7505","ENSG00000154380","ENAH","1",225674537,225840844,166307
"7506","ENSG00000154429","CCSAP","1",229456758,229479041,22283
"7507","ENSG00000154447","SH3RF1","4",170015407,170192256,176849
"7508","ENSG00000154473","BUB3","10",124913793,124924886,11093
"7509","ENSG00000154479","CCDC173","2",170501935,170550943,49008
"7510","ENSG00000154511","FAM69A","1",93307724,93427057,119333
"7511","ENSG00000154518","ATP5G3","2",176040986,176049335,8349
"7512","ENSG00000154529","CNTNAP3B","9",43684902,43924049,239147
"7513","ENSG00000154548","SRSF12","6",89805678,89827800,22122
"7514","ENSG00000154553","PDLIM3","4",186422851,186456766,33915
"7515","ENSG00000154556","SORBS2","4",186506598,186877806,371208
"7516","ENSG00000154582","TCEB1","8",74851404,74884522,33118
"7517","ENSG00000154608","CEP170P1","4",119388745,119476483,87738
"7518","ENSG00000154620","TMSB4Y","Y",15815447,15817904,2457
"7519","ENSG00000154639","CXADR","21",18884700,18965897,81197
"7520","ENSG00000154640","BTG3","21",18965971,18985265,19294
"7521","ENSG00000154642","C21orf91","21",19161284,19191703,30419
"7522","ENSG00000154645","CHODL","21",19273580,19639690,366110
"7523","ENSG00000154654","NCAM2","21",22370633,22915650,545017
"7524","ENSG00000154678","PDE1C","7",31790793,32338941,548148
"7525","ENSG00000154710","RABGEF1","7",66147151,66276451,129300
"7526","ENSG00000154719","MRPL39","21",26957968,26979829,21861
"7527","ENSG00000154721","JAM2","21",27011584,27089874,78290
"7528","ENSG00000154723","ATP5J","21",27088815,27107984,19169
"7529","ENSG00000154727","GABPA","21",27106881,27144771,37890
"7530","ENSG00000154734","ADAMTS1","21",28208066,28217728,9662
"7531","ENSG00000154736","ADAMTS5","21",28290231,28338832,48601
"7532","ENSG00000154743","TSEN2","3",12525931,12581122,55191
"7533","ENSG00000154760","SLFN13","17",33762115,33775856,13741
"7534","ENSG00000154764","WNT7A","3",13857755,13921618,63863
"7535","ENSG00000154767","XPC","3",14186647,14220283,33636
"7536","ENSG00000154781","CCDC174","3",14693271,14714166,20895
"7537","ENSG00000154803","FLCN","17",17115526,17140502,24976
"7538","ENSG00000154813","DPH3","3",16299485,16306479,6994
"7539","ENSG00000154814","OXNAD1","3",16306706,16391806,85100
"7540","ENSG00000154822","PLCL2","3",16844159,17132086,287927
"7541","ENSG00000154832","CXXC1","18",47808713,47814674,5961
"7542","ENSG00000154839","SKA1","18",47901365,47920543,19178
"7543","ENSG00000154845","PPP4R1","18",9546789,9615238,68449
"7544","ENSG00000154856","APCDD1","18",10454625,10489945,35320
"7545","ENSG00000154864","PIEZO2","18",10666480,11148587,482107
"7546","ENSG00000154889","MPPE1","18",11882621,11909222,26601
"7547","ENSG00000154898","CCDC144CP","17",20224477,20306870,82393
"7548","ENSG00000154917","RAB6B","3",133543083,133614680,71597
"7549","ENSG00000154920","EME1","17",48450581,48458844,8263
"7550","ENSG00000154928","EPHB1","3",134316643,134979309,662666
"7551","ENSG00000154930","ACSS1","20",24986868,25039616,52748
"7552","ENSG00000154945","ANKRD40","17",48770551,48785285,14734
"7553","ENSG00000154957","ZNF18","17",11880756,11900827,20071
"7554","ENSG00000154978","VOPP1","7",55503749,55640681,136932
"7555","ENSG00000155008","APOOL","X",84258832,84343069,84237
"7556","ENSG00000155011","DKK2","4",107842959,108204963,362004
"7557","ENSG00000155016","CYP2U1","4",108852525,108874613,22088
"7558","ENSG00000155034","FBXL18","7",5470966,5553429,82463
"7559","ENSG00000155052","CNTNAP5","2",124782864,125672864,890000
"7560","ENSG00000155085","AK9","6",109814059,110012420,198361
"7561","ENSG00000155090","KLF10","8",103661007,103668130,7123
"7562","ENSG00000155093","PTPRN2","7",157331750,158380480,1048730
"7563","ENSG00000155096","AZIN1","8",103838585,103906092,67507
"7564","ENSG00000155097","ATP6V1C1","8",104033291,104085279,51988
"7565","ENSG00000155099","TMEM55A","8",92006024,92053292,47268
"7566","ENSG00000155100","OTUD6B","8",92082424,92099323,16899
"7567","ENSG00000155111","CDK19","6",110931181,111137161,205980
"7568","ENSG00000155115","GTF3C6","6",111279763,111289093,9330
"7569","ENSG00000155130","MARCKS","6",114178541,114184648,6107
"7570","ENSG00000155158","TTC39B","9",15163620,15307358,143738
"7571","ENSG00000155189","AGPAT5","8",6565878,6617184,51306
"7572","ENSG00000155229","MMS19","10",99218081,99258551,40470
"7573","ENSG00000155252","PI4K2A","10",99344131,99436191,92060
"7574","ENSG00000155254","MARVELD1","10",99472930,99477907,4977
"7575","ENSG00000155256","ZFYVE27","10",99496878,99520664,23786
"7576","ENSG00000155275","TRMT44","4",8437867,8495258,57391
"7577","ENSG00000155287","SLC25A28","10",101370282,101380366,10084
"7578","ENSG00000155304","HSPA13","21",15743436,15755805,12369
"7579","ENSG00000155313","USP25","21",17102344,17252377,150033
"7580","ENSG00000155324","GRAMD3","5",125695824,125832186,136362
"7581","ENSG00000155329","ZCCHC10","5",132332677,132362296,29619
"7582","ENSG00000155330","C16orf87","16",46830519,46865323,34804
"7583","ENSG00000155363","MOV10","1",113215763,113243368,27605
"7584","ENSG00000155366","RHOC","1",113243728,113250056,6328
"7585","ENSG00000155367","PPM1J","1",113252616,113258099,5483
"7586","ENSG00000155368","DBI","2",120124497,120130126,5629
"7587","ENSG00000155380","SLC16A1","1",113454469,113499635,45166
"7588","ENSG00000155393","HEATR3","16",50099852,50140298,40446
"7589","ENSG00000155438","NIFK","2",122484521,122494499,9978
"7590","ENSG00000155463","OXA1L","14",23235731,23241007,5276
"7591","ENSG00000155506","LARP1","5",154092462,154197167,104705
"7592","ENSG00000155508","CNOT8","5",154237113,154256353,19240
"7593","ENSG00000155511","GRIA1","5",152869175,153193429,324254
"7594","ENSG00000155530","LRGUK","7",133812052,133949343,137291
"7595","ENSG00000155542","SETD9","5",56205087,56221359,16272
"7596","ENSG00000155545","MIER3","5",56215429,56267502,52073
"7597","ENSG00000155561","NUP205","7",135242667,135333505,90838
"7598","ENSG00000155592","ZKSCAN2","16",25247322,25269252,21930
"7599","ENSG00000155621","C9orf85","9",74526426,74600970,74544
"7600","ENSG00000155629","PIK3AP1","10",98353069,98480271,127202
"7601","ENSG00000155636","RBM45","2",178977151,179003738,26587
"7602","ENSG00000155640","C10orf12","10",98741041,98745582,4541
"7603","ENSG00000155657","TTN","2",179390716,179695529,304813
"7604","ENSG00000155660","PDIA4","7",148700154,148725733,25579
"7605","ENSG00000155666","KDM8","16",27214807,27233089,18282
"7606","ENSG00000155729","KCTD18","2",201353675,201384507,30832
"7607","ENSG00000155744","FAM126B","2",201838441,201936394,97953
"7608","ENSG00000155749","ALS2CR12","2",202152994,202222121,69127
"7609","ENSG00000155755","TMEM237","2",202484907,202508293,23386
"7610","ENSG00000155760","FZD7","2",202899310,202903160,3850
"7611","ENSG00000155761","SPAG17","1",118496484,118727846,231362
"7612","ENSG00000155792","DEPTOR","8",120885957,121063152,177195
"7613","ENSG00000155816","FMN2","1",240177648,240638489,460841
"7614","ENSG00000155827","RNF20","9",104296133,104325622,29489
"7615","ENSG00000155846","PPARGC1B","5",149109861,149234585,124724
"7616","ENSG00000155849","ELMO1","7",36893961,37488852,594891
"7617","ENSG00000155850","SLC26A2","5",149340300,149373018,32718
"7618","ENSG00000155858","LSM11","5",157170703,157187717,17014
"7619","ENSG00000155868","MED7","5",156564423,156586030,21607
"7620","ENSG00000155876","RRAGA","9",19049372,19051019,1647
"7621","ENSG00000155893","ACPL2","3",140947568,141013748,66180
"7622","ENSG00000155897","ADCY8","8",131792547,132054672,262125
"7623","ENSG00000155903","RASA2","3",141205889,141334184,128295
"7624","ENSG00000155906","RMND1","6",151725989,151773259,47270
"7625","ENSG00000155957","TMBIM4","12",66517709,66563852,46143
"7626","ENSG00000155959","VBP1","X",154425284,154468098,42814
"7627","ENSG00000155961","RAB39B","X",154487526,154493874,6348
"7628","ENSG00000155962","CLIC2","X",154505500,154563966,58466
"7629","ENSG00000155966","AFF2","X",147582139,148082193,500054
"7630","ENSG00000155970","MICU3","8",16884747,16980153,95406
"7631","ENSG00000155974","GRIP1","12",66741211,67197966,456755
"7632","ENSG00000155975","VPS37A","8",17104080,17159936,55856
"7633","ENSG00000155980","KIF5A","12",57943781,57980415,36634
"7634","ENSG00000155984","TMEM185A","X",148678216,148713568,35352
"7635","ENSG00000156011","PSD3","8",18384811,18942240,557429
"7636","ENSG00000156017","C9orf41","9",77595936,77643339,47403
"7637","ENSG00000156026","MCU","10",74451889,74647452,195563
"7638","ENSG00000156030","ELMSAN1","14",74181825,74256988,75163
"7639","ENSG00000156042","TTC18","10",75013517,75118617,105100
"7640","ENSG00000156050","FAM161B","14",74398204,74417117,18913
"7641","ENSG00000156052","GNAQ","9",80331003,80646374,315371
"7642","ENSG00000156103","MMP16","8",89044237,89340254,296017
"7643","ENSG00000156110","ADK","10",75910960,76469061,558101
"7644","ENSG00000156113","KCNMA1","10",78629359,79398353,768994
"7645","ENSG00000156136","DCK","4",71858255,71896631,38376
"7646","ENSG00000156140","ADAMTS3","4",73146686,73434516,287830
"7647","ENSG00000156162","DPY19L4","8",95731931,95806064,74133
"7648","ENSG00000156170","NDUFAF6","8",95907995,96128683,220688
"7649","ENSG00000156171","DRAM2","1",111659955,111682838,22883
"7650","ENSG00000156172","C8orf37","8",96257147,96281429,24282
"7651","ENSG00000156232","WHAMM","15",83478380,83503611,25231
"7652","ENSG00000156239","N6AMT1","21",30244513,30257693,13180
"7653","ENSG00000156253","RWDD2B","21",30376705,30391699,14994
"7654","ENSG00000156256","USP16","21",30396950,30426809,29859
"7655","ENSG00000156261","CCT8","21",30428126,30446118,17992
"7656","ENSG00000156273","BACH1","21",30566392,31003071,436679
"7657","ENSG00000156298","TSPAN7","X",38420623,38548169,127546
"7658","ENSG00000156299","TIAM1","21",32490734,32932290,441556
"7659","ENSG00000156304","SCAF4","21",33043346,33104388,61042
"7660","ENSG00000156313","RPGR","X",38128416,38186817,58401
"7661","ENSG00000156345","CDK20","9",90581356,90589668,8312
"7662","ENSG00000156374","PCGF6","10",105062553,105110891,48338
"7663","ENSG00000156381","ANKRD9","14",102973179,102976136,2957
"7664","ENSG00000156384","SFR1","10",105881816,105886143,4327
"7665","ENSG00000156395","SORCS3","10",106400859,107024993,624134
"7666","ENSG00000156398","SFXN2","10",104474295,104503249,28954
"7667","ENSG00000156411","C14orf2","14",104378625,104394606,15981
"7668","ENSG00000156427","FGF18","5",170846660,170884627,37967
"7669","ENSG00000156453","PCDH1","5",141232938,141258811,25873
"7670","ENSG00000156463","SH3RF2","5",145316142,145461354,145212
"7671","ENSG00000156466","GDF6","8",97154562,97173020,18458
"7672","ENSG00000156467","UQCRB","8",97238148,97247862,9714
"7673","ENSG00000156469","MTERFD1","8",97251626,97273838,22212
"7674","ENSG00000156471","PTDSS1","8",97273943,97349223,75280
"7675","ENSG00000156475","PPP2R2B","5",145967936,146464347,496411
"7676","ENSG00000156482","RPL30","8",99037079,99058697,21618
"7677","ENSG00000156486","KCNS2","8",99439250,99445076,5826
"7678","ENSG00000156500","FAM122C","X",133930819,133988640,57821
"7679","ENSG00000156502","SUPV3L1","10",70939988,70968855,28867
"7680","ENSG00000156504","FAM122B","X",133903596,133931262,27666
"7681","ENSG00000156508","EEF1A1","6",74225473,74233520,8047
"7682","ENSG00000156509","FBXO43","8",101145588,101158028,12440
"7683","ENSG00000156515","HK1","10",71029740,71161638,131898
"7684","ENSG00000156521","TYSND1","10",71897737,71906432,8695
"7685","ENSG00000156531","PHF6","X",133507283,133562820,55537
"7686","ENSG00000156535","CD109","6",74405508,74538040,132532
"7687","ENSG00000156587","UBE2L6","11",57319129,57335757,16628
"7688","ENSG00000156599","ZDHHC5","11",57435219,57468659,33440
"7689","ENSG00000156603","MED19","11",57471186,57479693,8507
"7690","ENSG00000156639","ZFAND3","6",37787275,38122400,335125
"7691","ENSG00000156642","NPTN","15",73852355,73926475,74120
"7692","ENSG00000156650","KAT6B","10",76585340,76792380,207040
"7693","ENSG00000156671","SAMD8","10",76859344,76941881,82537
"7694","ENSG00000156675","RAB11FIP1","8",37716136,37756985,40849
"7695","ENSG00000156687","UNC5D","8",35092975,35654068,561093
"7696","ENSG00000156689","GLYATL2","11",58601542,58671688,70146
"7697","ENSG00000156697","UTP14A","X",129040097,129063737,23640
"7698","ENSG00000156709","AIFM1","X",129263337,129299861,36524
"7699","ENSG00000156711","MAPK13","6",36095586,36107842,12256
"7700","ENSG00000156735","BAG4","8",38034051,38070819,36768
"7701","ENSG00000156787","TBC1D31","8",124054208,124164393,110185
"7702","ENSG00000156795","WDYHV1","8",124428965,124479470,50505
"7703","ENSG00000156802","ATAD2","8",124332090,124428590,96500
"7704","ENSG00000156804","FBXO32","8",124510129,124553446,43317
"7705","ENSG00000156831","NSMCE2","8",126103921,126379362,275441
"7706","ENSG00000156853","ZNF689","16",30613879,30635333,21454
"7707","ENSG00000156858","PRR14","16",30662038,30667761,5723
"7708","ENSG00000156860","FBRS","16",30669752,30682135,12383
"7709","ENSG00000156869","FRRS1","1",100174259,100232187,57928
"7710","ENSG00000156873","PHKG2","16",30759591,30772490,12899
"7711","ENSG00000156875","HIAT1","1",100503653,100548933,45280
"7712","ENSG00000156876","SASS6","1",100549119,100598511,49392
"7713","ENSG00000156925","ZIC3","X",136648301,136659850,11549
"7714","ENSG00000156928","MALSU1","7",23338358,23351348,12990
"7715","ENSG00000156931","VPS8","3",184529931,184770402,240471
"7716","ENSG00000156958","GALK2","15",49447853,49660066,212213
"7717","ENSG00000156968","MPV17L","16",15489611,15507125,17514
"7718","ENSG00000156970","BUB1B","15",40453224,40513337,60113
"7719","ENSG00000156973","PDE6D","2",232597135,232650982,53847
"7720","ENSG00000156976","EIF4A2","3",186500994,186507689,6695
"7721","ENSG00000156983","BRPF1","3",9773413,9789702,16289
"7722","ENSG00000156990","RPUSD3","3",9879533,9886286,6753
"7723","ENSG00000157014","TATDN2","3",10289707,10322902,33195
"7724","ENSG00000157020","SEC13","3",10334815,10362862,28047
"7725","ENSG00000157036","EXOG","3",38537618,38583652,46034
"7726","ENSG00000157045","NTAN1","16",15131710,15149921,18211
"7727","ENSG00000157064","NMNAT2","1",183217372,183387737,170365
"7728","ENSG00000157077","ZFYVE9","1",52608046,52812358,204312
"7729","ENSG00000157103","SLC6A1","3",11034410,11080933,46523
"7730","ENSG00000157106","SMG1","16",18816175,18937776,121601
"7731","ENSG00000157107","FCHO2","5",72251808,72386349,134541
"7732","ENSG00000157110","RBPMS","8",30241944,30429778,187834
"7733","ENSG00000157168","NRG1","8",31496902,32622548,1125646
"7734","ENSG00000157181","C1orf27","1",186344890,186390510,45620
"7735","ENSG00000157184","CPT2","1",53662101,53679869,17768
"7736","ENSG00000157191","NECAP2","1",16767167,16786573,19406
"7737","ENSG00000157193","LRP8","1",53711217,53793742,82525
"7738","ENSG00000157212","PAXIP1","7",154735397,154794794,59397
"7739","ENSG00000157214","STEAP2","7",89796904,89867451,70547
"7740","ENSG00000157216","SSBP3","1",54691105,54879152,188047
"7741","ENSG00000157224","CLDN12","7",90013035,90142716,129681
"7742","ENSG00000157227","MMP14","14",23305766,23318236,12470
"7743","ENSG00000157240","FZD1","7",90893783,90898123,4340
"7744","ENSG00000157259","GATAD1","7",92076767,92088150,11383
"7745","ENSG00000157306","","14",23980969,24029987,49018
"7746","ENSG00000157322","CLEC18A","16",69984810,69998141,13331
"7747","ENSG00000157326","DHRS4","14",24422795,24438488,15693
"7748","ENSG00000157343","ARMC12","6",35704809,35716856,12047
"7749","ENSG00000157349","DDX19B","16",70323566,70369186,45620
"7750","ENSG00000157350","ST3GAL2","16",70413338,70473140,59802
"7751","ENSG00000157353","FUK","16",70488324,70514177,25853
"7752","ENSG00000157379","DHRS1","14",24759804,24769039,9235
"7753","ENSG00000157399","ARSE","X",2852699,2886286,33587
"7754","ENSG00000157404","KIT","4",55524085,55606881,82796
"7755","ENSG00000157423","HYDIN","16",70841281,71264625,423344
"7756","ENSG00000157426","AASDH","4",57204456,57253666,49210
"7757","ENSG00000157429","ZNF19","16",71498453,71598992,100539
"7758","ENSG00000157445","CACNA2D3","3",54156574,55108584,952010
"7759","ENSG00000157450","RNF111","15",59157374,59389618,232244
"7760","ENSG00000157456","CCNB2","15",59397277,59417244,19967
"7761","ENSG00000157470","FAM81A","15",59664892,59815748,150856
"7762","ENSG00000157483","MYO1E","15",59427113,59665099,237986
"7763","ENSG00000157500","APPL1","3",57261765,57307496,45731
"7764","ENSG00000157502","MUM1L1","X",105412298,105452949,40651
"7765","ENSG00000157514","TSC22D3","X",106956451,107020572,64121
"7766","ENSG00000157538","DSCR3","21",38595721,38640262,44541
"7767","ENSG00000157540","DYRK1A","21",38738092,38889753,151661
"7768","ENSG00000157542","KCNJ6","21",38979678,39288749,309071
"7769","ENSG00000157554","ERG","21",39751949,40033704,281755
"7770","ENSG00000157557","ETS2","21",40177231,40196879,19648
"7771","ENSG00000157570","TSPAN18","11",44748015,44953972,205957
"7772","ENSG00000157578","LCA5L","21",40777770,40817731,39961
"7773","ENSG00000157593","SLC35B2","6",44221833,44225291,3458
"7774","ENSG00000157600","TMEM164","X",109245859,109425962,180103
"7775","ENSG00000157601","MX1","21",42792231,42831141,38910
"7776","ENSG00000157617","C2CD2","21",43305221,43373999,68778
"7777","ENSG00000157625","TAB3","X",30845559,30993201,147642
"7778","ENSG00000157637","SLC38A10","17",79218800,79269347,50547
"7779","ENSG00000157653","C9orf43","9",116172334,116191964,19630
"7780","ENSG00000157657","ZNF618","9",116638562,116818871,180309
"7781","ENSG00000157680","DGKI","7",137065783,137531838,466055
"7782","ENSG00000157693","C9orf91","9",117373486,117408702,35216
"7783","ENSG00000157734","SNX22","15",64443914,64449680,5766
"7784","ENSG00000157741","UBN2","7",138915102,138992982,77880
"7785","ENSG00000157764","BRAF","7",140419127,140624564,205437
"7786","ENSG00000157765","SLC34A2","4",25656923,25680370,23447
"7787","ENSG00000157778","PSMG3","7",1606966,1610641,3675
"7788","ENSG00000157782","CABP1","12",121078355,121105127,26772
"7789","ENSG00000157796","WDR19","4",39184024,39287430,103406
"7790","ENSG00000157800","SLC37A3","7",139993493,140104233,110740
"7791","ENSG00000157823","AP3S2","15",90373831,90437574,63743
"7792","ENSG00000157827","FMNL2","2",153191751,153506348,314597
"7793","ENSG00000157833","GAREML","2",26395960,26412532,16572
"7794","ENSG00000157837","SPPL3","12",121200313,121342174,141861
"7795","ENSG00000157851","DPYSL5","2",27070615,27173219,102604
"7796","ENSG00000157856","DRC1","2",26624784,26679579,54795
"7797","ENSG00000157869","RAB28","4",13362978,13485989,123011
"7798","ENSG00000157870","FAM213B","1",2517930,2522908,4978
"7799","ENSG00000157881","PANK4","1",2439972,2458039,18067
"7800","ENSG00000157890","MEGF11","15",66187417,66546085,358668
"7801","ENSG00000157895","C12orf43","12",121440225,121454305,14080
"7802","ENSG00000157911","PEX10","1",2336236,2345236,9000
"7803","ENSG00000157916","RER1","1",2323267,2336883,13616
"7804","ENSG00000157927","RADIL","7",4836686,4923350,86664
"7805","ENSG00000157933","SKI","1",2160134,2241558,81424
"7806","ENSG00000157954","WIPI2","7",5229819,5273457,43638
"7807","ENSG00000157978","LDLRAP1","1",25870071,25895377,25306
"7808","ENSG00000157985","AGAP1","2",236402733,237040444,637711
"7809","ENSG00000158006","PAFAH2","1",26286258,26324648,38390
"7810","ENSG00000158008","EXTL1","1",26346375,26362955,16580
"7811","ENSG00000158019","BRE","2",28112808,28561768,448960
"7812","ENSG00000158023","WDR66","12",122355768,122441833,86065
"7813","ENSG00000158042","MRPL17","11",6702013,6704632,2619
"7814","ENSG00000158050","DUSP2","2",96808905,96811179,2274
"7815","ENSG00000158055","GRHL3","1",24645812,24690972,45160
"7816","ENSG00000158062","UBXN11","1",26607819,26644854,37035
"7817","ENSG00000158077","NLRP14","11",7041677,7092539,50862
"7818","ENSG00000158079","PTPDC1","9",96793076,96872138,79062
"7819","ENSG00000158092","NCK1","3",136581050,136668665,87615
"7820","ENSG00000158106","RHPN1","8",144451057,144466390,15333
"7821","ENSG00000158109","TPRG1L","1",3541566,3546691,5125
"7822","ENSG00000158122","AAED1","9",99401859,99417585,15726
"7823","ENSG00000158156","XKR8","1",28285973,28294607,8634
"7824","ENSG00000158158","CNNM4","2",97426639,97477628,50989
"7825","ENSG00000158161","EYA3","1",28296855,28415207,118352
"7826","ENSG00000158163","DZIP1L","3",137780832,137834660,53828
"7827","ENSG00000158164","TMSB15A","X",101768604,101771712,3108
"7828","ENSG00000158169","FANCC","9",97861336,98079991,218655
"7829","ENSG00000158186","MRAS","3",138066539,138124375,57836
"7830","ENSG00000158195","WASF2","1",27730730,27816669,85939
"7831","ENSG00000158201","ABHD3","18",19230858,19284766,53908
"7832","ENSG00000158234","FAIM","3",138327448,138352218,24770
"7833","ENSG00000158246","FAM46B","1",27331511,27339327,7816
"7834","ENSG00000158258","CLSTN2","3",139654027,140296239,642212
"7835","ENSG00000158270","COLEC12","18",319361,500722,181361
"7836","ENSG00000158286","RNF207","1",6265535,6281359,15824
"7837","ENSG00000158290","CUL4B","X",119658464,119709649,51185
"7838","ENSG00000158292","GPR153","1",6307406,6321035,13629
"7839","ENSG00000158296","SLC13A3","20",45186463,45304714,118251
"7840","ENSG00000158301","GPRASP2","X",101967104,101973607,6503
"7841","ENSG00000158321","AUTS2","7",69063905,70258054,1194149
"7842","ENSG00000158352","SHROOM4","X",50334647,50557302,222655
"7843","ENSG00000158373","HIST1H2BD","6",26158349,26171577,13228
"7844","ENSG00000158402","CDC25C","5",137620954,137674044,53090
"7845","ENSG00000158406","HIST1H4H","6",26281283,26285762,4479
"7846","ENSG00000158411","MITD1","2",99777890,99797521,19631
"7847","ENSG00000158417","EIF5B","2",99953816,100017789,63973
"7848","ENSG00000158423","RIBC1","X",53449639,53458059,8420
"7849","ENSG00000158427","TMSB15B","X",103173479,103229570,56091
"7850","ENSG00000158435","CNOT11","2",101869264,101886778,17514
"7851","ENSG00000158445","KCNB1","20",47980414,48099184,118770
"7852","ENSG00000158457","TSPAN33","7",128784712,128808671,23959
"7853","ENSG00000158458","NRG2","5",139226364,139422884,196520
"7854","ENSG00000158467","AHCYL2","7",128864864,129070052,205188
"7855","ENSG00000158470","B4GALT5","20",48249482,48330415,80933
"7856","ENSG00000158480","SPATA2","20",48519928,48532080,12152
"7857","ENSG00000158483","FAM86C1","11",71498556,71512282,13726
"7858","ENSG00000158526","TSR2","X",54466834,54471920,5086
"7859","ENSG00000158528","PPP1R9A","7",94536514,94925727,389213
"7860","ENSG00000158545","ZC3H18","16",88636789,88698374,61585
"7861","ENSG00000158552","ZFAND2B","2",220059959,220074373,14414
"7862","ENSG00000158555","GDPD5","11",75145685,75236948,91263
"7863","ENSG00000158560","DYNC1I1","7",95401866,95739634,337768
"7864","ENSG00000158571","PFKFB1","X",54959394,55024967,65573
"7865","ENSG00000158604","TMED4","7",44617493,44621886,4393
"7866","ENSG00000158615","PPP1R15B","1",204372515,204380919,8404
"7867","ENSG00000158623","COPG2","7",130146089,130353598,207509
"7868","ENSG00000158636","C11orf30","11",76155967,76264069,108102
"7869","ENSG00000158669","AGPAT6","8",41434706,41482520,47814
"7870","ENSG00000158691","ZSCAN12","6",28346732,28367511,20779
"7871","ENSG00000158710","TAGLN2","1",159887897,159895522,7625
"7872","ENSG00000158711","ELK4","1",205577071,205601090,24019
"7873","ENSG00000158715","SLC45A3","1",205626979,205649587,22608
"7874","ENSG00000158717","RNF166","16",88762903,88772829,9926
"7875","ENSG00000158764","ITLN2","1",160914815,160924589,9774
"7876","ENSG00000158769","F11R","1",160965001,160991138,26137
"7877","ENSG00000158773","USF1","1",161009041,161015767,6726
"7878","ENSG00000158792","SPATA2L","16",89762751,89768113,5362
"7879","ENSG00000158793","NIT1","1",161087876,161095235,7359
"7880","ENSG00000158796","DEDD","1",161090764,161102478,11714
"7881","ENSG00000158805","ZNF276","16",89786808,89807311,20503
"7882","ENSG00000158813","EDA","X",68835911,69259319,423408
"7883","ENSG00000158828","PINK1","1",20959948,20978004,18056
"7884","ENSG00000158850","B4GALT3","1",161141100,161147287,6187
"7885","ENSG00000158856","DMTN","8",21906506,21940038,33532
"7886","ENSG00000158863","FAM160B2","8",21946670,21962409,15739
"7887","ENSG00000158864","NDUFS2","1",161166894,161184185,17291
"7888","ENSG00000158882","TOMM40L","1",161195793,161200408,4615
"7889","ENSG00000158941","CCAR2","8",22462145,22479027,16882
"7890","ENSG00000158955","WNT9B","17",44910567,44964096,53529
"7891","ENSG00000158966","CACHD1","1",64936428,65158741,222313
"7892","ENSG00000158985","CDC42SE2","5",130581186,130734140,152954
"7893","ENSG00000158987","RAPGEF6","5",130759614,130970929,211315
"7894","ENSG00000159023","EPB41","1",29213603,29446553,232950
"7895","ENSG00000159055","MIS18A","21",33640530,33651380,10850
"7896","ENSG00000159063","ALG8","11",77811982,77850706,38724
"7897","ENSG00000159069","FBXW5","9",139834887,139839148,4261
"7898","ENSG00000159079","C21orf59","21",33964389,33985176,20787
"7899","ENSG00000159082","SYNJ1","21",34001069,34100359,99290
"7900","ENSG00000159086","PAXBP1","21",34106210,34144169,37959
"7901","ENSG00000159110","IFNAR2","21",34602206,34637980,35774
"7902","ENSG00000159111","MRPL10","17",45900638,45908900,8262
"7903","ENSG00000159128","IFNGR2","21",34775202,34851655,76453
"7904","ENSG00000159131","GART","21",34876238,34915797,39559
"7905","ENSG00000159140","SON","21",34914924,34949812,34888
"7906","ENSG00000159147","DONSON","21",34931848,34961014,29166
"7907","ENSG00000159164","SV2A","1",149874870,149889434,14564
"7908","ENSG00000159167","STC1","8",23699428,23712320,12892
"7909","ENSG00000159173","TNNI1","1",201373625,201398994,25369
"7910","ENSG00000159176","CSRP1","1",201452658,201478584,25926
"7911","ENSG00000159199","ATP5G1","17",46970127,46973233,3106
"7912","ENSG00000159200","RCAN1","21",35885440,35987441,102001
"7913","ENSG00000159202","UBE2Z","17",46985731,47006418,20687
"7914","ENSG00000159208","C1orf51","1",150254953,150259505,4552
"7915","ENSG00000159210","SNF8","17",47006678,47022479,15801
"7916","ENSG00000159214","CCDC24","1",44457031,44462200,5169
"7917","ENSG00000159216","RUNX1","21",36160098,37376965,1216867
"7918","ENSG00000159217","IGF2BP1","17",47074774,47133012,58238
"7919","ENSG00000159228","CBR1","21",37442239,37445464,3225
"7920","ENSG00000159231","CBR3","21",37507210,37518864,11654
"7921","ENSG00000159239","C2orf81","2",74641304,74648718,7414
"7922","ENSG00000159251","ACTC1","15",35080297,35088340,8043
"7923","ENSG00000159256","MORC3","21",37692487,37758446,65959
"7924","ENSG00000159259","CHAF1B","21",37757676,37791313,33637
"7925","ENSG00000159267","HLCS","21",38123189,38362536,239347
"7926","ENSG00000159307","SCUBE1","22",43593289,43739394,146105
"7927","ENSG00000159314","ARHGAP27","17",43471275,43511787,40512
"7928","ENSG00000159322","ADPGK","15",73043710,73078187,34477
"7929","ENSG00000159335","PTMS","12",6874682,6880116,5434
"7930","ENSG00000159346","ADIPOR1","1",202909951,202927700,17749
"7931","ENSG00000159348","CYB5R1","1",202930997,202936408,5411
"7932","ENSG00000159352","PSMD4","1",151227179,151239955,12776
"7933","ENSG00000159363","ATP13A2","1",17312453,17338423,25970
"7934","ENSG00000159377","PSMB4","1",151372010,151374420,2410
"7935","ENSG00000159387","IRX6","16",55357672,55364672,7000
"7936","ENSG00000159388","BTG2","1",203274619,203278730,4111
"7937","ENSG00000159399","HK2","2",75061108,75120486,59378
"7938","ENSG00000159403","C1R","12",7187513,7245203,57690
"7939","ENSG00000159409","CELF3","1",151674880,151689290,14410
"7940","ENSG00000159423","ALDH4A1","1",19197926,19229275,31349
"7941","ENSG00000159433","STARD9","15",42867857,43013179,145322
"7942","ENSG00000159445","THEM4","1",151846060,151882284,36224
"7943","ENSG00000159459","UBR1","15",43235095,43398311,163216
"7944","ENSG00000159461","AMFR","16",56395364,56459450,64086
"7945","ENSG00000159479","MED8","1",43849588,43855479,5891
"7946","ENSG00000159579","RSPRY1","16",57220049,57274387,54338
"7947","ENSG00000159588","CCDC17","1",46085716,46089729,4013
"7948","ENSG00000159592","GPBP1L1","1",46092976,46153785,60809
"7949","ENSG00000159593","NAE1","16",66836778,66907159,70381
"7950","ENSG00000159596","TMEM69","1",46152886,46160115,7229
"7951","ENSG00000159658","EFCAB14","1",47124366,47184824,60458
"7952","ENSG00000159685","CHCHD6","3",126423063,126679249,256186
"7953","ENSG00000159692","CTBP1","4",1205236,1243741,38505
"7954","ENSG00000159713","TPPP3","16",67423712,67427438,3726
"7955","ENSG00000159714","ZDHHC1","16",67428322,67450736,22414
"7956","ENSG00000159720","ATP6V0D1","16",67471917,67515140,43223
"7957","ENSG00000159784","FAM131B","7",143050493,143059863,9370
"7958","ENSG00000159788","RGS12","4",3294755,3441640,146885
"7959","ENSG00000159792","PSKH1","16",67927175,67963581,36406
"7960","ENSG00000159840","ZYX","7",143078173,143088204,10031
"7961","ENSG00000159842","ABR","17",906758,1132315,225557
"7962","ENSG00000159873","CCDC117","22",29168662,29185283,16621
"7963","ENSG00000159882","ZNF230","19",44507100,44518078,10978
"7964","ENSG00000159884","CCDC107","9",35658301,35661508,3207
"7965","ENSG00000159885","ZNF222","19",44529494,44537265,7771
"7966","ENSG00000159899","NPR2","9",35792151,35809729,17578
"7967","ENSG00000159905","ZNF221","19",44455375,44471861,16486
"7968","ENSG00000159915","ZNF233","19",44754318,44779470,25152
"7969","ENSG00000159917","ZNF235","19",44732882,44809199,76317
"7970","ENSG00000159921","GNE","9",36214438,36277053,62615
"7971","ENSG00000160007","ARHGAP35","19",47421933,47508334,86401
"7972","ENSG00000160014","CALM3","19",47104331,47114050,9719
"7973","ENSG00000160049","DFFA","1",10516579,10532583,16004
"7974","ENSG00000160050","CCDC28B","1",32665987,32670988,5001
"7975","ENSG00000160051","IQCC","1",32671236,32674288,3052
"7976","ENSG00000160055","TMEM234","1",32680073,32687972,7899
"7977","ENSG00000160058","BSDC1","1",32830704,32860332,29628
"7978","ENSG00000160062","ZBTB8A","1",33005028,33071540,66512
"7979","ENSG00000160072","ATAD3B","1",1407143,1433228,26085
"7980","ENSG00000160075","SSU72","1",1477053,1510249,33196
"7981","ENSG00000160087","UBE2J2","1",1189289,1209265,19976
"7982","ENSG00000160094","ZNF362","1",33722146,33766320,44174
"7983","ENSG00000160097","FNDC5","1",33327869,33338083,10214
"7984","ENSG00000160111","CPAMD8","19",17003758,17137625,133867
"7985","ENSG00000160113","NR2F6","19",17342692,17356749,14057
"7986","ENSG00000160117","ANKLE1","19",17392454,17398455,6001
"7987","ENSG00000160124","CCDC58","3",122078438,122102078,23640
"7988","ENSG00000160131","VMA21","X",150564987,150577836,12849
"7989","ENSG00000160145","KALRN","3",123798870,124445172,646302
"7990","ENSG00000160161","CILP2","19",19649057,19657468,8411
"7991","ENSG00000160172","FAM86C2P","11",67559119,67572807,13688
"7992","ENSG00000160179","ABCG1","21",43619799,43717354,97555
"7993","ENSG00000160190","SLC37A1","21",43916118,44001550,85432
"7994","ENSG00000160191","PDE9A","21",44073746,44195619,121873
"7995","ENSG00000160193","WDR4","21",44263204,44299678,36474
"7996","ENSG00000160194","NDUFV3","21",44299754,44333414,33660
"7997","ENSG00000160199","PKNOX1","21",44394620,44453691,59071
"7998","ENSG00000160200","CBS","21",44473301,44497053,23752
"7999","ENSG00000160201","U2AF1","21",44513066,44527697,14631
"8000","ENSG00000160207","HSF2BP","21",44949072,45079374,130302
"8001","ENSG00000160208","RRP1B","21",45079429,45115958,36529
"8002","ENSG00000160209","PDXK","21",45138975,45182188,43213
"8003","ENSG00000160211","G6PD","X",153759606,153775787,16181
"8004","ENSG00000160213","CSTB","21",45192393,45196326,3933
"8005","ENSG00000160214","RRP1","21",45209394,45225174,15780
"8006","ENSG00000160216","AGPAT3","21",45285067,45406417,121350
"8007","ENSG00000160218","TRAPPC10","21",45432200,45526433,94233
"8008","ENSG00000160221","C21orf33","21",45553487,45565605,12118
"8009","ENSG00000160226","C21orf2","21",45748827,45759285,10458
"8010","ENSG00000160229","ZNF66","19",20959110,20991922,32812
"8011","ENSG00000160233","LRRC3","21",45875369,45878739,3370
"8012","ENSG00000160256","FAM207A","21",46359925,46396904,36979
"8013","ENSG00000160271","RALGDS","9",135973107,136039301,66194
"8014","ENSG00000160284","SPATC1L","21",47581062,47604390,23328
"8015","ENSG00000160285","LSS","21",47608055,47648738,40683
"8016","ENSG00000160293","VAV2","9",136627016,136857726,230710
"8017","ENSG00000160294","MCM3AP","21",47655047,47706211,51164
"8018","ENSG00000160298","C21orf58","21",47720095,47743789,23694
"8019","ENSG00000160299","PCNT","21",47744036,47865682,121646
"8020","ENSG00000160305","DIP2A","21",47878812,47989926,111114
"8021","ENSG00000160307","S100B","21",48018875,48025121,6246
"8022","ENSG00000160310","PRMT2","21",48055079,48085036,29957
"8023","ENSG00000160323","ADAMTS13","9",136279478,136324508,45030
"8024","ENSG00000160325","CACFD1","9",136325089,136335970,10881
"8025","ENSG00000160326","SLC2A6","9",136336217,136344259,8042
"8026","ENSG00000160336","ZNF761","19",53935227,53961515,26288
"8027","ENSG00000160345","C9orf116","9",138387027,138393580,6553
"8028","ENSG00000160352","ZNF714","19",21264965,21308073,43108
"8029","ENSG00000160360","GPSM1","9",139221932,139254057,32125
"8030","ENSG00000160392","C19orf47","19",40825443,40854434,28991
"8031","ENSG00000160404","TOR2A","9",130493803,130497604,3801
"8032","ENSG00000160408","ST6GALNAC6","9",130647600,130667687,20087
"8033","ENSG00000160410","SHKBP1","19",41082757,41097305,14548
"8034","ENSG00000160439","RDH13","19",55550476,55582659,32183
"8035","ENSG00000160445","ZER1","9",131492065,131534693,42628
"8036","ENSG00000160446","ZDHHC12","9",131483148,131486406,3258
"8037","ENSG00000160447","PKN3","9",131464802,131483197,18395
"8038","ENSG00000160469","BRSK1","19",55793440,55823901,30461
"8039","ENSG00000160539","PPAPDC3","9",134165081,134184649,19568
"8040","ENSG00000160551","TAOK1","17",27717482,27878922,161440
"8041","ENSG00000160563","MED27","9",134735494,134955295,219801
"8042","ENSG00000160570","DEDD2","19",42702750,42724292,21542
"8043","ENSG00000160584","SIK3","11",116714118,116969153,255035
"8044","ENSG00000160602","NEK8","17",27052915,27070473,17558
"8045","ENSG00000160606","TLCD1","17",27051366,27054953,3587
"8046","ENSG00000160613","PCSK7","11",117075053,117103241,28188
"8047","ENSG00000160633","SAFB","19",5623046,5668489,45443
"8048","ENSG00000160679","CHTOP","1",153606525,153618782,12257
"8049","ENSG00000160685","ZBTB7B","1",154975127,154990998,15871
"8050","ENSG00000160688","FLAD1","1",154955814,154965587,9773
"8051","ENSG00000160691","SHC1","1",154934774,154946871,12097
"8052","ENSG00000160695","VPS11","11",118938403,118952688,14285
"8053","ENSG00000160703","NLRX1","11",119037277,119054725,17448
"8054","ENSG00000160710","ADAR","1",154554538,154600475,45937
"8055","ENSG00000160712","IL6R","1",154377669,154441926,64257
"8056","ENSG00000160714","UBE2Q1","1",154521053,154531504,10451
"8057","ENSG00000160716","CHRNB2","1",154540257,154552502,12245
"8058","ENSG00000160741","CRTC2","1",153920145,153931101,10956
"8059","ENSG00000160746","ANO10","3",43396351,43733086,336735
"8060","ENSG00000160752","FDPS","1",155278539,155290457,11918
"8061","ENSG00000160753","RUSC1","1",155290687,155300905,10218
"8062","ENSG00000160766","GBAP1","1",155183616,155197214,13598
"8063","ENSG00000160767","FAM189B","1",155216996,155225274,8278
"8064","ENSG00000160781","PAQR6","1",156213206,156217881,4675
"8065","ENSG00000160783","PMF1","1",156182784,156212874,30090
"8066","ENSG00000160785","SLC25A44","1",156163880,156182587,18707
"8067","ENSG00000160789","LMNA","1",156052364,156109880,57516
"8068","ENSG00000160796","NBEAL2","3",47021173,47051193,30020
"8069","ENSG00000160799","CCDC12","3",46963216,47023500,60284
"8070","ENSG00000160803","UBQLN4","1",156005092,156023585,18493
"8071","ENSG00000160813","PPP1R35","7",100032905,100034188,1283
"8072","ENSG00000160818","GPATCH4","1",156564279,156571288,7009
"8073","ENSG00000160828","STAG3L2","7",74112305,74306731,194426
"8074","ENSG00000160877","NACC1","19",13228917,13251955,23038
"8075","ENSG00000160888","IER2","19",13261229,13265722,4493
"8076","ENSG00000160908","ZNF394","7",99084142,99097947,13805
"8077","ENSG00000160917","CPSF4","7",99036545,99054994,18449
"8078","ENSG00000160932","LY6E","8",144099399,144105249,5850
"8079","ENSG00000160948","VPS28","8",145649000,145653931,4931
"8080","ENSG00000160949","TONSL","8",145654165,145669827,15662
"8081","ENSG00000160953","MUM1","19",1285890,1378430,92540
"8082","ENSG00000160957","RECQL4","8",145736667,145743229,6562
"8083","ENSG00000160959","LRRC14","8",145743376,145750557,7181
"8084","ENSG00000160961","ZNF333","19",14800613,14844558,43945
"8085","ENSG00000160963","COL26A1","7",101006101,101202304,196203
"8086","ENSG00000160972","PPP1R16A","8",145703352,145727504,24152
"8087","ENSG00000160991","ORAI2","7",102073553,102097268,23715
"8088","ENSG00000160993","ALKBH4","7",102096685,102105323,8638
"8089","ENSG00000160999","SH2B2","7",101928405,101962178,33773
"8090","ENSG00000161010","C5orf45","5",179261436,179289173,27737
"8091","ENSG00000161011","SQSTM1","5",179233388,179265078,31690
"8092","ENSG00000161013","MGAT4B","5",179224597,179233952,9355
"8093","ENSG00000161016","RPL8","8",146015150,146017972,2822
"8094","ENSG00000161021","MAML1","5",179159851,179223512,63661
"8095","ENSG00000161036","LRWD1","7",102105376,102113615,8239
"8096","ENSG00000161040","FBXL13","7",102453308,102715286,261978
"8097","ENSG00000161048","NAPEPLD","7",102740223,102790007,49784
"8098","ENSG00000161057","PSMC2","7",102984701,103009842,25141
"8099","ENSG00000161082","CELF5","19",3224701,3297074,72373
"8100","ENSG00000161091","MFSD12","19",3538259,3574288,36029
"8101","ENSG00000161149","TUBA3FP","22",21357184,21368581,11397
"8102","ENSG00000161179","YDJC","22",21982378,21984353,1975
"8103","ENSG00000161180","CCDC116","22",21987005,21991616,4611
"8104","ENSG00000161202","DVL3","3",183873176,183891398,18222
"8105","ENSG00000161203","AP2M1","3",183892477,183901879,9402
"8106","ENSG00000161204","ABCF3","3",183903811,183911800,7989
"8107","ENSG00000161217","PCYT1A","3",195941093,196014828,73735
"8108","ENSG00000161265","U2AF1L4","19",36233365,36236346,2981
"8109","ENSG00000161267","BDH1","3",197236654,197300194,63540
"8110","ENSG00000161277","THAP8","19",36525887,36545664,19777
"8111","ENSG00000161298","ZNF382","19",37095719,37119499,23780
"8112","ENSG00000161326","DUSP14","17",35849937,35873603,23666
"8113","ENSG00000161328","LRRC56","11",537527,554916,17389
"8114","ENSG00000161395","PGAP3","17",37827375,37853050,25675
"8115","ENSG00000161513","FDXR","17",72858619,72869156,10537
"8116","ENSG00000161526","SAP30BP","17",73663196,73704142,40946
"8117","ENSG00000161533","ACOX1","17",73937588,73975515,37927
"8118","ENSG00000161542","PRPSAP1","17",74305567,74380602,75035
"8119","ENSG00000161544","CYGB","17",74523438,74547257,23819
"8120","ENSG00000161547","SRSF2","17",74730197,74733456,3259
"8121","ENSG00000161551","ZNF577","19",52359055,52394203,35148
"8122","ENSG00000161558","TMEM143","19",48835613,48867494,31881
"8123","ENSG00000161618","ALDH16A1","19",49956426,49974305,17879
"8124","ENSG00000161638","ITGA5","12",54789045,54813244,24199
"8125","ENSG00000161642","ZNF385A","12",54762917,54785082,22165
"8126","ENSG00000161647","MPP3","17",41878167,41910538,32371
"8127","ENSG00000161654","LSM12","17",42112003,42144987,32984
"8128","ENSG00000161671","EMC10","19",50979657,50986608,6951
"8129","ENSG00000161682","FAM171A2","17",42430583,42441243,10660
"8130","ENSG00000161692","DBF4B","17",42785976,42829632,43656
"8131","ENSG00000161714","PLCD3","17",43186335,43210721,24386
"8132","ENSG00000161791","FMNL3","12",50031724,50101948,70224
"8133","ENSG00000161800","RACGAP1","12",50370706,50426919,56213
"8134","ENSG00000161813","LARP4","12",50786166,50873787,87621
"8135","ENSG00000161835","GRASP","12",52400724,52409673,8949
"8136","ENSG00000161847","RAVER1","19",10426888,10444316,17428
"8137","ENSG00000161860","SYCE2","19",13009600,13030090,20490
"8138","ENSG00000161888","SPC24","19",11242196,11266484,24288
"8139","ENSG00000161904","LEMD2","6",33738979,33756913,17934
"8140","ENSG00000161912","ADCY10P1","6",41068761,41108571,39810
"8141","ENSG00000161914","ZNF653","19",11594242,11616738,22496
"8142","ENSG00000161920","MED11","17",4634723,4636905,2182
"8143","ENSG00000161956","SENP3","17",7465192,7475287,10095
"8144","ENSG00000161960","EIF4A1","17",7476024,7482323,6299
"8145","ENSG00000161970","RPL26","17",8280838,8286531,5693
"8146","ENSG00000161980","POLR3K","16",96407,103628,7221
"8147","ENSG00000161981","SNRNP25","16",103010,107669,4659
"8148","ENSG00000161996","WDR90","16",699311,717833,18522
"8149","ENSG00000161999","JMJD8","16",731671,734529,2858
"8150","ENSG00000162032","SPSB3","16",1826713,1843701,16988
"8151","ENSG00000162062","C16orf59","16",2510081,2514964,4883
"8152","ENSG00000162063","CCNF","16",2479395,2508855,29460
"8153","ENSG00000162065","TBC1D24","16",2525147,2555735,30588
"8154","ENSG00000162066","AMDHD2","16",2570358,2581423,11065
"8155","ENSG00000162073","PAQR4","16",3019246,3023490,4244
"8156","ENSG00000162076","FLYWCH2","16",2933187,2949383,16196
"8157","ENSG00000162086","ZNF75A","16",3355406,3368852,13446
"8158","ENSG00000162104","ADCY9","16",4003388,4166186,162798
"8159","ENSG00000162105","SHANK2","11",70313961,70963623,649662
"8160","ENSG00000162129","CLPB","11",72003469,72145692,142223
"8161","ENSG00000162139","NEU3","11",74699179,74729938,30759
"8162","ENSG00000162144","CYB561A3","11",61116217,61129771,13554
"8163","ENSG00000162148","PPP1R32","11",61248592,61258403,9811
"8164","ENSG00000162174","ASRGL1","11",62104920,62160882,55962
"8165","ENSG00000162188","GNG3","11",62475130,62476673,1543
"8166","ENSG00000162191","UBXN1","11",62443970,62446567,2597
"8167","ENSG00000162194","C11orf48","11",62430287,62439727,9440
"8168","ENSG00000162222","TTC9C","11",62495541,62507765,12224
"8169","ENSG00000162227","TAF6L","11",62538775,62554814,16039
"8170","ENSG00000162231","NXF1","11",62559595,62573774,14179
"8171","ENSG00000162236","STX5","11",62574369,62599560,25191
"8172","ENSG00000162244","RPL29","3",52027616,52029958,2342
"8173","ENSG00000162290","DCP1A","3",53317447,53381654,64207
"8174","ENSG00000162298","SYVN1","11",64889252,64902004,12752
"8175","ENSG00000162300","ZFPL1","11",64851695,64855870,4175
"8176","ENSG00000162302","RPS6KA4","11",64126620,64139687,13067
"8177","ENSG00000162337","LRP5","11",68080077,68216743,136666
"8178","ENSG00000162341","TPCN2","11",68816365,68858072,41707
"8179","ENSG00000162344","FGF19","11",69513000,69519410,6410
"8180","ENSG00000162368","CMPK1","1",47799469,47844511,45042
"8181","ENSG00000162373","BEND5","1",49193195,49242641,49446
"8182","ENSG00000162374","ELAVL4","1",50513686,50669458,155772
"8183","ENSG00000162377","COA7","1",53152508,53164038,11530
"8184","ENSG00000162378","ZYG11B","1",53192126,53293014,100888
"8185","ENSG00000162384","C1orf123","1",53679771,53686289,6518
"8186","ENSG00000162385","MAGOH","1",53692564,53704282,11718
"8187","ENSG00000162390","ACOT11","1",55007930,55104865,96935
"8188","ENSG00000162396","PARS2","1",55222571,55230187,7616
"8189","ENSG00000162402","USP24","1",55532032,55680786,148754
"8190","ENSG00000162407","PPAP2B","1",56960419,57110974,150555
"8191","ENSG00000162408","NOL9","1",6581407,6614595,33188
"8192","ENSG00000162409","PRKAA2","1",57110995,57181008,70013
"8193","ENSG00000162413","KLHL21","1",6650784,6674667,23883
"8194","ENSG00000162415","ZSWIM5","1",45482071,45771881,289810
"8195","ENSG00000162419","GMEB1","1",28995244,29045865,50621
"8196","ENSG00000162426","SLC45A1","1",8377886,8404227,26341
"8197","ENSG00000162430","SEPN1","1",26126667,26144713,18046
"8198","ENSG00000162433","AK4","1",65613232,65697828,84596
"8199","ENSG00000162434","JAK1","1",65298912,65432187,133275
"8200","ENSG00000162437","RAVER2","1",65210778,65298915,88137
"8201","ENSG00000162441","LZIC","1",9982173,10003465,21292
"8202","ENSG00000162458","FBLIM1","1",16083102,16113089,29987
"8203","ENSG00000162461","SLC25A34","1",16062900,16067891,4991
"8204","ENSG00000162482","AKR7A3","1",19609052,19615744,6692
"8205","ENSG00000162490","DRAXIN","1",11751786,11785914,34128
"8206","ENSG00000162493","PDPN","1",13909960,13944452,34492
"8207","ENSG00000162496","DHRS3","1",12627939,12677737,49798
"8208","ENSG00000162512","SDC3","1",31342314,31381608,39294
"8209","ENSG00000162517","PEF1","1",32095463,32110497,15034
"8210","ENSG00000162520","SYNC","1",33145507,33169197,23690
"8211","ENSG00000162521","RBBP4","1",33116743,33151812,35069
"8212","ENSG00000162522","KIAA1522","1",33207486,33240571,33085
"8213","ENSG00000162526","TSSK3","1",32817122,32829913,12791
"8214","ENSG00000162543","UBXN10","1",20512578,20522541,9963
"8215","ENSG00000162545","CAMK2N1","1",20808884,20812713,3829
"8216","ENSG00000162551","ALPL","1",21835858,21904905,69047
"8217","ENSG00000162552","WNT4","1",22443798,22470462,26664
"8218","ENSG00000162572","SCNN1D","1",1215816,1227409,11593
"8219","ENSG00000162576","MXRA8","1",1288069,1297157,9088
"8220","ENSG00000162585","C1orf86","1",2115903,2144159,28256
"8221","ENSG00000162591","MEGF6","1",3406484,3528059,121575
"8222","ENSG00000162595","DIRAS3","1",68511645,68517314,5669
"8223","ENSG00000162599","NFIA","1",61330931,61928465,597534
"8224","ENSG00000162600","OMA1","1",58881056,59012474,131418
"8225","ENSG00000162601","MYSM1","1",59120411,59165764,45353
"8226","ENSG00000162604","TM2D1","1",62146718,62191095,44377
"8227","ENSG00000162607","USP1","1",62901968,62917475,15507
"8228","ENSG00000162613","FUBP1","1",78409740,78444794,35054
"8229","ENSG00000162614","NEXN","1",78354198,78409580,55382
"8230","ENSG00000162616","DNAJB4","1",78444859,78483648,38789
"8231","ENSG00000162618","ELTD1","1",79355449,79472403,116954
"8232","ENSG00000162620","LRRIQ3","1",74491699,74663871,172172
"8233","ENSG00000162623","TYW3","1",75198836,75232362,33526
"8234","ENSG00000162627","SNX7","1",99127236,99226056,98820
"8235","ENSG00000162630","B3GALT2","1",193148175,193155784,7609
"8236","ENSG00000162631","NTNG1","1",107682629,108026080,343451
"8237","ENSG00000162636","FAM102B","1",109102711,109187522,84811
"8238","ENSG00000162639","HENMT1","1",109190912,109204148,13236
"8239","ENSG00000162641","AKNAD1","1",109358520,109506106,147586
"8240","ENSG00000162642","C1orf52","1",85715639,85725355,9716
"8241","ENSG00000162643","WDR63","1",85464830,85598821,133991
"8242","ENSG00000162650","ATXN7L2","1",110026101,110035426,9325
"8243","ENSG00000162664","ZNF326","1",90460671,90501090,40419
"8244","ENSG00000162669","HFM1","1",91726323,91870426,144103
"8245","ENSG00000162670","BRINP3","1",190066792,190446759,379967
"8246","ENSG00000162687","KCNT2","1",196194909,196578355,383446
"8247","ENSG00000162688","AGL","1",100315640,100389579,73939
"8248","ENSG00000162692","VCAM1","1",101185298,101204601,19303
"8249","ENSG00000162694","EXTL2","1",101337943,101361554,23611
"8250","ENSG00000162695","SLC30A7","1",101361632,101447309,85677
"8251","ENSG00000162702","ZNF281","1",200374068,200379184,5116
"8252","ENSG00000162704","ARPC5","1",183592401,183604892,12491
"8253","ENSG00000162706","CADM3","1",159141399,159173103,31704
"8254","ENSG00000162714","ZNF496","1",247460714,247495148,34434
"8255","ENSG00000162729","IGSF8","1",160061130,160068733,7603
"8256","ENSG00000162733","DDR2","1",162601163,162757190,156027
"8257","ENSG00000162734","PEA15","1",160175127,160185166,10039
"8258","ENSG00000162735","PEX19","1",160246602,160256138,9536
"8259","ENSG00000162736","NCSTN","1",160313062,160328742,15680
"8260","ENSG00000162738","VANGL2","1",160370376,160398468,28092
"8261","ENSG00000162745","OLFML2B","1",161952982,161993644,40662
"8262","ENSG00000162755","KLHDC9","1",161068151,161070136,1985
"8263","ENSG00000162757","C1orf74","1",209955661,209957904,2243
"8264","ENSG00000162769","FLVCR1","1",213031597,213072705,41108
"8265","ENSG00000162772","ATF3","1",212738676,212794119,55443
"8266","ENSG00000162775","RBM15","1",110881128,110889299,8171
"8267","ENSG00000162783","IER5","1",181057638,181059977,2339
"8268","ENSG00000162804","SNED1","2",241938255,242034983,96728
"8269","ENSG00000162813","BPNT1","1",220230824,220263804,32980
"8270","ENSG00000162814","SPATA17","1",217804666,218045038,240372
"8271","ENSG00000162817","C1orf115","1",220863187,220872499,9312
"8272","ENSG00000162819","BROX","1",222885895,222908538,22643
"8273","ENSG00000162836","ACP6","1",147101453,147142618,41165
"8274","ENSG00000162849","KIF26B","1",245318287,245872733,554446
"8275","ENSG00000162851","TFB2M","1",246703862,246729626,25764
"8276","ENSG00000162852","CNST","1",246729746,246831886,102140
"8277","ENSG00000162869","PPP1R21","2",48667737,48742525,74788
"8278","ENSG00000162873","KLHDC8A","1",205305220,205326218,20998
"8279","ENSG00000162878","PKDCC","2",42275160,42285668,10508
"8280","ENSG00000162882","HAAO","2",42994229,43019733,25504
"8281","ENSG00000162885","B3GALNT2","1",235613238,235667781,54543
"8282","ENSG00000162889","MAPKAPK2","1",206858289,206907628,49339
"8283","ENSG00000162909","CAPN2","1",223889295,223963720,74425
"8284","ENSG00000162910","MRPL55","1",228294380,228297013,2633
"8285","ENSG00000162913","C1orf145","1",228391207,228401365,10158
"8286","ENSG00000162923","WDR26","1",224572845,224624735,51890
"8287","ENSG00000162924","REL","2",61108656,61158745,50089
"8288","ENSG00000162927","PUS10","2",61167357,61245394,78037
"8289","ENSG00000162928","PEX13","2",61244360,61279125,34765
"8290","ENSG00000162929","KIAA1841","2",61293006,61391960,98954
"8291","ENSG00000162944","RFTN2","2",198432948,198540769,107821
"8292","ENSG00000162946","DISC1","1",231762561,232177018,414457
"8293","ENSG00000162951","LRRTM1","2",80515483,80531874,16391
"8294","ENSG00000162959","MEMO1","2",32090129,32236299,146170
"8295","ENSG00000162961","DPY30","2",32092878,32264881,172003
"8296","ENSG00000162971","TYW5","2",200794698,200820459,25761
"8297","ENSG00000162972","C2orf47","2",200820040,200873263,53223
"8298","ENSG00000162976","PQLC3","2",11295324,11319000,23676
"8299","ENSG00000162980","ARL5A","2",152645498,152685006,39508
"8300","ENSG00000162981","FAM84A","2",14772810,14790933,18123
"8301","ENSG00000162992","NEUROD1","2",182537815,182545603,7788
"8302","ENSG00000162994","CLHC1","2",55401927,55459699,57772
"8303","ENSG00000162998","FRZB","2",183698002,183731890,33888
"8304","ENSG00000162999","DUSP19","2",183943287,183964733,21446
"8305","ENSG00000163001","CCDC104","2",55746740,55773015,26275
"8306","ENSG00000163002","NUP35","2",183982241,184026408,44167
"8307","ENSG00000163006","CCDC138","2",109403213,109501933,98720
"8308","ENSG00000163009","C2orf48","2",10281509,10351851,70342
"8309","ENSG00000163013","FBXO41","2",73481810,73511559,29749
"8310","ENSG00000163017","ACTG2","2",74119441,74146992,27551
"8311","ENSG00000163026","C2orf44","2",24252210,24272445,20235
"8312","ENSG00000163029","SMC6","2",17845079,17981509,136430
"8313","ENSG00000163040","CCDC74A","2",132285248,132291239,5991
"8314","ENSG00000163041","H3F3A","1",226249552,226259702,10150
"8315","ENSG00000163046","ANKRD30BL","2",132905164,133015542,110378
"8316","ENSG00000163050","ADCK3","1",227085237,227175246,90009
"8317","ENSG00000163053","SLC16A14","2",230899698,230933715,34017
"8318","ENSG00000163064","EN1","2",119599747,119605254,5507
"8319","ENSG00000163067","ZNF2","2",95831177,95850065,18888
"8320","ENSG00000163069","SGCB","4",52886872,52904648,17776
"8321","ENSG00000163071","SPATA18","4",52917497,52963458,45961
"8322","ENSG00000163075","","2",120302008,120419827,117819
"8323","ENSG00000163081","CCDC140","2",223162866,223169936,7070
"8324","ENSG00000163083","INHBB","2",121103719,121109384,5665
"8325","ENSG00000163093","BBS5","2",170335688,170382432,46744
"8326","ENSG00000163104","SMARCAD1","4",95128762,95212443,83681
"8327","ENSG00000163110","PDLIM5","4",95373037,95589377,216340
"8328","ENSG00000163113","OTUD7B","1",149909705,149982625,72920
"8329","ENSG00000163116","STPG2","4",98105244,99064391,959147
"8330","ENSG00000163125","RPRD2","1",150335567,150449042,113475
"8331","ENSG00000163126","ANKRD23","2",97490263,97523671,33408
"8332","ENSG00000163138","PACRGL","4",20697905,20754530,56625
"8333","ENSG00000163141","BNIPL","1",151009046,151020076,11030
"8334","ENSG00000163155","LYSMD1","1",151132224,151138424,6200
"8335","ENSG00000163156","SCNM1","1",151129140,151142773,13633
"8336","ENSG00000163159","VPS72","1",151142463,151167797,25334
"8337","ENSG00000163161","ERCC3","2",128014866,128051752,36886
"8338","ENSG00000163162","RNF149","2",101887681,101925163,37482
"8339","ENSG00000163166","IWS1","2",128193783,128284462,90679
"8340","ENSG00000163170","BOLA3","2",74362525,74375121,12596
"8341","ENSG00000163171","CDC42EP3","2",37869032,37965611,96579
"8342","ENSG00000163191","S100A11","1",152004982,152020383,15401
"8343","ENSG00000163214","DHX57","2",39024871,39103075,78204
"8344","ENSG00000163219","ARHGAP25","2",68906733,69053965,147232
"8345","ENSG00000163249","CCNYL1","2",208576264,208626563,50299
"8346","ENSG00000163251","FZD5","2",208627310,208634287,6977
"8347","ENSG00000163257","DCAF16","4",17802278,17812381,10103
"8348","ENSG00000163273","NPPC","2",232786530,232791113,4583
"8349","ENSG00000163281","GNPDA2","4",44684217,44728612,44395
"8350","ENSG00000163291","PAQR3","4",79808281,79860592,52311
"8351","ENSG00000163297","ANTXR2","4",80822303,81046608,224305
"8352","ENSG00000163312","HELQ","4",84328496,84377009,48513
"8353","ENSG00000163319","MRPS18C","4",84377085,84390888,13803
"8354","ENSG00000163320","CGGBP1","3",88101094,88199035,97941
"8355","ENSG00000163322","FAM175A","4",84382092,84444501,62409
"8356","ENSG00000163328","GPR155","2",175296966,175351822,54856
"8357","ENSG00000163344","PMVK","1",154897210,154909467,12257
"8358","ENSG00000163346","PBXIP1","1",154916552,154928599,12047
"8359","ENSG00000163347","CLDN1","3",190023490,190040264,16774
"8360","ENSG00000163348","PYGO2","1",154929502,154936329,6827
"8361","ENSG00000163349","HIPK1","1",114471814,114520426,48612
"8362","ENSG00000163359","COL6A3","2",238232646,238323018,90372
"8363","ENSG00000163362","C1orf106","1",200860176,200884863,24687
"8364","ENSG00000163374","YY1AP1","1",155629237,155658791,29554
"8365","ENSG00000163376","KBTBD8","3",67048727,67061634,12907
"8366","ENSG00000163377","FAM19A4","3",68780917,68981761,200844
"8367","ENSG00000163378","EOGT","3",69024365,69063112,38747
"8368","ENSG00000163382","APOA1BP","1",156561554,156564091,2537
"8369","ENSG00000163386","NBPF10","1",145289772,145370303,80531
"8370","ENSG00000163389","POGLUT1","3",119187785,119213555,25770
"8371","ENSG00000163393","SLC22A15","1",116519119,116612675,93556
"8372","ENSG00000163399","ATP1A1","1",116915290,116952883,37593
"8373","ENSG00000163406","SLC15A2","3",121612936,121662949,50013
"8374","ENSG00000163412","EIF4E3","3",71724567,71803924,79357
"8375","ENSG00000163428","LRRC58","3",120043356,120068186,24830
"8376","ENSG00000163430","FSTL1","3",120111140,120170100,58960
"8377","ENSG00000163431","LMOD1","1",201865580,201915715,50135
"8378","ENSG00000163444","TMEM183A","1",202976514,202993976,17462
"8379","ENSG00000163449","TMEM169","2",216946589,216967506,20917
"8380","ENSG00000163453","IGFBP7","4",57896939,57976551,79612
"8381","ENSG00000163462","TRIM46","1",155145873,155157447,11574
"8382","ENSG00000163463","KRTCAP2","1",155141884,155145951,4067
"8383","ENSG00000163466","ARPC2","2",219081817,219119079,37262
"8384","ENSG00000163468","CCT3","1",156278759,156337664,58905
"8385","ENSG00000163472","TMEM79","1",156252726,156262976,10250
"8386","ENSG00000163479","SSR2","1",155978839,155990750,11911
"8387","ENSG00000163481","RNF25","2",219528587,219537134,8547
"8388","ENSG00000163482","STK36","2",219536749,219567439,30690
"8389","ENSG00000163485","ADORA1","1",203059782,203136533,76751
"8390","ENSG00000163486","SRGAP2","1",206516200,206637783,121583
"8391","ENSG00000163491","NEK10","3",27151576,27410951,259375
"8392","ENSG00000163507","KIAA1524","3",108268716,108308491,39775
"8393","ENSG00000163510","CWC22","2",180809603,180871840,62237
"8394","ENSG00000163512","AZI2","3",28356494,28390618,34124
"8395","ENSG00000163513","TGFBR2","3",30647994,30735634,87640
"8396","ENSG00000163516","ANKZF1","2",220094479,220101391,6912
"8397","ENSG00000163517","HDAC11","3",13521224,13547916,26692
"8398","ENSG00000163520","FBLN2","3",13573824,13679922,106098
"8399","ENSG00000163521","GLB1L","2",220101328,220110200,8872
"8400","ENSG00000163527","STT3B","3",31574130,31679112,104982
"8401","ENSG00000163528","CHCHD4","3",14153580,14166370,12790
"8402","ENSG00000163530","DPPA2","3",109012635,109035364,22729
"8403","ENSG00000163531","NFASC","1",204797779,204991950,194171
"8404","ENSG00000163535","SGOL2","2",201374731,201448505,73774
"8405","ENSG00000163536","SERPINI1","3",167453031,167543356,90325
"8406","ENSG00000163539","CLASP2","3",33537737,33759848,222111
"8407","ENSG00000163541","SUCLG1","2",84650647,84687169,36522
"8408","ENSG00000163545","NUAK2","1",205271187,205290883,19696
"8409","ENSG00000163558","PRKCI","3",169940153,170023769,83616
"8410","ENSG00000163565","IFI16","1",158969758,159024945,55187
"8411","ENSG00000163568","AIM2","1",159032274,159116886,84612
"8412","ENSG00000163576","EFHB","3",19920964,19988517,67553
"8413","ENSG00000163577","EIF5A2","3",170606204,170626482,20278
"8414","ENSG00000163584","RPL22L1","3",170582664,170588272,5608
"8415","ENSG00000163590","PPM1L","3",160473390,160796695,323305
"8416","ENSG00000163596","ICA1L","2",203640690,203736708,96018
"8417","ENSG00000163597","SNHG16","17",74553848,74561430,7582
"8418","ENSG00000163602","RYBP","3",72420976,72496069,75093
"8419","ENSG00000163605","PPP4R2","3",73045936,73118350,72414
"8420","ENSG00000163607","GTPBP8","3",112709765,112733907,24142
"8421","ENSG00000163608","C3orf17","3",112721287,112738708,17421
"8422","ENSG00000163611","SPICE1","3",113161565,113234034,72469
"8423","ENSG00000163617","KIAA1407","3",113682984,113775460,92476
"8424","ENSG00000163618","CADPS","3",62384022,62861054,477032
"8425","ENSG00000163623","NKX6-1","4",85413140,85419603,6463
"8426","ENSG00000163624","CDS1","4",85504132,85572491,68359
"8427","ENSG00000163625","WDFY3","4",85590704,85887544,296840
"8428","ENSG00000163626","COX18","4",73921797,73935472,13675
"8429","ENSG00000163629","PTPN13","4",87515468,87736324,220856
"8430","ENSG00000163633","C4orf36","4",87797358,87857354,59996
"8431","ENSG00000163634","THOC7","3",63819546,63849579,30033
"8432","ENSG00000163635","ATXN7","3",63850233,63989138,138905
"8433","ENSG00000163636","PSMD6","3",63996225,64009658,13433
"8434","ENSG00000163637","PRICKLE2","3",64079543,64431152,351609
"8435","ENSG00000163638","ADAMTS9","3",64501333,64673676,172343
"8436","ENSG00000163644","PPM1K","4",89178772,89205921,27149
"8437","ENSG00000163655","GMPS","3",155588325,155661815,73490
"8438","ENSG00000163659","TIPARP","3",156391024,156424559,33535
"8439","ENSG00000163660","CCNL1","3",156864297,156878549,14252
"8440","ENSG00000163661","PTX3","3",157154578,157161417,6839
"8441","ENSG00000163666","HESX1","3",57231944,57260549,28605
"8442","ENSG00000163681","SLMAP","3",57741177,57914895,173718
"8443","ENSG00000163682","RPL9","4",39455744,39460568,4824
"8444","ENSG00000163683","SMIM14","4",39547950,39640710,92760
"8445","ENSG00000163684","RPP14","3",58291974,58310422,18448
"8446","ENSG00000163686","ABHD6","3",58223233,58281420,58187
"8447","ENSG00000163689","C3orf67","3",58703092,59035810,332718
"8448","ENSG00000163697","APBB2","4",40812044,41218731,406687
"8449","ENSG00000163702","IL17RC","3",9958758,9975314,16556
"8450","ENSG00000163703","CRELD1","3",9975506,9987097,11591
"8451","ENSG00000163704","PRRT3","3",9987226,9994078,6852
"8452","ENSG00000163710","PCOLCE2","3",142534764,142608045,73281
"8453","ENSG00000163714","U2SURP","3",142683339,142779567,96228
"8454","ENSG00000163719","MTMR14","3",9691117,9744077,52960
"8455","ENSG00000163728","TTC14","3",180319918,180335616,15698
"8456","ENSG00000163738","MTHFD2L","4",74979891,75168816,188925
"8457","ENSG00000163743","RCHY1","4",76404247,76439974,35727
"8458","ENSG00000163754","GYG1","3",148709128,148745419,36291
"8459","ENSG00000163755","HPS3","3",148847371,148891519,44148
"8460","ENSG00000163762","TM4SF18","3",149036285,149052201,15916
"8461","ENSG00000163781","TOPBP1","3",133317019,133380737,63718
"8462","ENSG00000163785","RYK","3",133784147,133969689,185542
"8463","ENSG00000163788","SNRK","3",43328004,43466256,138252
"8464","ENSG00000163795","ZNF513","2",27600098,27603657,3559
"8465","ENSG00000163798","SLC4A1AP","2",27886338,27917840,31502
"8466","ENSG00000163803","PLB1","2",28680012,28866654,186642
"8467","ENSG00000163806","SPDYA","2",29005383,29073477,68094
"8468","ENSG00000163807","KIAA1143","3",44779153,44803154,24001
"8469","ENSG00000163808","KIF15","3",44803209,44914868,111659
"8470","ENSG00000163811","WDR43","2",29117509,29171088,53579
"8471","ENSG00000163812","ZDHHC3","3",44956749,45017677,60928
"8472","ENSG00000163814","CDCP1","3",45123770,45187914,64144
"8473","ENSG00000163818","LZTFL1","3",45864808,45957534,92726
"8474","ENSG00000163820","FYCO1","3",45959396,46037316,77920
"8475","ENSG00000163832","ELP6","3",47537130,47555251,18121
"8476","ENSG00000163840","DTX3L","3",122283085,122294050,10965
"8477","ENSG00000163848","ZNF148","3",124944405,125094198,149793
"8478","ENSG00000163864","NMNAT3","3",139279022,139396859,117837
"8479","ENSG00000163866","SMIM12","1",35178338,35325417,147079
"8480","ENSG00000163867","ZMYM6","1",35449523,35497569,48046
"8481","ENSG00000163870","TPRA1","3",127291912,127317094,25182
"8482","ENSG00000163872","YEATS2","3",183415606,183530413,114807
"8483","ENSG00000163873","GRIK3","1",37261128,37499730,238602
"8484","ENSG00000163874","ZC3H12A","1",37940153,37949980,9827
"8485","ENSG00000163875","MEAF6","1",37958176,37980375,22199
"8486","ENSG00000163877","SNIP1","1",38000050,38019903,19853
"8487","ENSG00000163879","DNALI1","1",38022520,38032458,9938
"8488","ENSG00000163882","POLR2H","3",184079506,184086384,6878
"8489","ENSG00000163884","KLF15","3",126061478,126076285,14807
"8490","ENSG00000163888","CAMK2N2","3",183977001,183979251,2250
"8491","ENSG00000163900","TMEM41A","3",185194284,185216845,22561
"8492","ENSG00000163902","RPN1","3",128338817,128399918,61101
"8493","ENSG00000163904","SENP2","3",185300284,185351339,51055
"8494","ENSG00000163909","HEYL","1",40089825,40105617,15792
"8495","ENSG00000163913","IFT122","3",129158968,129239198,80230
"8496","ENSG00000163918","RFC4","3",186507669,186524847,17178
"8497","ENSG00000163923","RPL39L","3",186838736,186898696,59960
"8498","ENSG00000163930","BAP1","3",52435029,52444366,9337
"8499","ENSG00000163931","TKT","3",53258723,53290068,31345
"8500","ENSG00000163932","PRKCD","3",53190025,53226733,36708
"8501","ENSG00000163933","RFT1","3",53122499,53164478,41979
"8502","ENSG00000163935","SFMBT1","3",52937588,53080766,143178
"8503","ENSG00000163938","GNL3","3",52715172,52728508,13336
"8504","ENSG00000163939","PBRM1","3",52579368,52719933,140565
"8505","ENSG00000163945","UVSSA","4",1341054,1381837,40783
"8506","ENSG00000163946","FAM208A","3",56654161,56717265,63104
"8507","ENSG00000163947","ARHGEF3","3",56761446,57113357,351911
"8508","ENSG00000163950","SLBP","4",1694527,1714282,19755
"8509","ENSG00000163956","LRPAP1","4",3508103,3534286,26183
"8510","ENSG00000163960","UBXN7","3",196074533,196159345,84812
"8511","ENSG00000163961","RNF168","3",196195654,196230639,34985
"8512","ENSG00000163964","PIGX","3",196366646,196462878,96232
"8513","ENSG00000163975","MFI2","3",196715492,196756687,41195
"8514","ENSG00000163995","ABLIM2","4",7967039,8160559,193520
"8515","ENSG00000164002","EXO5","1",40974413,40982228,7815
"8516","ENSG00000164008","C1orf50","1",43232940,43263968,31028
"8517","ENSG00000164010","ERMAP","1",43282795,43310660,27865
"8518","ENSG00000164011","ZNF691","1",43312280,43318148,5868
"8519","ENSG00000164022","AIMP1","4",107236701,107270383,33682
"8520","ENSG00000164023","SGMS2","4",108745719,108836203,90484
"8521","ENSG00000164024","METAP1","4",99916771,99983964,67193
"8522","ENSG00000164031","DNAJB14","4",100817405,100867883,50478
"8523","ENSG00000164032","H2AFZ","4",100869243,100871545,2302
"8524","ENSG00000164038","SLC9B2","4",103941025,104006986,65961
"8525","ENSG00000164039","BDH2","4",104000592,104021040,20448
"8526","ENSG00000164040","PGRMC2","4",129190397,129209984,19587
"8527","ENSG00000164045","CDC25A","3",48198636,48229892,31256
"8528","ENSG00000164048","ZNF589","3",48282590,48340743,58153
"8529","ENSG00000164049","FBXW12","3",48413709,48442666,28957
"8530","ENSG00000164050","PLXNB1","3",48445261,48471594,26333
"8531","ENSG00000164051","CCDC51","3",48473574,48481866,8292
"8532","ENSG00000164053","ATRIP","3",48488114,48507115,19001
"8533","ENSG00000164054","SHISA5","3",48509197,48542259,33062
"8534","ENSG00000164056","SPRY1","4",124317950,124324910,6960
"8535","ENSG00000164061","BSN","3",49591922,49708978,117056
"8536","ENSG00000164062","APEH","3",49711435,49721396,9961
"8537","ENSG00000164066","INTU","4",128544426,128647892,103466
"8538","ENSG00000164068","RNF123","3",49726932,49758962,32030
"8539","ENSG00000164070","HSPA4L","4",128702976,128761888,58912
"8540","ENSG00000164073","MFSD8","4",128838960,128887150,48190
"8541","ENSG00000164074","C4orf29","4",128886461,128960866,74405
"8542","ENSG00000164076","CAMKV","3",49895421,49907655,12234
"8543","ENSG00000164077","MON1A","3",49946302,49967606,21304
"8544","ENSG00000164080","RAD54L2","3",51575160,51702683,127523
"8545","ENSG00000164081","TEX264","3",51696709,51738339,41630
"8546","ENSG00000164082","GRM2","3",51741086,51752629,11543
"8547","ENSG00000164086","DUSP7","3",52082935,52090566,7631
"8548","ENSG00000164087","POC1A","3",52109269,52188706,79437
"8549","ENSG00000164088","PPM1M","3",52279841,52284613,4772
"8550","ENSG00000164091","WDR82","3",52288437,52322036,33599
"8551","ENSG00000164096","C4orf3","4",120218207,120225600,7393
"8552","ENSG00000164099","PRSS12","4",119201193,119274158,72965
"8553","ENSG00000164100","NDST3","4",118954773,119179803,225030
"8554","ENSG00000164104","HMGB2","4",174252846,174256276,3430
"8555","ENSG00000164105","SAP30","4",174291120,174298683,7563
"8556","ENSG00000164109","MAD2L1","4",120976763,120988229,11466
"8557","ENSG00000164111","ANXA5","4",122589110,122618268,29158
"8558","ENSG00000164114","MAP9","4",156263810,156298122,34312
"8559","ENSG00000164116","GUCY1A3","4",156587863,156653501,65638
"8560","ENSG00000164117","FBXO8","4",175157809,175205415,47606
"8561","ENSG00000164118","CEP44","4",175204828,175254531,49703
"8562","ENSG00000164124","TMEM144","4",159122756,159176563,53807
"8563","ENSG00000164125","FAM198B","4",159045626,159094470,48844
"8564","ENSG00000164128","NPY1R","4",164245113,164265984,20871
"8565","ENSG00000164134","NAA15","4",140222609,140341187,118578
"8566","ENSG00000164142","FAM160A1","4",152330368,152584784,254416
"8567","ENSG00000164144","ARFIP1","4",153701089,153839615,138526
"8568","ENSG00000164151","KIAA0947","5",5420777,5490347,69570
"8569","ENSG00000164161","HHIP","4",145567173,145666423,99250
"8570","ENSG00000164162","ANAPC10","4",145888264,146019693,131429
"8571","ENSG00000164163","ABCE1","4",146019084,146050331,31247
"8572","ENSG00000164164","OTUD4","4",146031990,146101313,69323
"8573","ENSG00000164167","LSM6","4",147096837,147121152,24315
"8574","ENSG00000164168","TMEM184C","4",148538534,148593195,54661
"8575","ENSG00000164169","PRMT10","4",148558936,148605381,46445
"8576","ENSG00000164171","ITGA2","5",52285156,52390609,105453
"8577","ENSG00000164172","MOCS2","5",52391509,52405893,14384
"8578","ENSG00000164175","SLC45A2","5",33944721,33984835,40114
"8579","ENSG00000164176","EDIL3","5",83236373,83680611,444238
"8580","ENSG00000164180","TMEM161B","5",87485450,87565293,79843
"8581","ENSG00000164182","NDUFAF2","5",60240956,60448853,207897
"8582","ENSG00000164187","LMBRD2","5",36098514,36152063,53549
"8583","ENSG00000164190","NIPBL","5",36876861,37066515,189654
"8584","ENSG00000164197","RNF180","5",63461671,63668696,207025
"8585","ENSG00000164199","GPR98","5",89825161,90460038,634877
"8586","ENSG00000164209","SLC25A46","5",110073837,110100857,27020
"8587","ENSG00000164211","STARD4","5",110831731,110848288,16557
"8588","ENSG00000164219","PGGT1B","5",114546527,114598569,52042
"8589","ENSG00000164220","F2RL2","5",75911307,75919259,7952
"8590","ENSG00000164221","CCDC112","5",114602885,114632528,29643
"8591","ENSG00000164237","CMBL","5",10275987,10308138,32151
"8592","ENSG00000164241","C5orf63","5",126378250,126409184,30934
"8593","ENSG00000164244","PRRC1","5",126853301,126890781,37480
"8594","ENSG00000164251","F2RL1","5",76114758,76131140,16382
"8595","ENSG00000164252","AGGF1","5",76325076,76361059,35983
"8596","ENSG00000164253","WDR41","5",76721795,76916436,194641
"8597","ENSG00000164258","NDUFS4","5",52856463,52979168,122705
"8598","ENSG00000164284","GRPEL2","5",148724993,148734146,9153
"8599","ENSG00000164291","ARSK","5",94890778,94940768,49990
"8600","ENSG00000164292","RHOBTB3","5",95049226,95160087,110861
"8601","ENSG00000164294","GPX8","5",54455946,54462899,6953
"8602","ENSG00000164296","TIGD6","5",149372681,149380730,8049
"8603","ENSG00000164300","SERINC5","5",79407050,79551898,144848
"8604","ENSG00000164305","CASP3","4",185548850,185570663,21813
"8605","ENSG00000164306","PRIMPOL","4",185570767,185616117,45350
"8606","ENSG00000164307","ERAP1","5",96096521,96143803,47282
"8607","ENSG00000164308","ERAP2","5",96211643,96255420,43777
"8608","ENSG00000164309","CMYA5","5",78985700,79096063,110363
"8609","ENSG00000164318","EGFLAM","5",38258511,38465123,206612
"8610","ENSG00000164323","KIAA1430","4",186080819,186130658,49839
"8611","ENSG00000164327","RICTOR","5",38938021,39074510,136489
"8612","ENSG00000164329","PAPD4","5",78907943,78982471,74528
"8613","ENSG00000164330","EBF1","5",158122928,158526769,403841
"8614","ENSG00000164331","ANKRA2","5",72848160,72861511,13351
"8615","ENSG00000164332","UBLCP1","5",158690089,158713044,22955
"8616","ENSG00000164338","UTP15","5",72861268,72877794,16526
"8617","ENSG00000164342","TLR3","4",186990306,187009223,18917
"8618","ENSG00000164344","KLKB1","4",187130133,187179625,49492
"8619","ENSG00000164346","NSA2","5",74062817,74072737,9920
"8620","ENSG00000164347","GFM2","5",74017029,74063196,46167
"8621","ENSG00000164362","TERT","5",1253262,1295184,41922
"8622","ENSG00000164366","CCDC127","5",196986,218330,21344
"8623","ENSG00000164398","ACSL6","5",131142683,131347936,205253
"8624","ENSG00000164402","SEPT8","5",132086509,132142933,56424
"8625","ENSG00000164403","SHROOM1","5",132157833,132166590,8757
"8626","ENSG00000164405","UQCRQ","5",132202252,132203723,1471
"8627","ENSG00000164406","LEAP2","5",132208014,132210738,2724
"8628","ENSG00000164414","SLC35A1","6",88180341,88222054,41713
"8629","ENSG00000164418","GRIK2","6",101846664,102517958,671294
"8630","ENSG00000164434","FABP7","6",123100620,123105219,4599
"8631","ENSG00000164438","TLX3","5",170736288,170739138,2850
"8632","ENSG00000164442","CITED2","6",139693393,139695757,2364
"8633","ENSG00000164463","CREBRF","5",172483355,172566291,82936
"8634","ENSG00000164465","DCBLD1","6",117774980,117891021,116041
"8635","ENSG00000164466","SFXN1","5",174904065,174956745,52680
"8636","ENSG00000164484","TMEM200A","6",130686879,130764208,77329
"8637","ENSG00000164494","PDSS2","6",107473761,107780768,307007
"8638","ENSG00000164506","STXBP5","6",147525561,147706866,181305
"8639","ENSG00000164535","DAGLB","7",6448757,6523821,75064
"8640","ENSG00000164542","KIAA0895","7",36363830,36429734,65904
"8641","ENSG00000164543","STK17A","7",43622357,43666385,44028
"8642","ENSG00000164548","TRA2A","7",23544399,23571660,27261
"8643","ENSG00000164574","GALNT10","5",153570290,153800544,230254
"8644","ENSG00000164576","SAP30L","5",153825517,153840614,15097
"8645","ENSG00000164587","RPS14","5",149822753,149829319,6566
"8646","ENSG00000164588","HCN1","5",45259349,45696253,436904
"8647","ENSG00000164591","MYOZ3","5",150040436,150058927,18491
"8648","ENSG00000164597","COG5","7",106842000,107204959,362959
"8649","ENSG00000164603","C7orf60","7",112459202,112579971,120769
"8650","ENSG00000164604","GPR85","7",112718386,112727833,9447
"8651","ENSG00000164609","SLU7","5",159828648,159848718,20070
"8652","ENSG00000164610","RP9","7",33134409,33149013,14604
"8653","ENSG00000164611","PTTG1","5",159848829,159855748,6919
"8654","ENSG00000164615","CAMLG","5",134074191,134087847,13656
"8655","ENSG00000164619","BMPER","7",33944523,34195484,250961
"8656","ENSG00000164620","RELL2","5",141016517,141020644,4127
"8657","ENSG00000164626","KCNK5","6",39156749,39197226,40477
"8658","ENSG00000164627","KIF6","6",39297766,39693181,395415
"8659","ENSG00000164631","ZNF12","7",6728064,6746554,18490
"8660","ENSG00000164638","SLC29A4","7",5314000,5346501,32501
"8661","ENSG00000164647","STEAP1","7",89783689,89794143,10454
"8662","ENSG00000164649","CDCA7L","7",21940518,21985702,45184
"8663","ENSG00000164654","MIOS","7",7606503,7648560,42057
"8664","ENSG00000164659","KIAA1324L","7",86506222,86689015,182793
"8665","ENSG00000164663","USP49","6",41757634,41863099,105465
"8666","ENSG00000164669","INTS4L1","7",64601603,64694600,92997
"8667","ENSG00000164675","IQUB","7",123092454,123175131,82677
"8668","ENSG00000164683","HEY1","8",80676245,80680098,3853
"8669","ENSG00000164684","ZNF704","8",81540686,81787016,246330
"8670","ENSG00000164687","FABP5","8",82192598,82197012,4414
"8671","ENSG00000164692","COL1A2","7",94023873,94060544,36671
"8672","ENSG00000164707","SLC13A4","7",135365985,135414006,48021
"8673","ENSG00000164713","BRI3","7",97881691,97937162,55471
"8674","ENSG00000164715","LMTK2","7",97736197,97838945,102748
"8675","ENSG00000164733","CTSB","8",11700033,11726957,26924
"8676","ENSG00000164741","DLC1","8",12940870,13373167,432297
"8677","ENSG00000164742","ADCY1","7",45613739,45762715,148976
"8678","ENSG00000164743","C8orf48","8",13424352,13425796,1444
"8679","ENSG00000164749","HNF4G","8",76320149,76479078,158929
"8680","ENSG00000164751","PEX2","8",77892494,77913280,20786
"8681","ENSG00000164754","RAD21","8",117858174,117887105,28931
"8682","ENSG00000164758","MED30","8",118532952,118552501,19549
"8683","ENSG00000164761","TNFRSF11B","8",119935796,119964439,28643
"8684","ENSG00000164778","EN2","7",155250824,155257526,6702
"8685","ENSG00000164794","KCNV1","8",110975874,110988076,12202
"8686","ENSG00000164796","CSMD3","8",113235157,114449328,1214171
"8687","ENSG00000164808","SPIDR","8",48173167,48648868,475701
"8688","ENSG00000164815","ORC5","7",103766788,103848495,81707
"8689","ENSG00000164818","HEATR2","7",766338,829190,62852
"8690","ENSG00000164823","OSGIN2","8",90914087,90940116,26029
"8691","ENSG00000164828","SUN1","7",855528,936072,80544
"8692","ENSG00000164830","OXR1","8",107282473,107764922,482449
"8693","ENSG00000164841","TMEM74","8",109619079,109799844,180765
"8694","ENSG00000164845","FAM86FP","12",8385108,8395544,10436
"8695","ENSG00000164877","MICALL2","7",1468101,1499138,31037
"8696","ENSG00000164879","CA3","8",86285665,86361269,75604
"8697","ENSG00000164880","INTS1","7",1509913,1545489,35576
"8698","ENSG00000164885","CDK5","7",150750899,150755617,4718
"8699","ENSG00000164889","SLC4A2","7",150754297,150773614,19317
"8700","ENSG00000164896","FASTK","7",150773711,150777953,4242
"8701","ENSG00000164897","TMUB1","7",150778167,150780633,2466
"8702","ENSG00000164898","C7orf55","7",139024203,139031065,6862
"8703","ENSG00000164902","PHAX","5",125935960,125962944,26984
"8704","ENSG00000164904","ALDH7A1","5",125877533,125931110,53577
"8705","ENSG00000164916","FOXK1","7",4683388,4811074,127686
"8706","ENSG00000164919","COX6C","8",100885428,100906290,20862
"8707","ENSG00000164924","YWHAZ","8",101928753,101965616,36863
"8708","ENSG00000164929","BAALC","8",104152938,104242533,89595
"8709","ENSG00000164930","FZD6","8",104310661,104345094,34433
"8710","ENSG00000164933","SLC25A32","8",104410863,104427417,16554
"8711","ENSG00000164934","DCAF13","8",104426942,104455681,28739
"8712","ENSG00000164938","TP53INP1","8",95938200,95961639,23439
"8713","ENSG00000164941","INTS8","8",95825539,95893974,68435
"8714","ENSG00000164944","KIAA1429","8",95499921,95565757,65836
"8715","ENSG00000164946","FREM1","9",14734664,14910993,176329
"8716","ENSG00000164949","GEM","8",95261481,95274578,13097
"8717","ENSG00000164951","PDP1","8",94870035,94938294,68259
"8718","ENSG00000164953","TMEM67","8",94767072,94831462,64390
"8719","ENSG00000164961","KIAA0196","8",126036502,126104082,67580
"8720","ENSG00000164967","RPP25L","9",34610483,34612101,1618
"8721","ENSG00000164970","FAM219A","9",34398182,34458568,60386
"8722","ENSG00000164975","SNAPC3","9",15422702,15465951,43249
"8723","ENSG00000164976","KIAA1161","9",34366668,34376851,10183
"8724","ENSG00000164978","NUDT2","9",34329504,34343709,14205
"8725","ENSG00000164983","TMEM65","8",125324231,125384933,60702
"8726","ENSG00000164985","PSIP1","9",15464064,15511017,46953
"8727","ENSG00000164989","CCDC171","9",15552895,16061661,508766
"8728","ENSG00000165006","UBAP1","9",34179003,34252521,73518
"8729","ENSG00000165023","DIRAS2","9",93372114,93405386,33272
"8730","ENSG00000165028","NIPSNAP3B","9",107526438,107539738,13300
"8731","ENSG00000165029","ABCA1","9",107543283,107690518,147235
"8732","ENSG00000165030","NFIL3","9",94171327,94186144,14817
"8733","ENSG00000165046","LETM2","8",38243725,38267045,23320
"8734","ENSG00000165055","METTL2B","7",128116783,128146656,29873
"8735","ENSG00000165060","FXN","9",71650175,71715094,64919
"8736","ENSG00000165061","ZMAT4","8",40388109,40755352,367243
"8737","ENSG00000165071","TMEM71","8",133697253,133772958,75705
"8738","ENSG00000165072","MAMDC2","9",72658497,72841886,183389
"8739","ENSG00000165097","KDM1B","6",18155560,18224084,68524
"8740","ENSG00000165102","HGSNAT","8",42995556,43057998,62442
"8741","ENSG00000165113","GKAP1","9",86354336,86444431,90095
"8742","ENSG00000165115","KIF27","9",86451613,86536342,84729
"8743","ENSG00000165118","C9orf64","9",86553226,86571901,18675
"8744","ENSG00000165119","HNRNPK","9",86582998,86595569,12571
"8745","ENSG00000165121","","9",88430881,88464426,33545
"8746","ENSG00000165124","SVEP1","9",113127531,113342160,214629
"8747","ENSG00000165138","ANKS6","9",101493611,101559247,65636
"8748","ENSG00000165152","TMEM246","9",104235453,104295819,60366
"8749","ENSG00000165156","ZHX1","8",124260696,124287781,27085
"8750","ENSG00000165169","DYNLT3","X",37696010,37706890,10880
"8751","ENSG00000165171","WBSCR27","7",73248920,73256865,7945
"8752","ENSG00000165175","MID1IP1","X",38660685,38665790,5105
"8753","ENSG00000165185","KIAA1958","9",115249127,115431677,182550
"8754","ENSG00000165194","PCDH19","X",99546642,99665271,118629
"8755","ENSG00000165195","PIGA","X",15337573,15353676,16103
"8756","ENSG00000165197","FIGF","X",15363713,15402498,38785
"8757","ENSG00000165209","STRBP","9",125871779,126030855,159076
"8758","ENSG00000165219","GAPVD1","9",128024073,128129486,105413
"8759","ENSG00000165233","C9orf89","9",95858500,95875565,17065
"8760","ENSG00000165238","WNK2","9",95947198,96082854,135656
"8761","ENSG00000165240","ATP7A","X",77166194,77305892,139698
"8762","ENSG00000165244","ZNF367","9",99148223,99180611,32388
"8763","ENSG00000165246","NLGN4Y","Y",16634518,16957530,323012
"8764","ENSG00000165259","HDX","X",83572882,83757487,184605
"8765","ENSG00000165264","NDUFB6","9",32552997,32573160,20163
"8766","ENSG00000165271","NOL6","9",33461439,33473928,12489
"8767","ENSG00000165275","TRMT10B","9",37753804,37778969,25165
"8768","ENSG00000165280","VCP","9",35056061,35073246,17185
"8769","ENSG00000165282","PIGO","9",35088685,35096591,7906
"8770","ENSG00000165283","STOML2","9",35099888,35103154,3266
"8771","ENSG00000165288","BRWD3","X",79926353,80065187,138834
"8772","ENSG00000165300","SLITRK5","13",88324870,88331871,7001
"8773","ENSG00000165304","MELK","9",36572859,36677678,104819
"8774","ENSG00000165309","ARMC3","10",23216953,23326518,109565
"8775","ENSG00000165312","OTUD1","10",23728198,23731308,3110
"8776","ENSG00000165322","ARHGAP12","10",32094365,32217742,123377
"8777","ENSG00000165323","FAT3","11",92085262,92629618,544356
"8778","ENSG00000165338","HECTD2","10",93170096,93274586,104490
"8779","ENSG00000165349","SLC7A3","X",70145432,70150975,5543
"8780","ENSG00000165355","FBXO33","14",39866873,39901704,34831
"8781","ENSG00000165359","DDX26B","X",134654584,134716435,61851
"8782","ENSG00000165379","LRFN5","14",42076773,42373752,296979
"8783","ENSG00000165388","ZNF488","10",48355024,48373866,18842
"8784","ENSG00000165389","SPTSSA","14",34901995,34931562,29567
"8785","ENSG00000165392","WRN","8",30891317,31031285,139968
"8786","ENSG00000165406","MARCH8","10",45950035,46090354,140319
"8787","ENSG00000165410","CFL2","14",35179593,35184029,4436
"8788","ENSG00000165416","SUGT1","13",53226844,53275044,48200
"8789","ENSG00000165417","GTF2A1","14",81641796,81687721,45925
"8790","ENSG00000165424","ZCCHC24","10",81142081,81205383,63302
"8791","ENSG00000165434","PGM2L1","11",74041363,74109518,68155
"8792","ENSG00000165443","PHYHIPL","10",60936350,61007534,71184
"8793","ENSG00000165449","SLC16A9","10",61410523,61495760,85237
"8794","ENSG00000165458","INPPL1","11",71934745,71950149,15404
"8795","ENSG00000165475","CRYL1","13",20977806,21099996,122190
"8796","ENSG00000165476","REEP3","10",65281123,65384883,103760
"8797","ENSG00000165480","SKA3","13",21727734,21750741,23007
"8798","ENSG00000165487","MICU2","13",22066836,22178353,111517
"8799","ENSG00000165490","C11orf82","11",82611017,82669319,58302
"8800","ENSG00000165494","PCF11","11",82868030,82898493,30463
"8801","ENSG00000165495","PKNOX2","11",125034583,125303285,268702
"8802","ENSG00000165501","LRR1","14",50065415,50081390,15975
"8803","ENSG00000165502","RPL36AL","14",50085237,50087403,2166
"8804","ENSG00000165506","DNAAF2","14",50091892,50101948,10056
"8805","ENSG00000165511","C10orf25","10",45493146,45496336,3190
"8806","ENSG00000165512","ZNF22","10",45495923,45500774,4851
"8807","ENSG00000165516","KLHDC2","14",50234326,50249909,15583
"8808","ENSG00000165521","EML5","14",89078775,89259096,180321
"8809","ENSG00000165525","NEMF","14",50249997,50319921,69924
"8810","ENSG00000165526","RPUSD4","11",126071993,126081587,9594
"8811","ENSG00000165527","ARF6","14",50359810,50361490,1680
"8812","ENSG00000165533","TTC8","14",89290497,89344335,53838
"8813","ENSG00000165548","TMEM63C","14",77582911,77725838,142927
"8814","ENSG00000165555","NOXRED1","14",77860364,77889860,29496
"8815","ENSG00000165566","AMER2","13",25735822,25746426,10604
"8816","ENSG00000165568","AKR1E2","10",4828821,4890254,61433
"8817","ENSG00000165572","KBTBD6","13",41701705,41706882,5177
"8818","ENSG00000165609","NUDT5","10",12207324,12238143,30819
"8819","ENSG00000165617","DACT1","14",59100685,59115039,14354
"8820","ENSG00000165626","BEND7","10",13480484,13570974,90490
"8821","ENSG00000165629","ATP5C1","10",7830092,7849778,19686
"8822","ENSG00000165630","PRPF18","10",13628927,13672868,43941
"8823","ENSG00000165632","TAF3","10",7860467,8058590,198123
"8824","ENSG00000165633","VSTM4","10",50222290,50323554,101264
"8825","ENSG00000165637","VDAC2","10",76969912,76991206,21294
"8826","ENSG00000165650","PDZD8","10",119040000,119134978,94978
"8827","ENSG00000165655","ZNF503","10",77157588,77161664,4076
"8828","ENSG00000165659","DACH1","13",72012098,72441330,429232
"8829","ENSG00000165660","FAM175B","10",126490354,126525239,34885
"8830","ENSG00000165661","QSOX2","9",139098179,139137687,39508
"8831","ENSG00000165669","FAM204A","10",120065401,120101840,36439
"8832","ENSG00000165671","NSD1","5",176560026,176727216,167190
"8833","ENSG00000165672","PRDX3","10",120927215,120938345,11130
"8834","ENSG00000165675","ENOX2","X",129757350,130037208,279858
"8835","ENSG00000165678","GHITM","10",85899196,85913001,13805
"8836","ENSG00000165684","SNAPC4","9",139270029,139293249,23220
"8837","ENSG00000165688","PMPCA","9",139305110,139318213,13103
"8838","ENSG00000165689","SDCCAG3","9",139296377,139305061,8684
"8839","ENSG00000165695","AK8","9",135600965,135754164,153199
"8840","ENSG00000165698","C9orf9","9",135753414,135765588,12174
"8841","ENSG00000165699","TSC1","9",135766735,135820020,53285
"8842","ENSG00000165704","HPRT1","X",133594183,133654543,60360
"8843","ENSG00000165714","LOH12CR1","12",12510013,12619840,109827
"8844","ENSG00000165716","FAM69B","9",139607022,139618502,11480
"8845","ENSG00000165724","ZMYND19","9",140476531,140484942,8411
"8846","ENSG00000165730","STOX1","10",70587298,70655188,67890
"8847","ENSG00000165732","DDX21","10",70715884,70744829,28945
"8848","ENSG00000165733","BMS1","10",43278249,43330385,52136
"8849","ENSG00000165752","STK32C","10",134020996,134145351,124355
"8850","ENSG00000165757","KIAA1462","10",30301729,30404423,102694
"8851","ENSG00000165775","FUNDC2","X",154254255,154288578,34323
"8852","ENSG00000165782","TMEM55B","14",20925878,20929771,3893
"8853","ENSG00000165792","METTL17","14",21457929,21465189,7260
"8854","ENSG00000165795","NDRG2","14",21484922,21539031,54109
"8855","ENSG00000165801","ARHGEF40","14",21538429,21558399,19970
"8856","ENSG00000165802","NSMF","9",140342022,140353786,11764
"8857","ENSG00000165804","ZNF219","14",21558205,21572881,14676
"8858","ENSG00000165806","CASP7","10",115438942,115490662,51720
"8859","ENSG00000165807","PPP1R36","14",65016620,65056098,39478
"8860","ENSG00000165813","C10orf118","10",115880621,115933979,53358
"8861","ENSG00000165819","METTL3","14",21966277,21979517,13240
"8862","ENSG00000165821","SALL2","14",21989232,22005350,16118
"8863","ENSG00000165832","TRUB1","10",116697952,116737430,39478
"8864","ENSG00000165861","ZFYVE1","14",73436159,73493920,57761
"8865","ENSG00000165868","HSPA12A","10",118430703,118502085,71382
"8866","ENSG00000165879","FRAT1","10",99079022,99081672,2650
"8867","ENSG00000165886","UBTD1","10",99258625,99330966,72341
"8868","ENSG00000165891","E2F7","12",77415027,77459360,44333
"8869","ENSG00000165895","ARHGAP42","11",100558384,100862668,304284
"8870","ENSG00000165898","ISCA2","14",74960423,74963809,3386
"8871","ENSG00000165899","OTOGL","12",80603233,80772870,169637
"8872","ENSG00000165912","PACSIN3","11",47199076,47207994,8918
"8873","ENSG00000165914","TTC7B","14",91006932,91282823,275891
"8874","ENSG00000165915","SLC39A13","11",47428683,47438047,9364
"8875","ENSG00000165916","PSMC3","11",47440320,47447993,7673
"8876","ENSG00000165923","AGBL2","11",47681143,47736941,55798
"8877","ENSG00000165934","CPSF2","14",92588281,92630755,42474
"8878","ENSG00000165943","MOAP1","14",93648541,93651273,2732
"8879","ENSG00000165948","IFI27L1","14",94547628,94570192,22564
"8880","ENSG00000165949","IFI27","14",94571182,94583033,11851
"8881","ENSG00000165959","CLMN","14",95648277,95786243,137966
"8882","ENSG00000165983","PTER","10",16478942,16555736,76794
"8883","ENSG00000165996","PTPLA","10",17631958,17659376,27418
"8884","ENSG00000165997","ARL5B","10",18948334,18970568,22234
"8885","ENSG00000166002","SMCO4","11",93211638,93276674,65036
"8886","ENSG00000166004","KIAA1731","11",93394805,93463522,68717
"8887","ENSG00000166012","TAF1D","11",93463114,93517557,54443
"8888","ENSG00000166016","ABTB2","11",34172535,34379555,207020
"8889","ENSG00000166024","R3HCC1L","10",99894387,100004654,110267
"8890","ENSG00000166025","AMOTL1","11",94439597,94609918,170321
"8891","ENSG00000166033","HTRA1","10",124221041,124274424,53383
"8892","ENSG00000166037","CEP57","11",95523129,95565857,42728
"8893","ENSG00000166046","TCP11L2","12",106695707,106740793,45086
"8894","ENSG00000166049","PASD1","X",150732094,150845211,113117
"8895","ENSG00000166068","SPRED1","15",38544527,38649450,104923
"8896","ENSG00000166073","GPR176","15",40091233,40213093,121860
"8897","ENSG00000166086","JAM3","11",133938820,134021896,83076
"8898","ENSG00000166106","ADAMTS15","11",130318869,130346532,27663
"8899","ENSG00000166111","SVOP","12",109304658,109459045,154387
"8900","ENSG00000166123","GPT2","16",46918290,46965209,46919
"8901","ENSG00000166128","RAB8B","15",63481668,63559981,78313
"8902","ENSG00000166130","IKBIP","12",99007183,99038891,31708
"8903","ENSG00000166133","RPUSD2","15",40861499,40866659,5160
"8904","ENSG00000166135","HIF1AN","10",102288829,102319755,30926
"8905","ENSG00000166136","NDUFB8","10",102267203,102289757,22554
"8906","ENSG00000166140","ZFYVE19","15",41099284,41106767,7483
"8907","ENSG00000166147","FBN1","15",48700503,48938046,237543
"8908","ENSG00000166148","AVPR1A","12",63539014,63544722,5708
"8909","ENSG00000166153","DEPDC4","12",100597447,100660857,63410
"8910","ENSG00000166164","BRD7","16",50347398,50402845,55447
"8911","ENSG00000166165","CKB","14",103985996,103989448,3452
"8912","ENSG00000166166","TRMT61A","14",103995521,104003410,7889
"8913","ENSG00000166167","BTRC","10",103113820,103317078,203258
"8914","ENSG00000166169","POLL","10",103338639,103348027,9388
"8915","ENSG00000166170","BAG5","14",104022881,104029168,6287
"8916","ENSG00000166171","DPCD","10",103330317,103369425,39108
"8917","ENSG00000166173","LARP6","15",71123863,71146498,22635
"8918","ENSG00000166181","API5","11",43333513,43366079,32566
"8919","ENSG00000166188","ZNF319","16",58028572,58034357,5785
"8920","ENSG00000166189","HPS6","10",103825147,103827792,2645
"8921","ENSG00000166192","SENP8","15",72406599,72433311,26712
"8922","ENSG00000166197","NOLC1","10",103911933,103923627,11694
"8923","ENSG00000166199","ALKBH3","11",43902361,43941816,39455
"8924","ENSG00000166200","COPS2","15",49398268,49447858,49590
"8925","ENSG00000166206","GABRB3","15",26788693,27184686,395993
"8926","ENSG00000166224","SGPL1","10",72575717,72640930,65213
"8927","ENSG00000166225","FRS2","12",69864129,69973562,109433
"8928","ENSG00000166226","CCT2","12",69979114,69995350,16236
"8929","ENSG00000166228","PCBD1","10",72642037,72648541,6504
"8930","ENSG00000166233","ARIH1","15",72766667,72879692,113025
"8931","ENSG00000166246","C16orf71","16",4784273,4799397,15124
"8932","ENSG00000166250","CLMP","11",122943035,123065989,122954
"8933","ENSG00000166257","SCN3B","11",123499895,123525952,26057
"8934","ENSG00000166260","COX11","17",53029263,53046146,16883
"8935","ENSG00000166261","ZNF202","11",123594885,123612383,17498
"8936","ENSG00000166262","FAM227B","15",49619159,49913128,293969
"8937","ENSG00000166263","STXBP4","17",53046088,53241646,195558
"8938","ENSG00000166265","CYYR1","21",27838528,27945603,107075
"8939","ENSG00000166266","CUL5","11",107879459,107978503,99044
"8940","ENSG00000166268","MYRFL","12",70219084,70352877,133793
"8941","ENSG00000166272","WBP1L","10",104503727,104576021,72294
"8942","ENSG00000166275","C10orf32","10",104613980,104624718,10738
"8943","ENSG00000166292","TMEM100","17",53796988,53809482,12494
"8944","ENSG00000166295","ANAPC16","10",73975787,73995618,19831
"8945","ENSG00000166311","SMPD1","11",6411655,6416228,4573
"8946","ENSG00000166313","APBB1","11",6416355,6440644,24289
"8947","ENSG00000166321","NUDT13","10",74870217,74891586,21369
"8948","ENSG00000166323","C11orf65","11",108179246,108338258,159012
"8949","ENSG00000166326","TRIM44","11",35684353,35829775,145422
"8950","ENSG00000166333","ILK","11",6624961,6632102,7141
"8951","ENSG00000166337","TAF10","11",6627526,6633898,6372
"8952","ENSG00000166340","TPP1","11",6634000,6640692,6692
"8953","ENSG00000166341","DCHS1","11",6642556,6677085,34529
"8954","ENSG00000166342","NETO1","18",70409549,70535381,125832
"8955","ENSG00000166343","MSS51","10",75183339,75193319,9980
"8956","ENSG00000166347","CYB5A","18",71920530,71959251,38721
"8957","ENSG00000166348","USP54","10",75257296,75385711,128415
"8958","ENSG00000166349","RAG1","11",36532259,36614706,82447
"8959","ENSG00000166352","C11orf74","11",36616051,36694823,78772
"8960","ENSG00000166377","ATP9B","18",76829285,77138283,308998
"8961","ENSG00000166387","PPFIBP2","11",7534529,7678358,143829
"8962","ENSG00000166394","CYB5R2","11",7686331,7698453,12122
"8963","ENSG00000166398","KIAA0355","19",34745442,34846491,101049
"8964","ENSG00000166401","SERPINB8","18",61637159,61672278,35119
"8965","ENSG00000166402","TUB","11",8040791,8127659,86868
"8966","ENSG00000166405","RIC3","11",8127597,8190602,63005
"8967","ENSG00000166407","LMO1","11",8245851,8290263,44412
"8968","ENSG00000166411","IDH3A","15",78423840,78464291,40451
"8969","ENSG00000166415","WDR72","15",53805938,54055075,249137
"8970","ENSG00000166426","CRABP1","15",78632666,78640572,7906
"8971","ENSG00000166432","ZMAT1","X",101137262,101187004,49742
"8972","ENSG00000166435","XRRA1","11",74518784,74660245,141461
"8973","ENSG00000166436","TRIM66","11",8633584,8693413,59829
"8974","ENSG00000166439","RNF169","11",74459913,74553458,93545
"8975","ENSG00000166441","RPL27A","11",8703958,8736306,32348
"8976","ENSG00000166444","ST5","11",8714898,8932498,217600
"8977","ENSG00000166446","CDYL2","16",80631803,80838226,206423
"8978","ENSG00000166448","TMEM130","7",98444111,98468394,24283
"8979","ENSG00000166450","PRTG","15",55903744,56035288,131544
"8980","ENSG00000166451","CENPN","16",81040103,81066719,26616
"8981","ENSG00000166452","AKIP1","11",8932686,8941631,8945
"8982","ENSG00000166454","ATMIN","16",81069452,81080963,11511
"8983","ENSG00000166455","C16orf46","16",81087102,81110872,23770
"8984","ENSG00000166471","TMEM41B","11",9302201,9336327,34126
"8985","ENSG00000166477","LEO1","15",52230222,52264003,33781
"8986","ENSG00000166478","ZNF143","11",9481866,9550071,68205
"8987","ENSG00000166479","TMX3","18",66340925,66382535,41610
"8988","ENSG00000166483","WEE1","11",9595228,9615004,19776
"8989","ENSG00000166484","MAPK7","17",19281034,19286857,5823
"8990","ENSG00000166501","PRKCB","16",23847322,24231932,384610
"8991","ENSG00000166503","","15",83784320,83876770,92450
"8992","ENSG00000166507","NDST2","10",75561669,75571589,9920
"8993","ENSG00000166508","MCM7","7",99690351,99699563,9212
"8994","ENSG00000166526","ZNF3","7",99661656,99680171,18515
"8995","ENSG00000166529","ZSCAN21","7",99647390,99662661,15271
"8996","ENSG00000166532","RIMKLB","12",8834196,8935691,101495
"8997","ENSG00000166548","TK2","16",66541906,66586447,44541
"8998","ENSG00000166557","TMED3","15",79603404,79704334,100930
"8999","ENSG00000166562","SEC11C","18",56806709,56826068,19359
"9000","ENSG00000166575","TMEM135","11",86748886,87034800,285914
"9001","ENSG00000166578","IQCD","12",113633246,113658899,25653
"9002","ENSG00000166579","NDEL1","17",8316449,8393729,77280
"9003","ENSG00000166582","CENPV","17",16245848,16256970,11122
"9004","ENSG00000166595","FAM96B","16",66965959,66968326,2367
"9005","ENSG00000166598","HSP90B1","12",104323885,104347423,23538
"9006","ENSG00000166619","BLCAP","20",36120874,36156333,35459
"9007","ENSG00000166664","CHRFAM7A","15",30653443,30686052,32609
"9008","ENSG00000166669","ATF7IP2","16",10420291,10577495,157204
"9009","ENSG00000166676","TVP23A","16",10854776,10912651,57875
"9010","ENSG00000166681","NGFRAP1","X",102631268,102633005,1737
"9011","ENSG00000166682","TMPRSS5","11",113558272,113577095,18823
"9012","ENSG00000166685","COG1","17",71189129,71204646,15517
"9013","ENSG00000166689","PLEKHA7","11",16799842,17035990,236148
"9014","ENSG00000166704","ZNF606","19",58488421,58514717,26296
"9015","ENSG00000166707","ZCCHC18","X",103356822,103360533,3711
"9016","ENSG00000166710","B2M","15",45003675,45011075,7400
"9017","ENSG00000166716","ZNF592","15",85291866,85349659,57793
"9018","ENSG00000166734","CASC4","15",44580927,44707956,127029
"9019","ENSG00000166741","NNMT","11",114128509,114184007,55498
"9020","ENSG00000166743","ACSM1","16",20634559,20710212,75653
"9021","ENSG00000166747","AP1G1","16",71762913,71843104,80191
"9022","ENSG00000166748","AGBL1","15",86685227,87572283,887056
"9023","ENSG00000166750","SLFN5","17",33570055,33600674,30619
"9024","ENSG00000166762","CATSPER2","15",43920701,43960316,39615
"9025","ENSG00000166770","ZNF667-AS1","19",56988619,57012035,23416
"9026","ENSG00000166780","C16orf45","16",15528152,15718885,190733
"9027","ENSG00000166783","KIAA0430","16",15688243,15737023,48780
"9028","ENSG00000166788","SAAL1","11",18091482,18127638,36156
"9029","ENSG00000166794","PPIB","15",64448011,64455404,7393
"9030","ENSG00000166797","FAM96A","15",64364758,64386217,21459
"9031","ENSG00000166801","FAM111A","11",58910221,58922512,12291
"9032","ENSG00000166803","KIAA0101","15",64657193,64679886,22693
"9033","ENSG00000166813","KIF7","15",90152020,90198682,46662
"9034","ENSG00000166821","PEX11A","15",90220995,90234014,13019
"9035","ENSG00000166822","TMEM170A","16",75476952,75499395,22443
"9036","ENSG00000166831","RBPMS2","15",65032091,65067786,35695
"9037","ENSG00000166833","NAV2","11",19372271,20143144,770873
"9038","ENSG00000166839","ANKDD1A","15",65204101,65251042,46941
"9039","ENSG00000166845","C18orf54","18",51884287,51911588,27301
"9040","ENSG00000166847","DCTN5","16",23652713,23681195,28482
"9041","ENSG00000166848","TERF2IP","16",75681684,75795770,114086
"9042","ENSG00000166851","PLK1","16",23688977,23701688,12711
"9043","ENSG00000166855","CLPX","15",65440557,65477680,37123
"9044","ENSG00000166860","ZBTB39","12",57392618,57400230,7612
"9045","ENSG00000166881","TMEM194A","12",57449426,57481846,32420
"9046","ENSG00000166886","NAB2","12",57482677,57489259,6582
"9047","ENSG00000166887","VPS39","15",42450899,42500514,49615
"9048","ENSG00000166888","STAT6","12",57489191,57525922,36731
"9049","ENSG00000166889","PATL1","11",59404189,59436453,32264
"9050","ENSG00000166896","XRCC6BP1","12",58335324,58351052,15728
"9051","ENSG00000166900","STX3","11",59480929,59573354,92425
"9052","ENSG00000166902","MRPL16","11",59573608,59578345,4737
"9053","ENSG00000166908","PIP4K2C","12",57984957,57997198,12241
"9054","ENSG00000166912","MTMR10","15",31231144,31283810,52666
"9055","ENSG00000166913","YWHAB","20",43514317,43537173,22856
"9056","ENSG00000166922","SCG5","15",32933877,32989299,55422
"9057","ENSG00000166923","GREM1","15",33010175,33026870,16695
"9058","ENSG00000166924","NYAP1","7",100081550,100092422,10872
"9059","ENSG00000166925","TSC22D4","7",100060982,100076902,15920
"9060","ENSG00000166938","DIS3L","15",66585555,66626236,40681
"9061","ENSG00000166946","CCNDBP1","15",43477316,43487396,10080
"9062","ENSG00000166949","SMAD3","15",67356101,67487533,131432
"9063","ENSG00000166960","CCDC178","18",30517366,31021065,503699
"9064","ENSG00000166963","MAP1A","15",43803156,43823818,20662
"9065","ENSG00000166965","RCCD1","15",91498100,91506349,8249
"9066","ENSG00000166971","AKTIP","16",53524952,53538323,13371
"9067","ENSG00000166974","MAPRE2","18",32556892,32723434,166542
"9068","ENSG00000166979","EVA1C","21",33784314,33887707,103393
"9069","ENSG00000166986","MARS","12",57869228,57911352,42124
"9070","ENSG00000166987","MBD6","12",57914493,57923931,9438
"9071","ENSG00000166997","CNPY4","7",99717236,99723134,5898
"9072","ENSG00000167004","PDIA3","15",44038590,44065477,26887
"9073","ENSG00000167005","NUDT21","16",56463045,56486111,23066
"9074","ENSG00000167037","SGSM1","22",25202236,25323545,121309
"9075","ENSG00000167065","DUSP18","22",31048038,31063877,15839
"9076","ENSG00000167074","TEF","22",41763337,41795330,31993
"9077","ENSG00000167081","PBX3","9",128509624,128729656,220032
"9078","ENSG00000167085","PHB","17",47481414,47492246,10832
"9079","ENSG00000167088","SNRPD1","18",19192228,19210417,18189
"9080","ENSG00000167100","SAMD14","17",48187404,48207246,19842
"9081","ENSG00000167103","PIP5KL1","9",130683158,130693076,9918
"9082","ENSG00000167106","FAM102A","9",130702858,130742792,39934
"9083","ENSG00000167107","ACSF2","17",48503519,48552206,48687
"9084","ENSG00000167110","GOLGA2","9",131018108,131038274,20166
"9085","ENSG00000167112","TRUB2","9",131071382,131085021,13639
"9086","ENSG00000167113","COQ4","9",131084815,131096351,11536
"9087","ENSG00000167114","SLC27A4","9",131102925,131123749,20824
"9088","ENSG00000167118","URM1","9",131133598,131153015,19417
"9089","ENSG00000167123","CERCAM","9",131174030,131199626,25596
"9090","ENSG00000167130","DOLPP1","9",131843379,131852717,9338
"9091","ENSG00000167136","ENDOG","9",131580753,131584956,4203
"9092","ENSG00000167173","C15orf39","15",75487984,75504510,16526
"9093","ENSG00000167178","ISLR2","15",74392652,74430881,38229
"9094","ENSG00000167182","SP2","17",45973516,46006323,32807
"9095","ENSG00000167186","COQ7","16",19078921,19091417,12496
"9096","ENSG00000167191","GPRC5B","16",19868616,19897489,28873
"9097","ENSG00000167193","CRK","17",1323983,1366456,42473
"9098","ENSG00000167196","FBXO22","15",76196200,76227609,31409
"9099","ENSG00000167202","TBC1D2B","15",78276378,78370066,93688
"9100","ENSG00000167216","KATNAL2","18",44497455,44627658,130203
"9101","ENSG00000167220","HDHD2","18",44633774,44676891,43117
"9102","ENSG00000167232","ZNF91","19",23487793,23578362,90569
"9103","ENSG00000167257","RNF214","11",117103341,117157161,53820
"9104","ENSG00000167258","CDK12","17",37617764,37721160,103396
"9105","ENSG00000167264","DUS2","16",68021649,68113223,91574
"9106","ENSG00000167272","POP5","12",121016567,121019201,2634
"9107","ENSG00000167280","ENGASE","17",77071021,77084681,13660
"9108","ENSG00000167281","RBFOX3","17",77085427,77613550,528123
"9109","ENSG00000167283","ATP5L","11",118271869,118302211,30342
"9110","ENSG00000167291","TBC1D16","17",77906142,78009647,103505
"9111","ENSG00000167302","ENTHD2","17",79202077,79212891,10814
"9112","ENSG00000167306","MYO5B","18",47349183,47721463,372280
"9113","ENSG00000167311","ART5","11",3659733,3663546,3813
"9114","ENSG00000167315","ACAA2","18",47309869,47340330,30461
"9115","ENSG00000167323","STIM1","11",3875757,4114439,238682
"9116","ENSG00000167325","RRM1","11",4115937,4160106,44169
"9117","ENSG00000167332","OR51E2","11",4701401,4719084,17683
"9118","ENSG00000167333","TRIM68","11",4619902,4629489,9587
"9119","ENSG00000167363","FN3K","17",80693451,80709073,15622
"9120","ENSG00000167371","PRRT2","16",29823177,29827201,4024
"9121","ENSG00000167377","ZNF23","16",71481500,71496998,15498
"9122","ENSG00000167378","IRGQ","19",44088521,44100287,11766
"9123","ENSG00000167380","ZNF226","19",44669226,44682534,13308
"9124","ENSG00000167383","ZNF229","19",44921685,44952766,31081
"9125","ENSG00000167384","ZNF180","19",44979854,45004576,24722
"9126","ENSG00000167393","PPP2R3B","X",294698,347690,52992
"9127","ENSG00000167394","ZNF668","16",31072164,31085641,13477
"9128","ENSG00000167395","ZNF646","16",31085743,31095517,9774
"9129","ENSG00000167397","VKORC1","16",31102163,31107301,5138
"9130","ENSG00000167447","SMG8","17",57286761,57292608,5847
"9131","ENSG00000167460","TPM4","19",16177831,16213813,35982
"9132","ENSG00000167461","RAB8A","19",16222439,16245044,22605
"9133","ENSG00000167468","GPX4","19",1103936,1106787,2851
"9134","ENSG00000167470","MIDN","19",1248552,1259142,10590
"9135","ENSG00000167487","KLHL26","19",18747775,18781309,33534
"9136","ENSG00000167491","GATAD2A","19",19496635,19619740,123105
"9137","ENSG00000167508","MVD","16",88718343,88729569,11226
"9138","ENSG00000167513","CDT1","16",88869621,88875666,6045
"9139","ENSG00000167515","TRAPPC2L","16",88922628,88929094,6466
"9140","ENSG00000167522","ANKRD11","16",89334038,89556969,222931
"9141","ENSG00000167523","SPATA33","16",89724210,89737680,13470
"9142","ENSG00000167524","","17",26934982,26941218,6236
"9143","ENSG00000167525","PROCA1","17",27030215,27038872,8657
"9144","ENSG00000167526","RPL13","16",89627065,89630950,3885
"9145","ENSG00000167528","ZNF641","12",48733791,48745197,11406
"9146","ENSG00000167535","CACNB3","12",49207577,49222724,15147
"9147","ENSG00000167536","DHRS13","17",27224799,27230089,5290
"9148","ENSG00000167543","TP53I13","17",27893070,27900175,7105
"9149","ENSG00000167548","KMT2D","12",49412758,49453557,40799
"9150","ENSG00000167549","CORO6","17",27941774,27949925,8151
"9151","ENSG00000167550","RHEBL1","12",49458468,49463808,5340
"9152","ENSG00000167552","TUBA1A","12",49578579,49583107,4528
"9153","ENSG00000167553","TUBA1C","12",49582519,49667114,84595
"9154","ENSG00000167554","ZNF610","19",52839498,52871031,31533
"9155","ENSG00000167555","ZNF528","19",52901102,52921665,20563
"9156","ENSG00000167562","ZNF701","19",53059075,53090427,31352
"9157","ENSG00000167565","SERTAD3","19",40946751,40950612,3861
"9158","ENSG00000167566","NCKAP5L","12",50184929,50222533,37604
"9159","ENSG00000167578","RAB4B","19",41284121,41302847,18726
"9160","ENSG00000167595","C19orf55","19",36249044,36261930,12886
"9161","ENSG00000167601","AXL","19",41725108,41767671,42563
"9162","ENSG00000167604","NFKBID","19",36378555,36393205,14650
"9163","ENSG00000167614","TTYH1","19",54926393,54948080,21687
"9164","ENSG00000167615","LENG8","19",54960065,54973217,13152
"9165","ENSG00000167619","TMEM145","19",42817477,42829214,11737
"9166","ENSG00000167625","ZNF526","19",42724423,42732353,7930
"9167","ENSG00000167632","TRAPPC9","8",140742586,141468678,726092
"9168","ENSG00000167635","ZNF146","19",36705504,36729676,24172
"9169","ENSG00000167637","ZNF283","19",44331444,44353307,21863
"9170","ENSG00000167642","SPINT2","19",38734675,38783254,48579
"9171","ENSG00000167645","YIF1B","19",38795753,38807913,12160
"9172","ENSG00000167654","ATCAY","19",3879862,3928077,48215
"9173","ENSG00000167657","DAPK3","19",3958451,3971121,12670
"9174","ENSG00000167658","EEF2","19",3976054,3985467,9413
"9175","ENSG00000167670","CHAF1A","19",4402659,4445015,42356
"9176","ENSG00000167671","UBXN6","19",4444996,4457819,12823
"9177","ENSG00000167674","","19",4472284,4502223,29939
"9178","ENSG00000167680","SEMA6B","19",4542600,4559820,17220
"9179","ENSG00000167685","ZNF444","19",56643968,56672262,28294
"9180","ENSG00000167693","NXN","17",702553,883010,180457
"9181","ENSG00000167695","FAM57A","17",635652,646206,10554
"9182","ENSG00000167699","GLOD4","17",660337,685581,25244
"9183","ENSG00000167700","MFSD3","8",145734457,145736596,2139
"9184","ENSG00000167702","KIFC2","8",145691426,145699585,8159
"9185","ENSG00000167703","SLC43A2","17",1472561,1532180,59619
"9186","ENSG00000167705","RILP","17",1549444,1553371,3927
"9187","ENSG00000167716","WDR81","17",1619817,1641893,22076
"9188","ENSG00000167720","SRR","17",2206677,2228554,21877
"9189","ENSG00000167721","TSR1","17",2225797,2240801,15004
"9190","ENSG00000167723","TRPV3","17",3413796,3461289,47493
"9191","ENSG00000167733","HSD11B1L","19",5680615,5688533,7918
"9192","ENSG00000167740","CYB5D2","17",4046462,4090605,44143
"9193","ENSG00000167747","C19orf48","19",51300961,51308186,7225
"9194","ENSG00000167765","","19",52095036,52097630,2594
"9195","ENSG00000167766","ZNF83","19",53097313,53193749,96436
"9196","ENSG00000167770","OTUB1","11",63753325,63769283,15958
"9197","ENSG00000167771","RCOR2","11",63678693,63684316,5623
"9198","ENSG00000167775","CD320","19",8367011,8373240,6229
"9199","ENSG00000167778","SPRYD3","12",53458388,53473204,14816
"9200","ENSG00000167785","ZNF558","19",8920380,8943004,22624
"9201","ENSG00000167792","NDUFV1","11",67374323,67380006,5683
"9202","ENSG00000167797","CDK2AP2","11",67273968,67276120,2152
"9203","ENSG00000167799","NUDT8","11",67395409,67397401,1992
"9204","ENSG00000167815","PRDX2","19",12907634,12912694,5060
"9205","ENSG00000167840","ZNF232","17",5008836,5026411,17575
"9206","ENSG00000167842","MIS12","17",5389605,5394134,4529
"9207","ENSG00000167861","HID1","17",72946838,72969261,22423
"9208","ENSG00000167862","ICT1","17",73008765,73017356,8591
"9209","ENSG00000167863","ATP5H","17",73034958,73043080,8122
"9210","ENSG00000167874","TMEM88","17",7758383,7759417,1034
"9211","ENSG00000167881","SRP68","17",74035184,74068734,33550
"9212","ENSG00000167889","MGAT5B","17",74864538,74946475,81937
"9213","ENSG00000167900","TK1","17",76170160,76183314,13154
"9214","ENSG00000167904","TMEM68","8",56608983,56685966,76983
"9215","ENSG00000167912","","8",60031599,60033905,2306
"9216","ENSG00000167920","TMEM99","17",38975358,38992522,17164
"9217","ENSG00000167925","GHDC","17",40340817,40346531,5714
"9218","ENSG00000167930","ITFG3","16",284545,319942,35397
"9219","ENSG00000167962","ZNF598","16",2047655,2059824,12169
"9220","ENSG00000167965","MLST8","16",2254249,2259417,5168
"9221","ENSG00000167967","E4F1","16",2273567,2285743,12176
"9222","ENSG00000167969","ECI1","16",2289396,2302301,12905
"9223","ENSG00000167971","CASKIN1","16",2227184,2246526,19342
"9224","ENSG00000167972","ABCA3","16",2325882,2390747,64865
"9225","ENSG00000167977","KCTD5","16",2732476,2759031,26555
"9226","ENSG00000167978","SRRM2","16",2802330,2822539,20209
"9227","ENSG00000167981","ZNF597","16",3486104,3493542,7438
"9228","ENSG00000167985","SDHAF2","11",61197514,61215001,17487
"9229","ENSG00000167986","DDB1","11",61066923,61110068,43145
"9230","ENSG00000167987","VPS37C","11",60897728,60929089,31361
"9231","ENSG00000167992","VWCE","11",61025762,61062896,37134
"9232","ENSG00000167996","FTH1","11",61727190,61735132,7942
"9233","ENSG00000168000","BSCL2","11",62457747,62477317,19570
"9234","ENSG00000168002","POLR2G","11",62529016,62534182,5166
"9235","ENSG00000168003","SLC3A2","11",62623518,62656352,32834
"9236","ENSG00000168005","C11orf84","11",63580860,63595190,14330
"9237","ENSG00000168010","ATG16L2","11",72525353,72554719,29366
"9238","ENSG00000168014","C2CD3","11",73723763,73882255,158492
"9239","ENSG00000168016","TRANK1","3",36868311,36986548,118237
"9240","ENSG00000168026","TTC21A","3",39149152,39180394,31242
"9241","ENSG00000168028","RPSA","3",39448180,39454033,5853
"9242","ENSG00000168036","CTNNB1","3",41236328,41301587,65259
"9243","ENSG00000168038","ULK4","3",41288090,42003922,715832
"9244","ENSG00000168040","FADD","11",70049269,70053496,4227
"9245","ENSG00000168056","LTBP3","11",65306276,65326401,20125
"9246","ENSG00000168061","SAC3D1","11",64808373,64812300,3927
"9247","ENSG00000168066","SF1","11",64532078,64546258,14180
"9248","ENSG00000168067","MAP4K2","11",64556290,64570713,14423
"9249","ENSG00000168077","SCARA3","8",27491385,27534293,42908
"9250","ENSG00000168078","PBK","8",27667137,27695612,28475
"9251","ENSG00000168090","COPS6","7",99686577,99689823,3246
"9252","ENSG00000168092","PAFAH1B2","11",117014983,117047610,32627
"9253","ENSG00000168096","ANKS3","16",4746513,4784379,37866
"9254","ENSG00000168101","NUDT16L1","16",4743695,4745860,2165
"9255","ENSG00000168116","KIAA1586","6",56911347,56920023,8676
"9256","ENSG00000168118","RAB4A","1",229406822,229441641,34819
"9257","ENSG00000168126","OR2W6P","6",27905243,27906181,938
"9258","ENSG00000168137","SETD5","3",9439299,9520924,81625
"9259","ENSG00000168152","THAP9","4",83821837,83841122,19285
"9260","ENSG00000168159","RNF187","1",228674762,228683467,8705
"9261","ENSG00000168172","HOOK3","8",42752075,42885682,133607
"9262","ENSG00000168175","MAPK1IP1L","14",55518349,55536910,18561
"9263","ENSG00000168209","DDIT4","10",74033678,74035794,2116
"9264","ENSG00000168214","RBPJ","4",26165077,26436541,271464
"9265","ENSG00000168216","LMBRD1","6",70385694,70507003,121309
"9266","ENSG00000168228","ZCCHC4","4",25314407,25372005,57598
"9267","ENSG00000168234","TTC39C","18",21572737,21715574,142837
"9268","ENSG00000168237","GLYCTK","3",52321105,52329272,8167
"9269","ENSG00000168242","HIST1H2BI","6",26273144,26273622,478
"9270","ENSG00000168243","GNG4","1",235710987,235814054,103067
"9271","ENSG00000168246","UBTD2","5",171636644,171711075,74431
"9272","ENSG00000168255","POLR2J3","7",102178365,102213103,34738
"9273","ENSG00000168256","NKIRAS2","17",40163400,40177659,14259
"9274","ENSG00000168259","DNAJC7","17",40128451,40173394,44943
"9275","ENSG00000168264","IRF2BP2","1",234740015,234745271,5256
"9276","ENSG00000168268","NT5DC2","3",52558386,52569070,10684
"9277","ENSG00000168273","SMIM4","3",52568029,52613253,45224
"9278","ENSG00000168274","HIST1H2AE","6",26217165,26217711,546
"9279","ENSG00000168275","COA6","1",234509202,234519795,10593
"9280","ENSG00000168280","KIF5C","2",149632819,149883273,250454
"9281","ENSG00000168282","MGAT2","14",50087489,50090198,2709
"9282","ENSG00000168283","BMI1","10",22610140,22620413,10273
"9283","ENSG00000168286","THAP11","16",67876213,67878097,1884
"9284","ENSG00000168288","MMADHC","2",150426148,150444330,18182
"9285","ENSG00000168291","PDHB","3",58413357,58419584,6227
"9286","ENSG00000168297","PXK","3",58318607,58411748,93141
"9287","ENSG00000168298","HIST1H1E","6",26156559,26157343,784
"9288","ENSG00000168300","PCMTD1","8",52730140,52811735,81595
"9289","ENSG00000168301","KCTD6","3",58477841,58488087,10246
"9290","ENSG00000168303","MPLKIP","7",40165622,40174258,8636
"9291","ENSG00000168309","FAM107A","3",58549844,58613337,63493
"9292","ENSG00000168310","IRF2","4",185308867,185395734,86867
"9293","ENSG00000168356","SCN11A","3",38887260,38992052,104792
"9294","ENSG00000168374","ARF4","3",57557090,57583947,26857
"9295","ENSG00000168385","SEPT2","2",242254515,242293442,38927
"9296","ENSG00000168386","FILIP1L","3",99548985,99833357,284372
"9297","ENSG00000168389","MFSD2A","1",40420802,40435638,14836
"9298","ENSG00000168393","DTYMK","2",242615157,242626406,11249
"9299","ENSG00000168394","TAP1","6",32812986,32821755,8769
"9300","ENSG00000168395","ING5","2",242641450,242668893,27443
"9301","ENSG00000168397","ATG4B","2",242576628,242613272,36644
"9302","ENSG00000168411","RFWD3","16",74655292,74700779,45487
"9303","ENSG00000168434","COG7","16",23399814,23464501,64687
"9304","ENSG00000168438","CDC40","6",110501344,110575478,74134
"9305","ENSG00000168439","STIP1","11",63952744,63972015,19271
"9306","ENSG00000168461","RAB31","18",9708162,9862548,154386
"9307","ENSG00000168476","REEP4","8",21995533,21999464,3931
"9308","ENSG00000168487","BMP1","8",22022249,22069839,47590
"9309","ENSG00000168488","ATXN2L","16",28834356,28848558,14202
"9310","ENSG00000168491","CCDC110","4",186366336,186392913,26577
"9311","ENSG00000168495","POLR3D","8",22102617,22112113,9496
"9312","ENSG00000168496","FEN1","11",61560109,61564716,4607
"9313","ENSG00000168497","SDPR","2",192699028,192711981,12953
"9314","ENSG00000168502","SOGA2","18",8705659,8832776,127117
"9315","ENSG00000168505","GBX2","2",237073879,237077012,3133
"9316","ENSG00000168517","HEXIM2","17",43238067,43247407,9340
"9317","ENSG00000168522","FNTA","8",42889337,42940931,51594
"9318","ENSG00000168528","SERINC2","1",31882412,31907525,25113
"9319","ENSG00000168538","TRAPPC11","4",184580420,184634745,54325
"9320","ENSG00000168542","COL3A1","2",189839046,189877472,38426
"9321","ENSG00000168556","ING2","4",184426147,184432249,6102
"9322","ENSG00000168564","CDKN2AIP","4",184365744,184369351,3607
"9323","ENSG00000168566","SNRNP48","6",7590432,7612200,21768
"9324","ENSG00000168569","TMEM223","11",62539101,62559493,20392
"9325","ENSG00000168575","SLC20A2","8",42273993,42397069,123076
"9326","ENSG00000168591","TMUB2","17",42264338,42269099,4761
"9327","ENSG00000168610","STAT3","17",40465342,40540586,75244
"9328","ENSG00000168612","ZSWIM1","20",44509866,44513905,4039
"9329","ENSG00000168614","NBPF9","1",144811744,144830413,18669
"9330","ENSG00000168615","ADAM9","8",38854388,38962663,108275
"9331","ENSG00000168646","AXIN2","17",63524681,63557765,33084
"9332","ENSG00000168653","NDUFS5","1",39491990,39500308,8318
"9333","ENSG00000168661","ZNF30","19",35417807,35436074,18267
"9334","ENSG00000168672","FAM84B","8",127564687,127570638,5951
"9335","ENSG00000168675","LDLRAD4","18",13217497,13652754,435257
"9336","ENSG00000168679","SLC16A4","1",110905470,110933704,28234
"9337","ENSG00000168701","TMEM208","16",67261006,67263181,2175
"9338","ENSG00000168702","LRP1B","2",140988992,142889270,1900278
"9339","ENSG00000168710","AHCYL1","1",110527308,110566357,39049
"9340","ENSG00000168724","DNAJC21","5",34929698,34959069,29371
"9341","ENSG00000168734","PKIG","20",43160426,43252888,92462
"9342","ENSG00000168758","SEMA4C","2",97525453,97536494,11041
"9343","ENSG00000168763","CNNM3","2",97481982,97499648,17666
"9344","ENSG00000168765","GSTM4","1",110198703,110208118,9415
"9345","ENSG00000168769","TET2","4",106067032,106200973,133941
"9346","ENSG00000168772","CXXC4","4",105389469,105416058,26589
"9347","ENSG00000168778","TCTN2","12",124155660,124192948,37288
"9348","ENSG00000168779","SHOX2","3",157814948,157824292,9344
"9349","ENSG00000168781","PPIP5K1","15",43825660,43882430,56770
"9350","ENSG00000168785","TSPAN5","4",99391518,99579780,188262
"9351","ENSG00000168792","ABHD15","17",27887565,27894155,6590
"9352","ENSG00000168795","ZBTB5","9",37438111,37465396,27285
"9353","ENSG00000168802","CHTF8","16",69151913,69166487,14574
"9354","ENSG00000168803","ADAL","15",43622872,43646096,23224
"9355","ENSG00000168806","LCMT2","15",43619974,43622803,2829
"9356","ENSG00000168807","SNTB2","16",69221032,69342955,121923
"9357","ENSG00000168811","IL12A","3",159706537,159713806,7269
"9358","ENSG00000168813","ZNF507","19",32836500,32878573,42073
"9359","ENSG00000168818","STX18","4",4417469,4544073,126604
"9360","ENSG00000168824","","4",4349867,4420785,70918
"9361","ENSG00000168826","ZBTB49","4",4291924,4323513,31589
"9362","ENSG00000168827","GFM1","3",158362067,158410364,48297
"9363","ENSG00000168843","FSTL5","4",162305049,163085187,780138
"9364","ENSG00000168852","TPTE2P5","13",41396432,41495890,99458
"9365","ENSG00000168872","DDX19A","16",70380732,70407286,26554
"9366","ENSG00000168874","ATOH8","2",85978467,86015189,36722
"9367","ENSG00000168876","ANKRD49","11",94226795,94232749,5954
"9368","ENSG00000168883","USP39","2",85829979,85876403,46424
"9369","ENSG00000168884","TNIP2","4",2743375,2758103,14728
"9370","ENSG00000168887","C2orf68","2",85833777,85839189,5412
"9371","ENSG00000168890","TMEM150A","2",85825671,85830319,4648
"9372","ENSG00000168894","RNF181","2",85822848,85824736,1888
"9373","ENSG00000168899","VAMP5","2",85811531,85820535,9004
"9374","ENSG00000168904","LRRC28","15",99791567,99930934,139367
"9375","ENSG00000168906","MAT2A","2",85766288,85772403,6115
"9376","ENSG00000168913","ENHO","9",34521038,34523039,2001
"9377","ENSG00000168916","ZNF608","5",123972608,124084500,111892
"9378","ENSG00000168917","SLC35G2","3",136537489,136574734,37245
"9379","ENSG00000168918","INPP5D","2",233924677,234116549,191872
"9380","ENSG00000168924","LETM1","4",1813206,1857974,44768
"9381","ENSG00000168936","TMEM129","4",1717679,1723085,5406
"9382","ENSG00000168938","PPIC","5",122358945,122372436,13491
"9383","ENSG00000168939","SPRY3","X",154997474,155012121,14647
"9384","ENSG00000168944","CEP120","5",122680579,122759286,78707
"9385","ENSG00000168952","STXBP6","14",25278862,25519503,240641
"9386","ENSG00000168958","MFF","2",228189867,228222550,32683
"9387","ENSG00000168959","GRM5","11",88237744,88799113,561369
"9388","ENSG00000168961","LGALS9","17",25956824,25976586,19762
"9389","ENSG00000168970","JMJD7-PLA2G4B","15",42120293,42140353,20060
"9390","ENSG00000168994","PXDC1","6",3722848,3752260,29412
"9391","ENSG00000169016","E2F6","2",11584501,11606297,21796
"9392","ENSG00000169018","FEM1B","15",68570141,68588203,18062
"9393","ENSG00000169019","COMMD8","4",47452885,47465736,12851
"9394","ENSG00000169020","ATP5I","4",666225,668127,1902
"9395","ENSG00000169021","UQCRFS1","19",29698173,29704448,6275
"9396","ENSG00000169032","MAP2K1","15",66679155,66784650,105495
"9397","ENSG00000169045","HNRNPH1","5",179041179,179061785,20606
"9398","ENSG00000169047","IRS1","2",227596033,227664475,68442
"9399","ENSG00000169057","MECP2","X",153287024,153363212,76188
"9400","ENSG00000169062","UPF3A","13",115047059,115071283,24224
"9401","ENSG00000169064","ZBBX","3",166958075,167099134,141059
"9402","ENSG00000169071","ROR2","9",94325373,94712444,387071
"9403","ENSG00000169083","AR","X",66764465,66950461,185996
"9404","ENSG00000169084","DHRSX","X",2137557,2420846,283289
"9405","ENSG00000169085","C8orf46","8",67372238,67430759,58521
"9406","ENSG00000169087","HSPBAP1","3",122458846,122512671,53825
"9407","ENSG00000169093","ASMTL","X",1522032,1572655,50623
"9408","ENSG00000169100","SLC25A6","X",1505045,1511617,6572
"9409","ENSG00000169105","CHST14","15",40763160,40765353,2193
"9410","ENSG00000169116","PARM1","4",75858305,75975325,117020
"9411","ENSG00000169118","CSNK1G1","15",64457716,64648442,190726
"9412","ENSG00000169122","FAM110B","8",58907068,59116838,209770
"9413","ENSG00000169126","ARMC4","10",28064115,28287977,223862
"9414","ENSG00000169129","AFAP1L2","10",116054583,116164515,109932
"9415","ENSG00000169131","ZNF354A","5",178138593,178157703,19110
"9416","ENSG00000169136","ATF5","19",50431959,50437192,5233
"9417","ENSG00000169139","UBE2V2","8",48920960,48977268,56308
"9418","ENSG00000169155","ZBTB43","9",129567285,129600489,33204
"9419","ENSG00000169169","CPT1C","19",50194155,50216988,22833
"9420","ENSG00000169174","PCSK9","1",55505221,55530525,25304
"9421","ENSG00000169180","XPO6","16",28109300,28223241,113941
"9422","ENSG00000169184","MN1","22",28144265,28197486,53221
"9423","ENSG00000169188","APEX2","X",55026790,55035490,8700
"9424","ENSG00000169189","NSMCE1","16",27236312,27280115,43803
"9425","ENSG00000169193","CCDC126","7",23636998,23684327,47329
"9426","ENSG00000169203","","16",29495010,29517320,22310
"9427","ENSG00000169213","RAB3B","1",52373628,52456436,82808
"9428","ENSG00000169217","CD2BP2","16",30362087,30366682,4595
"9429","ENSG00000169220","RGS14","5",176784838,176799602,14764
"9430","ENSG00000169221","TBC1D10B","16",30368423,30381585,13162
"9431","ENSG00000169223","LMAN2","5",176758563,176778853,20290
"9432","ENSG00000169228","RAB24","5",176728199,176730745,2546
"9433","ENSG00000169230","PRELID1","5",176730775,176733960,3185
"9434","ENSG00000169231","THBS3","1",155165379,155178842,13463
"9435","ENSG00000169239","CA5B","X",15706953,15805747,98794
"9436","ENSG00000169241","SLC50A1","1",155107820,155111329,3509
"9437","ENSG00000169242","EFNA1","1",155099936,155107333,7397
"9438","ENSG00000169246","NPIPB3","16",21413558,21459888,46330
"9439","ENSG00000169247","SH3TC2","5",148303202,148442726,139524
"9440","ENSG00000169249","ZRSR2","X",15808595,15841383,32788
"9441","ENSG00000169251","NMD3","3",160822484,160971320,148836
"9442","ENSG00000169252","ADRB2","5",148206156,148208196,2040
"9443","ENSG00000169255","B3GALNT1","3",160801671,160823172,21501
"9444","ENSG00000169258","GPRIN1","5",176022803,176037134,14331
"9445","ENSG00000169288","MRPL1","4",78783674,78873944,90270
"9446","ENSG00000169299","PGM2","4",37828255,37864558,36303
"9447","ENSG00000169302","STK32A","5",146614526,146767415,152889
"9448","ENSG00000169306","IL1RAPL1","X",28605516,29974840,1369324
"9449","ENSG00000169330","KIAA1024","15",79724858,79764632,39774
"9450","ENSG00000169359","SLC33A1","3",155538813,155572218,33405
"9451","ENSG00000169371","SNUPN","15",75890424,75918810,28386
"9452","ENSG00000169372","CRADD","12",94071151,94288616,217465
"9453","ENSG00000169375","SIN3A","15",75661720,75748183,86463
"9454","ENSG00000169379","ARL13B","3",93698983,93774512,75529
"9455","ENSG00000169398","PTK2","8",141667999,142012315,344316
"9456","ENSG00000169410","PTPN9","15",75759462,75871630,112168
"9457","ENSG00000169432","SCN9A","2",167051695,167232503,180808
"9458","ENSG00000169439","SDC2","8",97505579,97624000,118421
"9459","ENSG00000169446","MMGT1","X",135044229,135056222,11993
"9460","ENSG00000169490","TM2D2","8",38846327,38854343,8016
"9461","ENSG00000169499","PLEKHA2","8",38758753,38831428,72675
"9462","ENSG00000169504","CLIC4","1",25071848,25170815,98967
"9463","ENSG00000169507","SLC38A11","2",165752696,165812035,59339
"9464","ENSG00000169515","CCDC8","19",46913629,46916841,3212
"9465","ENSG00000169519","METTL15","11",28129795,28355054,225259
"9466","ENSG00000169554","ZEB2","2",145141648,145282147,140499
"9467","ENSG00000169564","PCBP1","2",70314585,70316332,1747
"9468","ENSG00000169567","HINT1","5",130494720,130507428,12708
"9469","ENSG00000169570","DTWD2","5",118173017,118324240,151223
"9470","ENSG00000169592","INO80E","16",30006615,30017114,10499
"9471","ENSG00000169598","DFFB","1",3773845,3801993,28148
"9472","ENSG00000169599","NFU1","2",69622882,69664760,41878
"9473","ENSG00000169604","ANTXR1","2",69240310,69476459,236149
"9474","ENSG00000169607","CKAP2L","2",113493930,113522254,28324
"9475","ENSG00000169609","C15orf40","15",83657193,83680393,23200
"9476","ENSG00000169612","FAM103A1","15",83654959,83659809,4850
"9477","ENSG00000169621","APLF","2",68694693,68858004,163311
"9478","ENSG00000169629","RGPD8","2",113127669,113192065,64396
"9479","ENSG00000169635","HIC2","22",21771693,21805752,34059
"9480","ENSG00000169641","LUZP1","1",23410516,23504301,93785
"9481","ENSG00000169660","HEXDC","17",80376194,80400521,24327
"9482","ENSG00000169679","BUB1","2",111395275,111435691,40416
"9483","ENSG00000169682","SPNS1","16",28985542,28995869,10327
"9484","ENSG00000169683","LRRC45","17",79981178,79989027,7849
"9485","ENSG00000169684","CHRNA5","15",78857862,78887611,29749
"9486","ENSG00000169689","STRA13","17",79976578,79981983,5405
"9487","ENSG00000169692","AGPAT2","9",139567595,139581875,14280
"9488","ENSG00000169696","ASPSCR1","17",79934683,79975282,40599
"9489","ENSG00000169710","FASN","17",80036214,80056208,19994
"9490","ENSG00000169714","CNBP","3",128888327,128902765,14438
"9491","ENSG00000169718","DUS1L","17",80015382,80023763,8381
"9492","ENSG00000169727","GPS1","17",80008567,80015346,6779
"9493","ENSG00000169733","RFNG","17",80005778,80009707,3929
"9494","ENSG00000169738","DCXR","17",79993012,79995608,2596
"9495","ENSG00000169740","ZNF32","10",44139307,44144304,4997
"9496","ENSG00000169744","LDB2","4",16503164,16900432,397268
"9497","ENSG00000169750","RAC3","17",79989500,79992080,2580
"9498","ENSG00000169756","LIMS1","2",109150857,109303702,152845
"9499","ENSG00000169760","NLGN1","3",173114074,174004434,890360
"9500","ENSG00000169762","TAPT1","4",16162128,16229033,66905
"9501","ENSG00000169764","UGP2","2",64068074,64118696,50622
"9502","ENSG00000169783","LINGO1","15",77905369,78113242,207873
"9503","ENSG00000169813","HNRNPF","10",43881065,43904614,23549
"9504","ENSG00000169814","BTD","3",15642848,15687329,44481
"9505","ENSG00000169826","CSGALNACT2","10",43633934,43680756,46822
"9506","ENSG00000169836","TACR3","4",104507188,104640973,133785
"9507","ENSG00000169840","GSX1","13",28366780,28368905,2125
"9508","ENSG00000169851","PCDH7","4",30722037,31148422,426385
"9509","ENSG00000169855","ROBO1","3",78646390,79816965,1170575
"9510","ENSG00000169856","ONECUT1","15",53049637,53083273,33636
"9511","ENSG00000169857","AVEN","15",34158428,34331377,172949
"9512","ENSG00000169860","P2RY1","3",152552736,152555841,3105
"9513","ENSG00000169862","CTNND2","5",10971952,11904155,932203
"9514","ENSG00000169871","TRIM56","7",100728720,100735017,6297
"9515","ENSG00000169891","REPS2","X",16964814,17171395,206581
"9516","ENSG00000169895","SYAP1","X",16737755,16783459,45704
"9517","ENSG00000169902","TPST1","7",65670186,65885530,215344
"9518","ENSG00000169905","TOR1AIP2","1",179809102,179846938,37836
"9519","ENSG00000169914","OTUD3","1",20209006,20239438,30432
"9520","ENSG00000169918","OTUD7A","15",31775329,32162992,387663
"9521","ENSG00000169919","GUSB","7",65425671,65447301,21630
"9522","ENSG00000169925","BRD3","9",136895427,136933657,38230
"9523","ENSG00000169926","KLF13","15",31619058,31727868,108810
"9524","ENSG00000169946","ZFPM2","8",106330920,106816760,485840
"9525","ENSG00000169951","ZNF764","16",30565085,30569819,4734
"9526","ENSG00000169955","ZNF747","16",30537244,30546668,9424
"9527","ENSG00000169957","ZNF768","16",30535325,30538142,2817
"9528","ENSG00000169964","TMEM42","3",44903361,44907162,3801
"9529","ENSG00000169967","MAP3K2","2",128056306,128146041,89735
"9530","ENSG00000169972","PUSL1","1",1243947,1247057,3110
"9531","ENSG00000169976","SF3B5","6",144416018,144416754,736
"9532","ENSG00000169981","ZNF35","3",44690219,44702283,12064
"9533","ENSG00000169989","TIGD4","4",153690506,153700916,10410
"9534","ENSG00000169991","IFFO2","1",19230775,19283180,52405
"9535","ENSG00000169992","NLGN2","17",7308193,7323179,14986
"9536","ENSG00000170004","CHD3","17",7788124,7816078,27954
"9537","ENSG00000170006","TMEM154","4",153539784,153601317,61533
"9538","ENSG00000170017","ALCAM","3",105085753,105295744,209991
"9539","ENSG00000170027","YWHAG","7",75956116,75988348,32232
"9540","ENSG00000170035","UBE2E3","2",181831975,181941312,109337
"9541","ENSG00000170037","CNTROB","17",7835419,7853236,17817
"9542","ENSG00000170043","TRAPPC1","17",7833663,7835441,1778
"9543","ENSG00000170049","KCNAB3","17",7825177,7833121,7944
"9544","ENSG00000170085","SIMC1","5",175665365,175772994,107629
"9545","ENSG00000170088","TMEM192","4",165995574,166129701,134127
"9546","ENSG00000170089","","5",177236408,177377733,141325
"9547","ENSG00000170091","","5",173472607,173670504,197897
"9548","ENSG00000170100","ZNF778","16",89284118,89295363,11245
"9549","ENSG00000170113","NIPA1","15",23043277,23100005,56728
"9550","ENSG00000170142","UBE2E1","3",23847394,23932807,85413
"9551","ENSG00000170144","HNRNPA3","2",178077291,178088686,11395
"9552","ENSG00000170145","SIK2","11",111473115,111601577,128462
"9553","ENSG00000170153","RNF150","4",141780961,142134031,353070
"9554","ENSG00000170160","CCDC144A","17",16592851,16707767,114916
"9555","ENSG00000170161","","9",66553273,66555928,2655
"9556","ENSG00000170175","CHRNB1","17",7348380,7361026,12646
"9557","ENSG00000170185","USP38","4",144106070,144144983,38913
"9558","ENSG00000170190","SLC16A5","17",73083822,73102257,18435
"9559","ENSG00000170191","NANP","20",25593571,25604811,11240
"9560","ENSG00000170214","ADRA1B","5",159343790,159399551,55761
"9561","ENSG00000170222","ADPRM","17",10600911,10614550,13639
"9562","ENSG00000170234","PWWP2A","5",159488808,159546430,57622
"9563","ENSG00000170242","USP47","11",11862970,11980870,117900
"9564","ENSG00000170248","PDCD6IP","3",33839844,33911194,71350
"9565","ENSG00000170260","ZNF212","7",148936742,148952700,15958
"9566","ENSG00000170264","FAM161A","2",62051989,62081278,29289
"9567","ENSG00000170265","ZNF282","7",148892577,148923339,30762
"9568","ENSG00000170266","GLB1","3",33038100,33138722,100622
"9569","ENSG00000170270","C14orf142","14",93669239,93673439,4200
"9570","ENSG00000170271","FAXDC2","5",154198051,154238812,40761
"9571","ENSG00000170275","CRTAP","3",33155471,33189265,33794
"9572","ENSG00000170291","ELP5","17",7154735,7163259,8524
"9573","ENSG00000170293","CMTM8","3",32280171,32411817,131646
"9574","ENSG00000170296","GABARAP","17",7143333,7146089,2756
"9575","ENSG00000170310","STX8","17",9153788,9479908,326120
"9576","ENSG00000170312","CDK1","10",62538089,62554610,16521
"9577","ENSG00000170315","UBB","17",16284112,16286059,1947
"9578","ENSG00000170322","NFRKB","11",129733531,129765485,31954
"9579","ENSG00000170325","PRDM10","11",129769601,129872730,103129
"9580","ENSG00000170340","B3GNT2","2",62423248,62451866,28618
"9581","ENSG00000170345","FOS","14",75745477,75748933,3456
"9582","ENSG00000170348","TMED10","14",75598173,75643334,45161
"9583","ENSG00000170364","SETMAR","3",4344988,4359251,14263
"9584","ENSG00000170365","SMAD1","4",146402346,146479231,76885
"9585","ENSG00000170381","SEMA3E","7",82993222,83278326,285104
"9586","ENSG00000170382","LRRN2","1",204586298,204654861,68563
"9587","ENSG00000170385","SLC30A1","1",211744910,211752084,7174
"9588","ENSG00000170390","DCLK2","4",150999426,151178609,179183
"9589","ENSG00000170396","ZNF804A","2",185463093,185804219,341126
"9590","ENSG00000170417","TMEM182","2",103353367,103460352,106985
"9591","ENSG00000170419","VSTM2A","7",54610018,54638773,28755
"9592","ENSG00000170425","ADORA2B","17",15848231,15879060,30829
"9593","ENSG00000170430","MGMT","10",131265448,131566271,300823
"9594","ENSG00000170445","HARS","5",140052758,140071609,18851
"9595","ENSG00000170448","NFXL1","4",47849257,47916653,67396
"9596","ENSG00000170456","DENND5B","12",31535157,31744031,208874
"9597","ENSG00000170464","DNAJC18","5",138744279,138780180,35901
"9598","ENSG00000170469","SPATA24","5",138732252,138739777,7525
"9599","ENSG00000170471","RALGAPB","20",37101459,37207504,106045
"9600","ENSG00000170473","WIBG","12",56295197,56326402,31205
"9601","ENSG00000170485","NPAS2","2",101436614,101613291,176677
"9602","ENSG00000170500","LONRF2","2",100889753,100939195,49442
"9603","ENSG00000170502","NUDT9","4",88343734,88380606,36872
"9604","ENSG00000170515","PA2G4","12",56498103,56507691,9588
"9605","ENSG00000170522","ELOVL6","4",110967002,111120355,153353
"9606","ENSG00000170525","PFKFB3","10",6186881,6277495,90614
"9607","ENSG00000170537","TMC7","16",18995256,19075264,80008
"9608","ENSG00000170540","ARL6IP1","16",18802991,18813000,10009
"9609","ENSG00000170542","SERPINB9","6",2887500,2903514,16014
"9610","ENSG00000170549","IRX1","5",3596168,3601517,5349
"9611","ENSG00000170558","CDH2","18",25530930,25757410,226480
"9612","ENSG00000170561","IRX2","5",2745959,2752969,7010
"9613","ENSG00000170571","EMB","5",49692026,49739082,47056
"9614","ENSG00000170579","DLGAP1","18",3496030,4455335,959305
"9615","ENSG00000170581","STAT2","12",56735381,56753939,18558
"9616","ENSG00000170584","NUDCD2","5",162873532,162887146,13614
"9617","ENSG00000170604","IRF2BP1","19",46386866,46389376,2510
"9618","ENSG00000170606","HSPA4","5",132387654,132442141,54487
"9619","ENSG00000170619","COMMD5","8",146066427,146079121,12694
"9620","ENSG00000170629","DPY19L2P2","7",102815580,102920857,105277
"9621","ENSG00000170631","ZNF16","8",146155744,146176274,20530
"9622","ENSG00000170632","ARMC10","7",102715328,102740205,24877
"9623","ENSG00000170633","RNF34","12",121837844,121868389,30545
"9624","ENSG00000170634","ACYP2","2",54197975,54532437,334462
"9625","ENSG00000170638","TRABD","22",50624344,50638027,13683
"9626","ENSG00000170647","TMEM133","11",100862811,100864663,1852
"9627","ENSG00000170653","ATF7","12",53901640,54020199,118559
"9628","ENSG00000170677","SOCS6","18",67956137,67997436,41299
"9629","ENSG00000170681","MURC","9",103340361,103350188,9827
"9630","ENSG00000170727","BOP1","8",145486055,145515082,29027
"9631","ENSG00000170734","POLH","6",43543887,43586701,42814
"9632","ENSG00000170745","KCNS3","2",18059114,18542882,483768
"9633","ENSG00000170759","KIF5B","10",32297938,32345359,47421
"9634","ENSG00000170775","GPR37","7",124386051,124405681,19630
"9635","ENSG00000170776","AKAP13","15",85923802,86292586,368784
"9636","ENSG00000170779","CDCA4","14",105475910,105487485,11575
"9637","ENSG00000170791","CHCHD7","8",57124245,57131357,7112
"9638","ENSG00000170802","FOXN2","2",48541776,48606433,64657
"9639","ENSG00000170832","USP32","17",58256455,58499831,243376
"9640","ENSG00000170835","CEL","9",135937365,135947248,9883
"9641","ENSG00000170836","PPM1D","17",58677544,58741849,64305
"9642","ENSG00000170837","GPR27","3",71803201,71805647,2446
"9643","ENSG00000170846","","4",6675178,6677774,2596
"9644","ENSG00000170852","KBTBD2","7",32907784,32933743,25959
"9645","ENSG00000170854","MINA","3",97660662,97691301,30639
"9646","ENSG00000170855","TRIAP1","12",120881764,120884215,2451
"9647","ENSG00000170860","LSM3","3",14219858,14242619,22761
"9648","ENSG00000170871","KIAA0232","4",6783102,6885897,102795
"9649","ENSG00000170873","MTSS1","8",125563031,125740730,177699
"9650","ENSG00000170876","TMEM43","3",14166440,14185179,18739
"9651","ENSG00000170881","RNF139","8",125486979,125500155,13176
"9652","ENSG00000170889","RPS9","19",54704610,54752862,48252
"9653","ENSG00000170891","CYTL1","4",5016313,5021199,4886
"9654","ENSG00000170892","TSEN34","19",54693789,54697585,3796
"9655","ENSG00000170893","TRH","3",129693148,129696781,3633
"9656","ENSG00000170899","GSTA4","6",52842751,52860176,17425
"9657","ENSG00000170903","MSANTD4","11",105866350,105893130,26780
"9658","ENSG00000170906","NDUFA3","19",54606036,54612564,6528
"9659","ENSG00000170915","PAQR8","6",52226219,52272575,46356
"9660","ENSG00000170917","NUDT6","4",123809852,123844123,34271
"9661","ENSG00000170919","TPT1-AS1","13",45915480,45965872,50392
"9662","ENSG00000170921","TANC2","17",61086917,61505060,418143
"9663","ENSG00000170927","PKHD1","6",51480098,51952423,472325
"9664","ENSG00000170946","DNAJC24","11",31391387,31453396,62009
"9665","ENSG00000170949","ZNF160","19",53569859,53606689,36830
"9666","ENSG00000170954","ZNF415","19",53611132,53636330,25198
"9667","ENSG00000170955","PRKCDBP","11",6340176,6341877,1701
"9668","ENSG00000170959","DCDC1","11",30851916,31391357,539441
"9669","ENSG00000170962","PDGFD","11",103777914,104035107,257193
"9670","ENSG00000170989","S1PR1","1",101702444,101707074,4630
"9671","ENSG00000171004","HS6ST2","X",131760044,132095423,335379
"9672","ENSG00000171016","PYGO1","15",55831088,55881145,50057
"9673","ENSG00000171033","PKIA","8",79428374,79517502,89128
"9674","ENSG00000171044","XKR6","8",10753555,11058875,305320
"9675","ENSG00000171045","TSNARE1","8",143293441,143484601,191160
"9676","ENSG00000171055","FEZ2","2",36778570,36873230,94660
"9677","ENSG00000171067","C11orf24","11",68028803,68039469,10666
"9678","ENSG00000171084","FAM86JP","3",125635463,125648867,13404
"9679","ENSG00000171094","ALK","2",29415640,30144432,728792
"9680","ENSG00000171097","CCBL1","9",131595221,131644773,49552
"9681","ENSG00000171100","MTM1","X",149737069,149841795,104726
"9682","ENSG00000171103","TRMT61B","2",29072687,29093167,20480
"9683","ENSG00000171105","INSR","19",7112266,7294045,181779
"9684","ENSG00000171109","MFN1","3",179065480,179112719,47239
"9685","ENSG00000171121","KCNMB3","3",178957530,178984790,27260
"9686","ENSG00000171130","ATP6V0E2","7",149570057,149577784,7727
"9687","ENSG00000171132","PRKCE","2",45878484,46415129,536645
"9688","ENSG00000171135","JAGN1","3",9932238,9936033,3795
"9689","ENSG00000171148","TADA3","3",9821544,9834695,13151
"9690","ENSG00000171150","SOCS5","2",46926091,46990268,64177
"9691","ENSG00000171155","C1GALT1C1","X",119759648,119764005,4357
"9692","ENSG00000171159","C9orf16","9",130922539,130926207,3668
"9693","ENSG00000171160","MORN4","10",99374310,99393344,19034
"9694","ENSG00000171161","ZNF672","1",249132409,249143716,11307
"9695","ENSG00000171163","ZNF692","1",249144205,249153343,9138
"9696","ENSG00000171169","NAIF1","9",130823512,130830485,6973
"9697","ENSG00000171174","RBKS","2",28004231,28113965,109734
"9698","ENSG00000171189","GRIK1","21",30909254,31312351,403097
"9699","ENSG00000171202","TMEM126A","11",85359011,85367591,8580
"9700","ENSG00000171204","TMEM126B","11",85339629,85347580,7951
"9701","ENSG00000171206","TRIM8","10",104404253,104418164,13911
"9702","ENSG00000171208","NETO2","16",47111614,47177908,66294
"9703","ENSG00000171219","CDC42BPG","11",64590859,64612041,21182
"9704","ENSG00000171222","SCAND1","20",34541539,34547394,5855
"9705","ENSG00000171223","JUNB","19",12902310,12904124,1814
"9706","ENSG00000171224","C10orf35","10",71390007,71393352,3345
"9707","ENSG00000171241","SHCBP1","16",46614466,46655538,41072
"9708","ENSG00000171243","SOSTDC1","7",16501106,16570205,69099
"9709","ENSG00000171246","NPTX1","17",78440948,78451643,10695
"9710","ENSG00000171262","FAM98B","15",38746328,38779911,33583
"9711","ENSG00000171282","","17",79373540,79433357,59817
"9712","ENSG00000171291","ZNF439","19",11959541,11994565,35024
"9713","ENSG00000171295","ZNF440","19",11925099,11946016,20917
"9714","ENSG00000171298","GAA","17",78075355,78093678,18323
"9715","ENSG00000171302","CANT1","17",76987799,77005949,18150
"9716","ENSG00000171307","ZDHHC16","10",99205927,99217127,11200
"9717","ENSG00000171310","CHST11","12",104849073,105155792,306719
"9718","ENSG00000171311","EXOSC1","10",99195899,99205774,9875
"9719","ENSG00000171314","PGAM1","10",99185917,99193198,7281
"9720","ENSG00000171316","CHD7","8",61591337,61779465,188128
"9721","ENSG00000171320","ESCO2","8",27629466,27670157,40691
"9722","ENSG00000171357","LURAP1","1",46669006,46686933,17927
"9723","ENSG00000171365","CLCN5","X",49687225,49863892,176667
"9724","ENSG00000171368","TPPP","5",660883,693510,32627
"9725","ENSG00000171385","KCND3","1",112313284,112531777,218493
"9726","ENSG00000171388","APLN","X",128779240,128788933,9693
"9727","ENSG00000171421","MRPL36","5",1798500,1801480,2980
"9728","ENSG00000171425","ZNF581","19",56146825,56156988,10163
"9729","ENSG00000171428","NAT1","8",18027986,18081198,53212
"9730","ENSG00000171435","KSR2","12",117890817,118406788,515971
"9731","ENSG00000171443","ZNF524","19",56111388,56114504,3116
"9732","ENSG00000171444","MCC","5",112357796,112824527,466731
"9733","ENSG00000171448","ZBTB26","9",125677845,125693779,15934
"9734","ENSG00000171451","DSEL","18",65173819,65184217,10398
"9735","ENSG00000171453","POLR1C","6",43477440,43497323,19883
"9736","ENSG00000171456","ASXL1","20",30946155,31027122,80967
"9737","ENSG00000171462","DLK2","6",43418090,43424370,6280
"9738","ENSG00000171466","ZNF562","19",9759330,9785776,26446
"9739","ENSG00000171467","ZNF318","6",43274872,43337216,62344
"9740","ENSG00000171469","ZNF561","19",9715356,9732075,16719
"9741","ENSG00000171475","WIPF2","17",38375556,38440388,64832
"9742","ENSG00000171488","LRRC8C","1",90098631,90235462,136831
"9743","ENSG00000171490","RSL1D1","16",11929056,11945442,16386
"9744","ENSG00000171492","LRRC8D","1",90286573,90402170,115597
"9745","ENSG00000171497","PPID","4",159630286,159644548,14262
"9746","ENSG00000171502","COL24A1","1",86194916,86622626,427710
"9747","ENSG00000171503","ETFDH","4",159593277,159630775,37498
"9748","ENSG00000171530","TBCA","5",76986991,77164604,177613
"9749","ENSG00000171533","MAP6","11",75297963,75380165,82202
"9750","ENSG00000171552","BCL2L1","20",30252255,30311792,59537
"9751","ENSG00000171566","PLRG1","4",155456158,155471587,15429
"9752","ENSG00000171574","ZNF584","19",58912871,58929694,16823
"9753","ENSG00000171587","DSCAM","21",41382926,42219065,836139
"9754","ENSG00000171603","CLSTN1","1",9789084,9884584,95500
"9755","ENSG00000171604","CXXC5","5",139026884,139063467,36583
"9756","ENSG00000171606","ZNF274","19",58694396,58724928,30532
"9757","ENSG00000171608","PIK3CD","1",9711790,9789172,77382
"9758","ENSG00000171612","SLC25A33","1",9599541,9645237,45696
"9759","ENSG00000171617","ENC1","5",73923234,73937249,14015
"9760","ENSG00000171621","SPSB1","1",9352939,9429591,76652
"9761","ENSG00000171634","BPTF","17",65821640,65980494,158854
"9762","ENSG00000171649","ZIK1","19",58089824,58105145,15321
"9763","ENSG00000171680","PLEKHG5","1",6526152,6580121,53969
"9764","ENSG00000171681","ATF7IP","12",14518610,14651697,133087
"9765","ENSG00000171700","RGS19","20",62704534,62711323,6789
"9766","ENSG00000171703","TCEA2","20",62681189,62703700,22511
"9767","ENSG00000171714","ANO5","11",22214722,22304903,90181
"9768","ENSG00000171720","HDAC3","5",141000443,141016437,15994
"9769","ENSG00000171723","GPHN","14",66974125,67648520,674395
"9770","ENSG00000171724","VAT1L","16",77822427,78014004,191577
"9771","ENSG00000171729","TMEM51","1",15479028,15546976,67948
"9772","ENSG00000171735","CAMTA1","1",6845384,7829766,984382
"9773","ENSG00000171757","LRRC34","3",169511216,169530774,19558
"9774","ENSG00000171763","SPATA5L1","15",45694529,45713617,19088
"9775","ENSG00000171766","GATM","15",45653322,45694525,41203
"9776","ENSG00000171786","NHLH1","1",160336857,160342638,5781
"9777","ENSG00000171790","SLFNL1","1",41481269,41488909,7640
"9778","ENSG00000171791","BCL2","18",60790579,60987361,196782
"9779","ENSG00000171792","RHNO1","12",2985424,2998626,13202
"9780","ENSG00000171793","CTPS1","1",41445007,41478235,33228
"9781","ENSG00000171798","KNDC1","10",134973951,135039916,65965
"9782","ENSG00000171806","METTL18","1",169761670,169764107,2437
"9783","ENSG00000171811","TTC40","10",134621896,134756327,134431
"9784","ENSG00000171813","PWWP2B","10",134210672,134231367,20695
"9785","ENSG00000171817","ZNF540","19",38042308,38104998,62690
"9786","ENSG00000171823","FBXL14","12",1675159,1703331,28172
"9787","ENSG00000171824","EXOSC10","1",11126675,11159938,33263
"9788","ENSG00000171827","ZNF570","19",37958487,37976260,17773
"9789","ENSG00000171843","MLLT3","9",20341663,20622542,280879
"9790","ENSG00000171848","RRM2","2",10262455,10271545,9090
"9791","ENSG00000171853","TRAPPC12","2",3383446,3488865,105419
"9792","ENSG00000171858","RPS21","20",60962172,60963576,1404
"9793","ENSG00000171861","RNMTL1","17",685513,695749,10236
"9794","ENSG00000171862","PTEN","10",89622870,89731687,108817
"9795","ENSG00000171863","RPS7","2",3622795,3628509,5714
"9796","ENSG00000171865","RNASEH1","2",3592383,3606206,13823
"9797","ENSG00000171867","PRNP","20",4666882,4682236,15354
"9798","ENSG00000171877","FRMD5","15",44162962,44487450,324488
"9799","ENSG00000171885","AQP4","18",24432002,24445782,13780
"9800","ENSG00000171914","TLN2","15",62682725,63136830,454105
"9801","ENSG00000171928","TVP23B","17",18684308,18710027,25719
"9802","ENSG00000171940","ZNF217","20",52183604,52226446,42842
"9803","ENSG00000171943","SRGAP2C","1",121107124,121129949,22825
"9804","ENSG00000171951","SCG2","2",224461658,224467221,5563
"9805","ENSG00000171953","ATPAF2","17",17880723,17942523,61800
"9806","ENSG00000171956","FOXB1","15",60296421,60353929,57508
"9807","ENSG00000171960","PPIH","1",43124096,43142429,18333
"9808","ENSG00000171962","LRRC48","17",17876127,17920203,44076
"9809","ENSG00000171970","ZNF57","19",2900896,2918474,17578
"9810","ENSG00000171984","C20orf196","20",5731039,5844558,113519
"9811","ENSG00000171988","JMJD1C","10",64926981,65225722,298741
"9812","ENSG00000171992","SYNPO","5",149980642,150038782,58140
"9813","ENSG00000172005","MAL","2",95691422,95719737,28315
"9814","ENSG00000172006","ZNF554","19",2819872,2835771,15899
"9815","ENSG00000172007","RAB33B","4",140374386,140397763,23377
"9816","ENSG00000172009","THOP1","19",2785458,2813599,28141
"9817","ENSG00000172014","ANKRD20A4","9",69381812,69425560,43748
"9818","ENSG00000172020","GAP43","3",115342171,115440337,98166
"9819","ENSG00000172031","EPHX4","1",92495539,92529093,33554
"9820","ENSG00000172037","LAMB2","3",49158547,49170551,12004
"9821","ENSG00000172046","USP19","3",49145479,49158371,12892
"9822","ENSG00000172053","QARS","3",49133365,49142553,9188
"9823","ENSG00000172057","ORMDL3","17",38077294,38083854,6560
"9824","ENSG00000172059","KLF11","2",10182976,10194963,11987
"9825","ENSG00000172062","SMN1","5",70220768,70249769,29001
"9826","ENSG00000172071","EIF2AK3","2",88856259,88927094,70835
"9827","ENSG00000172081","MOB3A","19",2071037,2096672,25635
"9828","ENSG00000172086","KRCC1","2",88326724,88355248,28524
"9829","ENSG00000172113","NME6","3",48334754,48343175,8421
"9830","ENSG00000172115","CYCS","7",25159710,25164980,5270
"9831","ENSG00000172123","SLFN12","17",33738079,33760302,22223
"9832","ENSG00000172137","CALB2","16",71392616,71424341,31725
"9833","ENSG00000172159","FRMD3","9",85857905,86153461,295556
"9834","ENSG00000172164","SNTB1","8",121547985,121825513,277528
"9835","ENSG00000172167","MTBP","8",121457640,121554373,96733
"9836","ENSG00000172171","TEFM","17",29224354,29233838,9484
"9837","ENSG00000172172","MRPL13","8",121393000,121457642,64642
"9838","ENSG00000172175","MALT1","18",56338618,56417371,78753
"9839","ENSG00000172183","ISG20","15",89179384,89199714,20330
"9840","ENSG00000172197","MBOAT1","6",20100935,20212670,111735
"9841","ENSG00000172201","ID4","6",19837617,19840915,3298
"9842","ENSG00000172209","GPR22","7",107110463,107116098,5635
"9843","ENSG00000172216","CEBPB","20",48807376,48809212,1836
"9844","ENSG00000172238","ATOH1","4",94750042,94751221,1179
"9845","ENSG00000172239","PAIP1","5",43526369,43557860,31491
"9846","ENSG00000172244","C5orf34","5",43486803,43515247,28444
"9847","ENSG00000172260","NEGR1","1",71861623,72748417,886794
"9848","ENSG00000172262","ZNF131","5",43065278,43192123,126845
"9849","ENSG00000172264","MACROD2","20",13976015,16033842,2057827
"9850","ENSG00000172269","DPAGT1","11",118967213,118979041,11828
"9851","ENSG00000172270","BSG","19",571297,583493,12196
"9852","ENSG00000172273","HINFP","11",118992297,119006752,14455
"9853","ENSG00000172292","CERS6","2",169312372,169631644,319272
"9854","ENSG00000172296","SPTLC3","20",12989627,13147411,157784
"9855","ENSG00000172301","COPRS","17",30178883,30186356,7473
"9856","ENSG00000172315","TP53RK","20",45313004,45318418,5414
"9857","ENSG00000172318","B3GALT1","2",168675182,168730551,55369
"9858","ENSG00000172331","BPGM","7",134331560,134364565,33005
"9859","ENSG00000172336","POP7","7",100303676,100305118,1442
"9860","ENSG00000172339","ALG14","1",95439963,95538501,98538
"9861","ENSG00000172340","SUCLG2","3",67410884,67705038,294154
"9862","ENSG00000172345","STARD5","15",81601394,81616524,15130
"9863","ENSG00000172346","CSDC2","22",41956767,41973745,16978
"9864","ENSG00000172348","RCAN2","6",46188475,46459709,271234
"9865","ENSG00000172354","GNB2","7",100271154,100276797,5643
"9866","ENSG00000172361","CCDC11","18",47753563,47792892,39329
"9867","ENSG00000172366","FAM195A","16",691813,698474,6661
"9868","ENSG00000172375","C2CD2L","11",118972908,118989252,16344
"9869","ENSG00000172379","ARNT2","15",80696692,80890278,193586
"9870","ENSG00000172380","GNG12","1",68167149,68299150,132001
"9871","ENSG00000172382","PRSS27","16",2762419,2770552,8133
"9872","ENSG00000172403","SYNPO2","4",119809996,119982402,172406
"9873","ENSG00000172409","CLP1","11",57416465,57429340,12875
"9874","ENSG00000172425","TTC36","11",118398187,118401912,3725
"9875","ENSG00000172426","RSPH9","6",43612783,43640336,27553
"9876","ENSG00000172428","MYEOV2","2",241065980,241076224,10244
"9877","ENSG00000172432","GTPBP2","6",43573053,43596899,23846
"9878","ENSG00000172456","FGGY","1",59762310,60233347,471037
"9879","ENSG00000172458","IL17D","13",21276266,21297237,20971
"9880","ENSG00000172461","FUT9","6",96463860,96663488,199628
"9881","ENSG00000172465","TCEAL1","X",102883632,102885881,2249
"9882","ENSG00000172466","ZNF24","18",32912176,32925446,13270
"9883","ENSG00000172469","MANEA","6",96025419,96057333,31914
"9884","ENSG00000172493","AFF1","4",87856154,88062206,206052
"9885","ENSG00000172497","ACOT12","5",80625824,80689998,64174
"9886","ENSG00000172500","FIBP","11",65651212,65656010,4798
"9887","ENSG00000172530","BANP","16",87982850,88110924,128074
"9888","ENSG00000172531","PPP1CA","11",67165654,67188654,23000
"9889","ENSG00000172534","HCFC1","X",153213004,153237258,24254
"9890","ENSG00000172554","SNTG2","2",946554,1371385,424831
"9891","ENSG00000172572","PDE3A","12",20522179,20837315,315136
"9892","ENSG00000172575","RASGRP1","15",38780304,38857776,77472
"9893","ENSG00000172586","CHCHD1","10",75541805,75543410,1605
"9894","ENSG00000172590","MRPL52","14",23299088,23304246,5158
"9895","ENSG00000172594","SMPDL3A","6",123110315,123130865,20550
"9896","ENSG00000172602","RND1","12",49250928,49259681,8753
"9897","ENSG00000172613","RAD9A","11",67159176,67165881,6705
"9898","ENSG00000172638","EFEMP2","11",65633912,65641063,7151
"9899","ENSG00000172660","TAF15","17",34136459,34191619,55160
"9900","ENSG00000172661","FAM21C","10",46222648,46288409,65761
"9901","ENSG00000172663","TMEM134","11",67231824,67236743,4919
"9902","ENSG00000172667","ZMAT3","3",178735011,178790067,55056
"9903","ENSG00000172671","ZFAND4","10",46111043,46168228,57185
"9904","ENSG00000172687","ZNF738","19",21541732,21562104,20372
"9905","ENSG00000172725","CORO1B","11",67205519,67211292,5773
"9906","ENSG00000172728","FUT10","8",33228342,33330940,102598
"9907","ENSG00000172731","LRRC20","10",72058729,72142382,83653
"9908","ENSG00000172732","MUS81","11",65624597,65635124,10527
"9909","ENSG00000172733","PURG","8",30853321,30891231,37910
"9910","ENSG00000172738","TMEM217","6",37179956,37225931,45975
"9911","ENSG00000172748","ZNF596","8",182137,197342,15205
"9912","ENSG00000172757","CFL1","11",65590493,65629497,39004
"9913","ENSG00000172765","TMCC1","3",129366635,129612419,245784
"9914","ENSG00000172766","NAA16","13",41885341,41951166,65825
"9915","ENSG00000172771","EFCAB12","3",129120164,129147494,27330
"9916","ENSG00000172775","FAM192A","16",57186378,57220028,33650
"9917","ENSG00000172785","CBWD1","9",121041,188979,67938
"9918","ENSG00000172795","DCP2","5",112312399,112356667,44268
"9919","ENSG00000172803","SNX32","11",65601112,65624367,23255
"9920","ENSG00000172809","RPL38","17",72199721,72206794,7073
"9921","ENSG00000172817","CYP7B1","8",65500320,65711318,210998
"9922","ENSG00000172819","RARG","12",53604354,53626764,22410
"9923","ENSG00000172824","CES4A","16",67022492,67043661,21169
"9924","ENSG00000172831","CES2","16",66968347,66978999,10652
"9925","ENSG00000172840","PDP2","16",66912492,66929657,17165
"9926","ENSG00000172845","SP3","2",174771187,174830430,59243
"9927","ENSG00000172869","DMXL1","5",118373467,118584833,211366
"9928","ENSG00000172878","METAP1D","2",172864490,172947158,82668
"9929","ENSG00000172888","ZNF621","3",40566369,40616176,49807
"9930","ENSG00000172889","EGFL7","9",139553308,139567130,13822
"9931","ENSG00000172890","NADSYN1","11",71164155,71235153,70998
"9932","ENSG00000172893","DHCR7","11",71139239,71163914,24675
"9933","ENSG00000172915","NBEA","13",35516424,36247159,730735
"9934","ENSG00000172922","RNASEH2C","11",65482367,65488418,6051
"9935","ENSG00000172932","ANKRD13D","11",67056018,67069956,13938
"9936","ENSG00000172936","MYD88","3",38179969,38184513,4544
"9937","ENSG00000172939","OXSR1","3",38206580,38296979,90399
"9938","ENSG00000172943","PHF8","X",53963109,54075391,112282
"9939","ENSG00000172954","LCLAT1","2",30670092,30867091,196999
"9940","ENSG00000172965","MIR4435-1HG","2",111953927,112252677,298750
"9941","ENSG00000172974","","2",65432137,65433396,1259
"9942","ENSG00000172977","KAT5","11",65479467,65487075,7608
"9943","ENSG00000172985","SH3RF3","2",109745804,110262207,516403
"9944","ENSG00000172986","GXYLT2","3",72937224,73047289,110065
"9945","ENSG00000172992","DCAKD","17",43100708,43138473,37765
"9946","ENSG00000172995","ARPP21","3",35680437,35835988,155551
"9947","ENSG00000173011","TADA2B","4",7043626,7059679,16053
"9948","ENSG00000173020","ADRBK1","11",67033881,67054027,20146
"9949","ENSG00000173039","RELA","11",65421067,65430565,9498
"9950","ENSG00000173040","EVC2","4",5544499,5711275,166776
"9951","ENSG00000173041","ZNF680","7",63980262,64023484,43222
"9952","ENSG00000173064","HECTD4","12",112597992,112819896,221904
"9953","ENSG00000173065","FAM222B","17",27082996,27182250,99254
"9954","ENSG00000173068","BNC2","9",16409501,16870841,461340
"9955","ENSG00000173085","COQ2","4",84182689,84206067,23378
"9956","ENSG00000173113","TRMT112","11",64083932,64085556,1624
"9957","ENSG00000173114","LRRN3","7",110731062,110765510,34448
"9958","ENSG00000173120","KDM2A","11",66886740,67025558,138818
"9959","ENSG00000173137","ADCK5","8",145596790,145618457,21667
"9960","ENSG00000173141","MRP63","13",21750784,21753223,2439
"9961","ENSG00000173145","NOC3L","10",96075004,96122716,47712
"9962","ENSG00000173153","ESRRA","11",64073044,64084215,11171
"9963","ENSG00000173157","ADAMTS20","12",43747669,43945724,198055
"9964","ENSG00000173163","COMMD1","2",62115859,62374382,258523
"9965","ENSG00000173166","RAPH1","2",204259068,204400133,141065
"9966","ENSG00000173171","MTX1","1",155178490,155183615,5125
"9967","ENSG00000173175","ADCY5","3",123001143,123168605,167462
"9968","ENSG00000173193","PARP14","3",122399465,122449687,50222
"9969","ENSG00000173207","CKS1B","1",154947129,154951725,4596
"9970","ENSG00000173208","ABCD2","12",39943835,40013553,69718
"9971","ENSG00000173209","AHSA2","2",61404553,61418338,13785
"9972","ENSG00000173214","KIAA1919","6",111580551,111592370,11819
"9973","ENSG00000173218","VANGL1","1",116184574,116240845,56271
"9974","ENSG00000173221","GLRX","5",95087023,95158709,71686
"9975","ENSG00000173226","IQCB1","3",121488610,121553926,65316
"9976","ENSG00000173230","GOLGB1","3",121382046,121468602,86556
"9977","ENSG00000173239","LIPM","10",90562487,90580303,17816
"9978","ENSG00000173258","ZNF483","9",114287439,114340124,52685
"9979","ENSG00000173261","PLAC8L1","5",145463949,145483932,19983
"9980","ENSG00000173264","GPR137","11",64037534,64056972,19438
"9981","ENSG00000173267","SNCG","10",88718375,88723017,4642
"9982","ENSG00000173272","MZT2A","2",132222473,132250316,27843
"9983","ENSG00000173273","TNKS","8",9413424,9639856,226432
"9984","ENSG00000173275","ZNF449","X",134478721,134497077,18356
"9985","ENSG00000173276","ZBTB21","21",43406940,43430496,23556
"9986","ENSG00000173281","PPP1R3B","8",8993765,9009084,15319
"9987","ENSG00000173295","FAM86B3P","8",8086117,8102387,16270
"9988","ENSG00000173320","STOX2","4",184774584,184944679,170095
"9989","ENSG00000173327","MAP3K11","11",65365226,65382853,17627
"9990","ENSG00000173334","TRIB1","8",126442563,126450647,8084
"9991","ENSG00000173349","SFT2D3","2",128458597,128461385,2788
"9992","ENSG00000173376","NDNF","4",121956768,121994176,37408
"9993","ENSG00000173402","DAG1","3",49506146,49573048,66902
"9994","ENSG00000173404","INSM1","20",20348765,20351590,2825
"9995","ENSG00000173406","DAB1","1",57460451,59012406,1551955
"9996","ENSG00000173409","ARV1","1",231114727,231136341,21614
"9997","ENSG00000173418","NAA20","20",19997760,20014299,16539
"9998","ENSG00000173436","MINOS1","1",19923477,19956314,32837
"9999","ENSG00000173442","EHBP1L1","11",65343509,65360121,16612
"10000","ENSG00000173451","THAP2","12",72056789,72074419,17630
"10001","ENSG00000173452","TMEM196","7",19758933,19813221,54288
"10002","ENSG00000173456","RNF26","11",119205237,119208023,2786
"10003","ENSG00000173457","PPP1R14B","11",64011956,64014413,2457
"10004","ENSG00000173465","SSSCA1","11",65337901,65341413,3512
"10005","ENSG00000173473","SMARCC1","3",47626762,47823596,196834
"10006","ENSG00000173480","ZNF417","19",58411664,58427978,16314
"10007","ENSG00000173482","PTPRM","18",7566780,8406859,840079
"10008","ENSG00000173486","FKBP2","11",64008475,64011604,3129
"10009","ENSG00000173511","VEGFB","11",64002010,64006259,4249
"10010","ENSG00000173517","PEAK1","15",77400471,77712486,312015
"10011","ENSG00000173530","TNFRSF10D","8",22993101,23021543,28442
"10012","ENSG00000173531","MST1","3",49721380,49726934,5554
"10013","ENSG00000173535","TNFRSF10C","8",22941868,22974950,33082
"10014","ENSG00000173542","MOB1B","4",71768043,71888166,120123
"10015","ENSG00000173545","ZNF622","5",16451628,16465901,14273
"10016","ENSG00000173546","CSPG4","15",75966663,76005189,38526
"10017","ENSG00000173548","SNX33","15",75940247,75954642,14395
"10018","ENSG00000173559","NABP1","2",192542794,192561385,18591
"10019","ENSG00000173575","CHD2","15",93426526,93571237,144711
"10020","ENSG00000173581","CCDC106","19",56152428,56164527,12099
"10021","ENSG00000173588","CCDC41","12",94700225,94853764,153539
"10022","ENSG00000173598","NUDT4","12",93771659,93797024,25365
"10023","ENSG00000173599","PC","11",66615704,66725847,110143
"10024","ENSG00000173611","SCAI","9",127704887,127905785,200898
"10025","ENSG00000173614","NMNAT1","1",10003486,10045559,42073
"10026","ENSG00000173621","LRFN4","11",66624118,66627946,3828
"10027","ENSG00000173638","SLC19A1","21",46913486,46964325,50839
"10028","ENSG00000173653","RCE1","11",66610306,66614017,3711
"10029","ENSG00000173660","UQCRH","1",46769303,46782448,13145
"10030","ENSG00000173673","HES3","1",6304252,6305638,1386
"10031","ENSG00000173674","EIF1AX","X",20142636,20159962,17326
"10032","ENSG00000173681","CXorf23","X",19930978,19988416,57438
"10033","ENSG00000173692","PSMD1","2",231921578,232037541,115963
"10034","ENSG00000173705","SUSD5","3",33191537,33260707,69170
"10035","ENSG00000173706","HEG1","3",124684554,124774802,90248
"10036","ENSG00000173715","C11orf80","11",66511922,66610987,99065
"10037","ENSG00000173726","TOMM20","1",235272651,235292251,19600
"10038","ENSG00000173744","AGFG1","2",228336868,228425930,89062
"10039","ENSG00000173757","STAT5B","17",40351186,40428725,77539
"10040","ENSG00000173786","CNP","17",40118759,40129749,10990
"10041","ENSG00000173801","JUP","17",39775692,39943183,167491
"10042","ENSG00000173805","HAP1","17",39873994,39890896,16902
"10043","ENSG00000173812","EIF1","17",39845137,39848920,3783
"10044","ENSG00000173818","ENDOV","17",78388965,78411886,22921
"10045","ENSG00000173821","RNF213","17",78234665,78372586,137921
"10046","ENSG00000173825","TIGD3","11",65122238,65125084,2846
"10047","ENSG00000173846","PLK3","1",45265897,45271662,5765
"10048","ENSG00000173848","NET1","10",5454514,5500426,45912
"10049","ENSG00000173852","DPY19L1","7",34968488,35077883,109395
"10050","ENSG00000173875","ZNF791","19",12721732,12742735,21003
"10051","ENSG00000173889","PHC3","3",169804520,169899537,95017
"10052","ENSG00000173894","CBX2","17",77751931,77761782,9851
"10053","ENSG00000173898","SPTBN2","11",66452719,66496697,43978
"10054","ENSG00000173905","GOLIM4","3",167726465,167813763,87298
"10055","ENSG00000173914","RBM4B","11",66432469,66445392,12923
"10056","ENSG00000173915","USMG5","10",105148798,105156223,7425
"10057","ENSG00000173917","HOXB2","17",46618256,46623441,5185
"10058","ENSG00000173926","MARCH3","5",126203406,126366500,163094
"10059","ENSG00000173928","SWSAP1","19",11485361,11487627,2266
"10060","ENSG00000173930","SLCO4C1","5",101569690,101632253,62563
"10061","ENSG00000173933","RBM4","11",66384097,66434153,50056
"10062","ENSG00000173947","PIFO","1",111888910,111895635,6725
"10063","ENSG00000173950","XXYLT1","3",194789008,194991896,202888
"10064","ENSG00000173960","UBXN2A","2",24150155,24227779,77624
"10065","ENSG00000173991","TCAP","17",37820440,37822808,2368
"10066","ENSG00000173992","CCS","11",66360292,66373490,13198
"10067","ENSG00000174007","CEP19","3",196433148,196439164,6016
"10068","ENSG00000174010","KLHL15","X",24001837,24045303,43466
"10069","ENSG00000174013","FBXO45","3",196295482,196315930,20448
"10070","ENSG00000174021","GNG5","1",84964008,84972248,8240
"10071","ENSG00000174028","FAM3C2","X",23093875,23094884,1009
"10072","ENSG00000174032","SLC25A30","13",45967451,45992590,25139
"10073","ENSG00000174080","CTSF","11",66330934,66336312,5378
"10074","ENSG00000174093","","17",36337717,36421858,84141
"10075","ENSG00000174099","MSRB3","12",65672423,65882024,209601
"10076","ENSG00000174100","MRPL45","17",36452989,36479101,26112
"10077","ENSG00000174106","LEMD3","12",65563351,65642107,78756
"10078","ENSG00000174109","C16orf91","16",1469745,1479345,9600
"10079","ENSG00000174111","SOCS7","17",36508111,36556019,47908
"10080","ENSG00000174130","TLR6","4",38825336,38858438,33102
"10081","ENSG00000174132","FAM174A","5",99871009,99922445,51436
"10082","ENSG00000174136","RGMB","5",98104354,98134347,29993
"10083","ENSG00000174137","FAM53A","4",1619642,1686029,66387
"10084","ENSG00000174145","KIAA1239","4",37245842,37451087,205245
"10085","ENSG00000174151","CYB561D1","1",110036674,110045554,8880
"10086","ENSG00000174165","ZDHHC24","11",66288108,66313709,25601
"10087","ENSG00000174173","TRMT10C","3",101280706,101285290,4584
"10088","ENSG00000174177","CTU2","16",88772871,88781794,8923
"10089","ENSG00000174194","AGAP8","10",51224681,51371321,146640
"10090","ENSG00000174197","MGA","15",41913422,42062141,148719
"10091","ENSG00000174206","C12orf66","12",64580096,64616076,35980
"10092","ENSG00000174227","PIGG","4",492989,533985,40996
"10093","ENSG00000174231","PRPF8","17",1553923,1588176,34253
"10094","ENSG00000174233","ADCY6","12",49159975,49182820,22845
"10095","ENSG00000174236","REP15","12",27849428,27850566,1138
"10096","ENSG00000174238","PITPNA","17",1421012,1466110,45098
"10097","ENSG00000174243","DDX23","12",49223547,49246625,23078
"10098","ENSG00000174276","ZNHIT2","11",64883875,64885170,1295
"10099","ENSG00000174282","ZBTB4","17",7362685,7387582,24897
"10100","ENSG00000174306","ZHX3","20",39807088,39946312,139224
"10101","ENSG00000174307","PHLDA3","1",201434620,201438365,3745
"10102","ENSG00000174327","SLC16A13","17",6939394,6943440,4046
"10103","ENSG00000174343","CHRNA9","4",40337346,40357234,19888
"10104","ENSG00000174353","STAG3L3","7",72440227,72476445,36218
"10105","ENSG00000174365","SNHG11","20",37075221,37079564,4343
"10106","ENSG00000174370","C11orf45","11",128769460,128775930,6470
"10107","ENSG00000174371","EXO1","1",242011269,242058450,47181
"10108","ENSG00000174373","RALGAPA1","14",36007558,36278510,270952
"10109","ENSG00000174374","WBSCR16","7",74441226,74490064,48838
"10110","ENSG00000174405","LIG4","13",108859787,108870716,10929
"10111","ENSG00000174428","GTF2IRD2B","7",74508364,74565623,57259
"10112","ENSG00000174437","ATP2A2","12",110718561,110788898,70337
"10113","ENSG00000174442","ZWILCH","15",66797297,66842115,44818
"10114","ENSG00000174444","RPL4","15",66790355,66816870,26515
"10115","ENSG00000174446","SNAPC5","15",66782473,66790151,7678
"10116","ENSG00000174448","STARD6","18",51850728,51884334,33606
"10117","ENSG00000174453","VWC2L","2",215275789,215443683,167894
"10118","ENSG00000174456","C12orf76","12",110465872,110511491,45619
"10119","ENSG00000174460","ZCCHC12","X",117957753,117960931,3178
"10120","ENSG00000174469","CNTNAP2","7",145813453,148118090,2304637
"10121","ENSG00000174473","GALNTL6","4",172733405,173962710,1229305
"10122","ENSG00000174482","LINGO2","9",27948076,28670283,722207
"10123","ENSG00000174483","BBS1","11",66278077,66301098,23021
"10124","ENSG00000174485","DENND4A","15",65950384,66084631,134247
"10125","ENSG00000174498","IGDCC3","15",65619465,65670378,50913
"10126","ENSG00000174501","ANKRD36C","2",96514587,96657541,142954
"10127","ENSG00000174516","PELI3","11",66234216,66244808,10592
"10128","ENSG00000174529","TMEM81","1",205052258,205053645,1387
"10129","ENSG00000174547","MRPL11","11",66202546,66234209,31663
"10130","ENSG00000174564","IL20RB","3",136665072,136729927,64855
"10131","ENSG00000174574","AKIRIN1","1",39456895,39471731,14836
"10132","ENSG00000174576","NPAS4","11",66188475,66194178,5703
"10133","ENSG00000174579","MSL2","3",135867764,135916083,48319
"10134","ENSG00000174586","ZNF497","19",58865723,58874214,8491
"10135","ENSG00000174599","TRAM1L1","4",118004718,118006736,2018
"10136","ENSG00000174600","CMKLR1","12",108681821,108733118,51297
"10137","ENSG00000174606","ANGEL2","1",213165524,213189168,23644
"10138","ENSG00000174607","UGT8","4",115519611,115599380,79769
"10139","ENSG00000174628","IQCK","16",19727778,19868907,141129
"10140","ENSG00000174652","ZNF266","19",9523272,9546254,22982
"10141","ENSG00000174669","SLC29A2","11",66129992,66139685,9693
"10142","ENSG00000174672","BRSK2","11",1411129,1483919,72790
"10143","ENSG00000174684","B3GNT1","11",66112843,66115163,2320
"10144","ENSG00000174695","TMEM167A","5",82348665,82373682,25017
"10145","ENSG00000174705","SH3PXD2B","5",171752185,171881527,129342
"10146","ENSG00000174718","KIAA1551","12",32112304,32146039,33735
"10147","ENSG00000174720","LARP7","4",113558120,113578748,20628
"10148","ENSG00000174721","FGFBP3","10",93666346,93669240,2894
"10149","ENSG00000174738","NR1D2","3",23986751,24022109,35358
"10150","ENSG00000174740","PABPC5","X",90689594,90693583,3989
"10151","ENSG00000174744","BRMS1","11",66104804,66112596,7792
"10152","ENSG00000174748","RPL15","3",23958036,23965183,7147
"10153","ENSG00000174749","C4orf32","4",113066553,113116412,49859
"10154","ENSG00000174775","HRAS","11",532242,537287,5045
"10155","ENSG00000174776","WDR49","3",167196472,167371771,175299
"10156","ENSG00000174780","SRP72","4",57333081,57369839,36758
"10157","ENSG00000174791","RIN1","11",66097713,66104311,6598
"10158","ENSG00000174796","THAP6","4",76439156,76475683,36527
"10159","ENSG00000174799","CEP135","4",56815037,56899529,84492
"10160","ENSG00000174804","FZD4","11",86656721,86666433,9712
"10161","ENSG00000174839","DENND6A","3",57611184,57678816,67632
"10162","ENSG00000174840","PDE12","3",57542003,57552571,10568
"10163","ENSG00000174842","GLMN","1",92711959,92764544,52585
"10164","ENSG00000174851","YIF1A","11",66052051,66056641,4590
"10165","ENSG00000174871","CNIH2","11",66045661,66052772,7111
"10166","ENSG00000174886","NDUFA11","19",5891287,5904017,12730
"10167","ENSG00000174891","RSRC1","3",157823644,158263519,439875
"10168","ENSG00000174903","RAB1B","11",66036004,66044963,8959
"10169","ENSG00000174915","PTDSS2","11",448268,491393,43125
"10170","ENSG00000174917","C19orf70","19",5678432,5680907,2475
"10171","ENSG00000174928","C3orf33","3",155480401,155524140,43739
"10172","ENSG00000174938","SEZ6L2","16",29882480,29910868,28388
"10173","ENSG00000174943","KCTD13","16",29916333,29938356,22023
"10174","ENSG00000174953","DHX36","3",153990335,154042286,51951
"10175","ENSG00000174963","ZIC4","3",147103833,147124647,20814
"10176","ENSG00000174977","","17",18553508,18554855,1347
"10177","ENSG00000174989","FBXW8","12",117348761,117468953,120192
"10178","ENSG00000174996","KLC2","11",66024765,66035331,10566
"10179","ENSG00000175003","SLC22A1","6",160542821,160579750,36929
"10180","ENSG00000175029","CTBP2","10",126676421,126849739,173318
"10181","ENSG00000175040","CHST2","3",142838173,142841800,3627
"10182","ENSG00000175048","ZDHHC14","6",157802165,158099178,297013
"10183","ENSG00000175054","ATR","3",142168077,142297668,129591
"10184","ENSG00000175061","FAM211A-AS1","17",16342136,16381992,39856
"10185","ENSG00000175063","UBE2C","20",44441215,44445596,4381
"10186","ENSG00000175066","GK5","3",141882414,141944449,62035
"10187","ENSG00000175073","VCPIP1","8",67540722,67579452,38730
"10188","ENSG00000175087","PDIK1L","1",26437664,26452034,14370
"10189","ENSG00000175093","SPSB4","3",140770244,140867453,97209
"10190","ENSG00000175104","TRAF6","11",36508577,36531822,23245
"10191","ENSG00000175105","ZNF654","3",88188254,88193815,5561
"10192","ENSG00000175106","TVP23C","17",15341205,15466909,125704
"10193","ENSG00000175110","MRPS22","3",138724648,139076065,351417
"10194","ENSG00000175115","PACS1","11",65837834,66012218,174384
"10195","ENSG00000175130","MARCKSL1","1",32799433,32801980,2547
"10196","ENSG00000175137","SH3BP5L","1",249104648,249120832,16184
"10197","ENSG00000175147","TMEM51-AS1","1",15442448,15478960,36512
"10198","ENSG00000175155","YPEL2","17",57409050,57479090,70040
"10199","ENSG00000175161","CADM2","3",85008132,86123579,1115447
"10200","ENSG00000175166","PSMD2","3",184016497,184026842,10345
"10201","ENSG00000175170","FAM182B","20",25744102,25848861,104759
"10202","ENSG00000175175","PPM1E","17",56833230,57058983,225753
"10203","ENSG00000175182","FAM131A","3",184053714,184064063,10349
"10204","ENSG00000175183","CSRP2","12",77252495,77272840,20345
"10205","ENSG00000175193","PARL","3",183547173,183602721,55548
"10206","ENSG00000175197","DDIT3","12",57910371,57914300,3929
"10207","ENSG00000175198","PCCA","13",100741269,101182686,441417
"10208","ENSG00000175203","DCTN2","12",57923885,57941114,17229
"10209","ENSG00000175213","ZNF408","11",46722368,46727462,5094
"10210","ENSG00000175215","CTDSP2","12",58213710,58240522,26812
"10211","ENSG00000175216","CKAP5","11",46764598,46867847,103249
"10212","ENSG00000175220","ARHGAP1","11",46698630,46722165,23535
"10213","ENSG00000175221","MED16","19",867962,893218,25256
"10214","ENSG00000175224","ATG13","11",46638826,46696368,57542
"10215","ENSG00000175229","GAL3ST3","11",65809423,65816651,7228
"10216","ENSG00000175264","CHST1","11",45670427,45687172,16745
"10217","ENSG00000175265","GOLGA8A","15",34671269,34880704,209435
"10218","ENSG00000175274","TP53I11","11",44907454,44972840,65386
"10219","ENSG00000175279","APITD1","1",10490159,10512210,22051
"10220","ENSG00000175283","DOLK","9",131707809,131709898,2089
"10221","ENSG00000175305","CCNE2","8",95891998,95908906,16908
"10222","ENSG00000175309","PHYKPL","5",177635498,177659792,24294
"10223","ENSG00000175322","ZNF519","18",14057456,14132489,75033
"10224","ENSG00000175324","LSM1","8",38020839,38034248,13409
"10225","ENSG00000175334","BANF1","11",65769550,65771620,2070
"10226","ENSG00000175344","CHRNA7","15",32322691,32464722,142031
"10227","ENSG00000175348","TMEM9B","11",8968841,8986558,17717
"10228","ENSG00000175352","NRIP3","11",9002123,9025596,23473
"10229","ENSG00000175354","PTPN2","18",12785477,12929642,144165
"10230","ENSG00000175356","SCUBE2","11",9041071,9159661,118590
"10231","ENSG00000175376","EIF1AD","11",65764016,65769647,5631
"10232","ENSG00000175387","SMAD2","18",45357922,45457515,99593
"10233","ENSG00000175390","EIF3F","11",7991798,8023409,31611
"10234","ENSG00000175395","ZNF25","10",38238500,38265561,27061
"10235","ENSG00000175414","ARL10","5",175792471,175828866,36395
"10236","ENSG00000175416","CLTB","5",175819456,175843570,24114
"10237","ENSG00000175426","PCSK1","5",95726119,95769847,43728
"10238","ENSG00000175445","LPL","8",19759228,19824769,65541
"10239","ENSG00000175449","RFESD","5",94982458,95020477,38019
"10240","ENSG00000175455","CCDC14","3",123616152,123680564,64412
"10241","ENSG00000175467","SART1","11",65729160,65747299,18139
"10242","ENSG00000175470","PPP2R2D","10",133747955,133773331,25376
"10243","ENSG00000175471","MCTP1","5",94039446,94620279,580833
"10244","ENSG00000175497","DPP10","2",115199876,116603328,1403452
"10245","ENSG00000175513","TSGA10IP","11",65712916,65727434,14518
"10246","ENSG00000175536","LIPT2","11",74202757,74204778,2021
"10247","ENSG00000175548","ALG10B","12",38710380,38717784,7404
"10248","ENSG00000175550","DRAP1","11",65686728,65689032,2304
"10249","ENSG00000175556","LONRF3","X",118108581,118152318,43737
"10250","ENSG00000175564","UCP3","11",73711326,73720480,9154
"10251","ENSG00000175567","UCP2","11",73685712,73694352,8640
"10252","ENSG00000175573","C11orf68","11",65684279,65686588,2309
"10253","ENSG00000175575","PAAF1","11",73587744,73638790,51046
"10254","ENSG00000175581","MRPL48","11",73498361,73576178,77817
"10255","ENSG00000175582","RAB6A","11",73386683,73472182,85499
"10256","ENSG00000175592","FOSL1","11",65659520,65668044,8524
"10257","ENSG00000175595","ERCC4","16",14014014,14046202,32188
"10258","ENSG00000175600","SUGCT","7",40174575,40900362,725787
"10259","ENSG00000175602","CCDC85B","11",65657875,65659105,1230
"10260","ENSG00000175606","TMEM70","8",74884672,74895018,10346
"10261","ENSG00000175611","LINC00476","9",98521513,98638259,116746
"10262","ENSG00000175634","RPS6KB2","11",67195931,67202872,6941
"10263","ENSG00000175643","RMI2","16",11343476,11445619,102143
"10264","ENSG00000175662","TOM1L2","17",17746828,17875736,128908
"10265","ENSG00000175691","ZNF77","19",2933216,2944969,11753
"10266","ENSG00000175697","GPR156","3",119883492,120003941,120449
"10267","ENSG00000175701","LINC00116","2",110969106,111002997,33891
"10268","ENSG00000175711","B3GNTL1","17",80900031,81009686,109655
"10269","ENSG00000175727","MLXIP","12",122516628,122631894,115266
"10270","ENSG00000175741","RWDD4P2","7",39894093,39894655,562
"10271","ENSG00000175745","NR2F1","5",92919043,92930321,11278
"10272","ENSG00000175749","EIF3KP1","5",102368080,102368735,655
"10273","ENSG00000175756","AURKAIP1","1",1309110,1310875,1765
"10274","ENSG00000175764","TTLL11","9",124584207,124855885,271678
"10275","ENSG00000175768","TOMM5","9",37582643,37592639,9996
"10276","ENSG00000175782","SLC35E3","12",69139886,69187508,47622
"10277","ENSG00000175785","PRIMA1","14",94184644,94254827,70183
"10278","ENSG00000175787","ZNF169","9",97021593,97063736,42143
"10279","ENSG00000175792","RUVBL1","3",127783621,127872757,89136
"10280","ENSG00000175806","MSRA","8",9911778,10286401,374623
"10281","ENSG00000175826","CTDNEP1","17",7146910,7155810,8900
"10282","ENSG00000175832","ETV4","17",41605212,41656988,51776
"10283","ENSG00000175854","SWI5","9",131037658,131051269,13611
"10284","ENSG00000175866","BAIAP2","17",79008948,79091232,82284
"10285","ENSG00000175873","","7",2477398,2487485,10087
"10286","ENSG00000175886","RPL7AP66","18",36914836,36915639,803
"10287","ENSG00000175893","ZDHHC21","9",14611069,14693469,82400
"10288","ENSG00000175895","PLEKHF2","8",96146032,96168912,22880
"10289","ENSG00000175898","","19",10332111,10333870,1759
"10290","ENSG00000175899","A2M","12",9220260,9268825,48565
"10291","ENSG00000175906","ARL4D","17",41476327,41478505,2178
"10292","ENSG00000175911","","17",78977135,78978932,1797
"10293","ENSG00000175928","LRRN1","3",3841121,3889387,48266
"10294","ENSG00000175931","UBE2O","17",74385532,74449288,63756
"10295","ENSG00000175938","ORAI3","16",30960387,30967782,7395
"10296","ENSG00000175970","UNC119B","12",121148238,121161443,13205
"10297","ENSG00000175984","DENND2C","1",115125469,115213043,87574
"10298","ENSG00000176014","TUBB6","18",12307668,12344319,36651
"10299","ENSG00000176018","LYSMD3","5",89811428,89825401,13973
"10300","ENSG00000176022","B3GALT6","1",1167629,1170421,2792
"10301","ENSG00000176024","ZNF613","19",52430400,52452012,21612
"10302","ENSG00000176040","TMPRSS7","3",111753690,111800116,46426
"10303","ENSG00000176049","JAKMIP2","5",146967990,147162338,194348
"10304","ENSG00000176054","RPL23P2","21",30369934,30370354,420
"10305","ENSG00000176055","MBLAC2","5",89754020,89770585,16565
"10306","ENSG00000176058","TPRN","9",140086069,140098645,12576
"10307","ENSG00000176087","SLC35A4","5",139944041,139948688,4647
"10308","ENSG00000176092","AIM1L","1",26648350,26680621,32271
"10309","ENSG00000176095","IP6K1","3",49761727,49823975,62248
"10310","ENSG00000176101","SSNA1","9",140083099,140084822,1723
"10311","ENSG00000176102","CSTF3","11",33098734,33183917,85183
"10312","ENSG00000176105","YES1","18",721588,812547,90959
"10313","ENSG00000176108","CHMP6","17",78965398,78983317,17919
"10314","ENSG00000176124","DLEU1","13",50656307,51297372,641065
"10315","ENSG00000176125","UFSP1","7",100486346,100487339,993
"10316","ENSG00000176142","TMEM39A","3",119148347,119187677,39330
"10317","ENSG00000176148","TCP11L1","11",33060963,33127489,66526
"10318","ENSG00000176155","CCDC57","17",80059336,80170706,111370
"10319","ENSG00000176170","SPHK1","17",74372665,74383941,11276
"10320","ENSG00000176171","BNIP3","10",133781578,133795435,13857
"10321","ENSG00000176182","MYPOP","19",46393278,46405862,12584
"10322","ENSG00000176204","LRRTM4","2",76974845,77820445,845600
"10323","ENSG00000176208","ATAD5","17",29158988,29222887,63899
"10324","ENSG00000176209","SMIM19","8",42396298,42409603,13305
"10325","ENSG00000176222","ZNF404","19",44376515,44405537,29022
"10326","ENSG00000176225","RTTN","18",67671029,67873181,202152
"10327","ENSG00000176244","ACBD7","10",15119522,15130775,11253
"10328","ENSG00000176248","ANAPC2","9",140069236,140082989,13753
"10329","ENSG00000176261","ZBTB8OS","1",33065773,33116504,50731
"10330","ENSG00000176273","SLC35G1","10",95653730,95715819,62089
"10331","ENSG00000176274","SLC25A53","X",103343898,103401708,57810
"10332","ENSG00000176293","ZNF135","19",58570607,58597677,27070
"10333","ENSG00000176340","COX8A","11",63742079,63744015,1936
"10334","ENSG00000176371","ZSCAN2","15",85144217,85171027,26810
"10335","ENSG00000176386","CDC26","9",116018115,116037869,19754
"10336","ENSG00000176390","CRLF3","17",29096406,29151794,55388
"10337","ENSG00000176393","RNPEP","1",201951500,201975275,23775
"10338","ENSG00000176396","EID2","19",40028890,40030870,1980
"10339","ENSG00000176399","DMRTA1","9",22446840,22455739,8899
"10340","ENSG00000176401","EID2B","19",40021630,40023494,1864
"10341","ENSG00000176406","RIMS2","8",104512976,105268322,755346
"10342","ENSG00000176407","KCMF1","2",85198216,85286595,88379
"10343","ENSG00000176410","DNAJC30","7",73095299,73097783,2484
"10344","ENSG00000176422","SPRYD4","12",56862301,56864763,2462
"10345","ENSG00000176428","VPS37D","7",73082155,73086442,4287
"10346","ENSG00000176438","SYNE3","14",95883831,95942173,58342
"10347","ENSG00000176444","CLK2","1",155232659,155248282,15623
"10348","ENSG00000176454","LPCAT4","15",34651106,34659479,8373
"10349","ENSG00000176463","SLCO3A1","15",92396925,92715665,318740
"10350","ENSG00000176473","WDR25","14",100842755,100996640,153885
"10351","ENSG00000176476","CCDC101","16",28565236,28603111,37875
"10352","ENSG00000176485","PLA2G16","11",63340667,63384355,43688
"10353","ENSG00000176490","DIRAS1","19",2714565,2721416,6851
"10354","ENSG00000176531","PHLDB3","19",43979106,44009087,29981
"10355","ENSG00000176533","GNG7","19",2511217,2702707,191490
"10356","ENSG00000176542","KIAA2018","3",113367232,113415493,48261
"10357","ENSG00000176593","","19",58513429,58522600,9171
"10358","ENSG00000176595","KBTBD11","8",1922044,1955102,33058
"10359","ENSG00000176597","B3GNT5","3",182971032,183016292,45260
"10360","ENSG00000176619","LMNB2","19",2427636,2456994,29358
"10361","ENSG00000176623","RMDN1","8",87480486,87526586,46100
"10362","ENSG00000176624","MEX3C","18",48700920,48744674,43754
"10363","ENSG00000176641","RNF152","18",59475296,59561480,86184
"10364","ENSG00000176658","MYO1D","17",30819540,31204195,384655
"10365","ENSG00000176681","LRRC37A","17",44370099,44415160,45061
"10366","ENSG00000176697","BDNF","11",27676440,27743605,67165
"10367","ENSG00000176700","SCAND2P","15",85174682,85185695,11013
"10368","ENSG00000176714","CCDC121","2",27848506,27851879,3373
"10369","ENSG00000176715","ACSF3","16",89154783,89222254,67471
"10370","ENSG00000176720","BOK","2",242498136,242513546,15410
"10371","ENSG00000176728","TTTY14","Y",21034387,21239302,204915
"10372","ENSG00000176731","C8orf59","8",86126311,86132650,6339
"10373","ENSG00000176732","PFN4","2",24338241,24346347,8106
"10374","ENSG00000176749","CDK5R1","17",30813637,30818274,4637
"10375","ENSG00000176771","NCKAP5","2",133429374,134326034,896660
"10376","ENSG00000176783","RUFY1","5",178977559,179037027,59468
"10377","ENSG00000176788","BASP1","5",17065707,17276943,211236
"10378","ENSG00000176809","LRRC37A3","17",62850430,62915598,65168
"10379","ENSG00000176824","","2",145218679,145221645,2966
"10380","ENSG00000176834","VSIG10","12",118501398,118573831,72433
"10381","ENSG00000176842","IRX5","16",54964774,54968397,3623
"10382","ENSG00000176845","METRNL","17",81037567,81052864,15297
"10383","ENSG00000176853","FAM91A1","8",124780696,124827692,46996
"10384","ENSG00000176871","WSB2","12",118470712,118500235,29523
"10385","ENSG00000176887","SOX11","2",5832799,5841516,8717
"10386","ENSG00000176890","TYMS","18",657604,673578,15974
"10387","ENSG00000176894","PXMP2","12",133264192,133297276,33084
"10388","ENSG00000176896","TCEANC","X",13671225,13700083,28858
"10389","ENSG00000176903","PNMA1","14",74178494,74181128,2634
"10390","ENSG00000176907","C8orf4","8",40010989,40012821,1832
"10391","ENSG00000176909","MAMSTR","19",49215999,49222978,6979
"10392","ENSG00000176912","C18orf56","18",641320,658340,17020
"10393","ENSG00000176915","ANKLE2","12",133302254,133338474,36220
"10394","ENSG00000176927","EFCAB5","17",28256218,28435470,179252
"10395","ENSG00000176928","GCNT4","5",74323289,74326724,3435
"10396","ENSG00000176946","THAP4","2",242523820,242576864,53044
"10397","ENSG00000176953","NFATC2IP","16",28962128,28978418,16290
"10398","ENSG00000176971","FIBIN","11",27015628,27018630,3002
"10399","ENSG00000176973","FAM89B","11",65339820,65341669,1849
"10400","ENSG00000176974","SHMT1","17",18231187,18266856,35669
"10401","ENSG00000176978","DPP7","9",140004994,140009629,4635
"10402","ENSG00000176986","SEC24C","10",75504120,75531919,27799
"10403","ENSG00000176994","SMCR8","17",18218624,18226517,7893
"10404","ENSG00000177000","MTHFR","1",11845780,11866977,21197
"10405","ENSG00000177025","C19orf18","19",58469805,58485902,16097
"10406","ENSG00000177030","DEAF1","11",644233,706715,62482
"10407","ENSG00000177034","MTX3","5",79275584,79287082,11498
"10408","ENSG00000177042","TMEM80","11",695428,705028,9600
"10409","ENSG00000177045","SIX5","19",46268043,46272484,4441
"10410","ENSG00000177051","FBXO46","19",46213887,46234162,20275
"10411","ENSG00000177054","ZDHHC13","11",19138646,19197969,59323
"10412","ENSG00000177058","SLC38A9","5",54921673,55069022,147349
"10413","ENSG00000177076","ACER2","9",19408925,19452018,43093
"10414","ENSG00000177082","WDR73","15",85185999,85197574,11575
"10415","ENSG00000177084","POLE","12",133200348,133263951,63603
"10416","ENSG00000177105","RHOG","11",3848208,3862213,14005
"10417","ENSG00000177108","ZDHHC22","14",77597613,77609077,11464
"10418","ENSG00000177119","ANO6","12",45609770,45834187,224417
"10419","ENSG00000177125","ZBTB34","9",129622944,129648157,25213
"10420","ENSG00000177150","FAM210A","18",13663346,13726662,63316
"10421","ENSG00000177156","TALDO1","11",747329,765024,17695
"10422","ENSG00000177169","ULK1","12",132379196,132407712,28516
"10423","ENSG00000177173","NAP1L4P1","1",117075558,117076714,1156
"10424","ENSG00000177181","RIMKLA","1",42846466,42888249,41783
"10425","ENSG00000177182","CLVS1","8",61969717,62414204,444487
"10426","ENSG00000177189","RPS6KA3","X",20168029,20285523,117494
"10427","ENSG00000177192","PUS1","12",132413745,132428406,14661
"10428","ENSG00000177200","CHD9","16",53088945,53363062,274117
"10429","ENSG00000177225","PDDC1","11",767220,777488,10268
"10430","ENSG00000177236","","11",780117,780755,638
"10431","ENSG00000177239","MAN1B1","9",139981379,140003635,22256
"10432","ENSG00000177272","KCNA3","1",111214310,111217655,3345
"10433","ENSG00000177283","FZD8","10",35927177,35930362,3185
"10434","ENSG00000177302","TOP3A","17",18174742,18218321,43579
"10435","ENSG00000177303","CASKIN2","17",73496342,73511664,15322
"10436","ENSG00000177311","ZBTB38","3",141043055,141168634,125579
"10437","ENSG00000177335","C8orf31","8",144120626,144141359,20733
"10438","ENSG00000177337","DLGAP1-AS1","18",3593730,3598350,4620
"10439","ENSG00000177352","CCDC71","3",49199968,49203754,3786
"10440","ENSG00000177359","","12",31264586,31359088,94502
"10441","ENSG00000177370","TIMM22","17",900357,906911,6554
"10442","ENSG00000177380","PPFIA3","19",49622646,49654283,31637
"10443","ENSG00000177383","MAGEF1","3",184428156,184429836,1680
"10444","ENSG00000177409","SAMD9L","7",92759368,92777682,18314
"10445","ENSG00000177410","ZFAS1","20",47894715,47905797,11082
"10446","ENSG00000177425","PAWR","12",79968759,80084877,116118
"10447","ENSG00000177426","TGIF1","18",3411606,3458409,46803
"10448","ENSG00000177427","MIEF2","17",18163848,18169866,6018
"10449","ENSG00000177432","NAP1L5","4",89617066,89619386,2320
"10450","ENSG00000177463","NR2C2","3",14989091,15095107,106016
"10451","ENSG00000177468","OLIG3","6",137813336,137815531,2195
"10452","ENSG00000177469","PTRF","17",40554470,40575535,21065
"10453","ENSG00000177479","ARIH2","3",48956254,49023815,67561
"10454","ENSG00000177483","RBM44","2",238707032,238751451,44419
"10455","ENSG00000177485","ZBTB33","X",119384607,119392253,7646
"10456","ENSG00000177508","IRX3","16",54317216,54320675,3459
"10457","ENSG00000177511","ST8SIA3","18",55018044,55038962,20918
"10458","ENSG00000177519","RPRM","2",154333852,154335322,1470
"10459","ENSG00000177542","SLC25A22","11",790475,798316,7841
"10460","ENSG00000177548","RABEP2","16",28915742,28947847,32105
"10461","ENSG00000177551","NHLH2","1",116378998,116386538,7540
"10462","ENSG00000177556","ATOX1","5",151121877,151152093,30216
"10463","ENSG00000177565","TBL1XR1","3",176737143,176915261,178118
"10464","ENSG00000177570","SAMD12","8",119201698,119634234,432536
"10465","ENSG00000177595","PIDD","11",799179,809753,10574
"10466","ENSG00000177599","ZNF491","19",11908482,11920437,11955
"10467","ENSG00000177600","RPLP2","11",809647,812880,3233
"10468","ENSG00000177602","GSG2","17",3627211,3630067,2856
"10469","ENSG00000177606","JUN","1",59246465,59249785,3320
"10470","ENSG00000177613","CSTF2T","10",53455247,53459355,4108
"10471","ENSG00000177614","PGBD5","1",230457392,230561475,104083
"10472","ENSG00000177628","GBA","1",155204243,155214490,10247
"10473","ENSG00000177640","CASC2","10",119805790,119969663,163873
"10474","ENSG00000177646","ACAD9","3",128598439,128634910,36471
"10475","ENSG00000177663","IL17RA","22",17565844,17596583,30739
"10476","ENSG00000177666","PNPLA2","11",818902,825573,6671
"10477","ENSG00000177674","AGTRAP","1",11796141,11814859,18718
"10478","ENSG00000177679","SRRM3","7",75831216,75916605,85389
"10479","ENSG00000177683","THAP5","7",108194987,108210194,15207
"10480","ENSG00000177688","SUMO4","6",149721495,149722177,682
"10481","ENSG00000177692","DNAJC28","21",34860497,34864027,3530
"10482","ENSG00000177694","NAALADL2","3",174156363,175523428,1367065
"10483","ENSG00000177697","CD151","11",832843,839831,6988
"10484","ENSG00000177700","POLR2L","11",837356,842545,5189
"10485","ENSG00000177706","FAM20C","7",192969,300711,107742
"10486","ENSG00000177707","PVRL3","3",110788918,110994410,205492
"10487","ENSG00000177721","ANXA2R","5",43039335,43043272,3937
"10488","ENSG00000177728","KIAA0195","17",73437240,73496171,58931
"10489","ENSG00000177731","FLII","17",18148150,18162230,14080
"10490","ENSG00000177732","SOX12","20",306207,310865,4658
"10491","ENSG00000177733","HNRNPA0","5",137087075,137090039,2964
"10492","ENSG00000177738","","5",43014516,43067521,53005
"10493","ENSG00000177764","ZCCHC3","20",277737,280965,3228
"10494","ENSG00000177822","","4",182795591,183066402,270811
"10495","ENSG00000177830","CHID1","11",867357,915058,47701
"10496","ENSG00000177839","PCDHB9","5",140566893,140571111,4218
"10497","ENSG00000177842","ZNF620","3",40547483,40560227,12744
"10498","ENSG00000177853","ZNF518A","10",97889472,97965044,75572
"10499","ENSG00000177854","TMEM187","X",153237778,153248646,10868
"10500","ENSG00000177868","CCDC23","1",43272723,43282954,10231
"10501","ENSG00000177873","ZNF619","3",40518604,40531727,13123
"10502","ENSG00000177875","C12orf68","12",48577366,48579709,2343
"10503","ENSG00000177879","AP3S1","5",115177178,115249778,72600
"10504","ENSG00000177885","GRB2","17",73314157,73401790,87633
"10505","ENSG00000177888","ZBTB41","1",197122810,197169672,46862
"10506","ENSG00000177889","UBE2N","12",93799449,93836038,36589
"10507","ENSG00000177917","ARL6IP6","2",153574407,153617767,43360
"10508","ENSG00000177932","ZNF354C","5",178487416,178510538,23122
"10509","ENSG00000177943","MAMDC4","9",139745395,139755249,9854
"10510","ENSG00000177946","CENPBD1","16",90036206,90038942,2736
"10511","ENSG00000177951","BET1L","11",167784,207428,39644
"10512","ENSG00000177954","RPS27","1",153963235,153964626,1391
"10513","ENSG00000177963","RIC8A","11",207511,215113,7602
"10514","ENSG00000177971","IMP3","15",75931426,75941047,9621
"10515","ENSG00000177981","ASB8","12",48541571,48574996,33425
"10516","ENSG00000177990","DPY19L2","12",63952693,64062719,110026
"10517","ENSG00000178026","FAM211B","22",24981588,24989175,7587
"10518","ENSG00000178028","DMAP1","1",44679127,44686353,7226
"10519","ENSG00000178031","ADAMTSL1","9",18473892,18910948,437056
"10520","ENSG00000178033","FAM26E","6",116832809,116845955,13146
"10521","ENSG00000178035","IMPDH2","3",49061758,49066841,5083
"10522","ENSG00000178053","MLF1","3",158288952,158325041,36089
"10523","ENSG00000178057","NDUFAF3","3",49057892,49060928,3036
"10524","ENSG00000178074","C2orf69","2",200775979,200820658,44679
"10525","ENSG00000178075","GRAMD1C","3",113547029,113666021,118992
"10526","ENSG00000178078","STAP2","19",4324040,4342783,18743
"10527","ENSG00000178081","ULK4P3","15",30395923,30423960,28037
"10528","ENSG00000178093","TSSK6","19",19623227,19626838,3611
"10529","ENSG00000178096","BOLA1","1",149859440,149872351,12911
"10530","ENSG00000178104","PDE4DIP","1",144836157,145076186,240029
"10531","ENSG00000178105","DDX10","11",108535752,108811657,275905
"10532","ENSG00000178127","NDUFV2","18",9102628,9134343,31715
"10533","ENSG00000178149","DALRD3","3",49052921,49059726,6805
"10534","ENSG00000178150","ZNF114","19",48675575,48790865,115290
"10535","ENSG00000178163","ZNF518B","4",10441498,10459034,17536
"10536","ENSG00000178177","LCORL","4",17842822,18023499,180677
"10537","ENSG00000178184","PARD6G","18",77915115,78005429,90314
"10538","ENSG00000178187","ZNF454","5",178368192,178393434,25242
"10539","ENSG00000178188","SH2B1","16",28857921,28885526,27605
"10540","ENSG00000178201","VN1R1","19",57966542,57967854,1312
"10541","ENSG00000178202","KDELC2","11",108342832,108369159,26327
"10542","ENSG00000178209","PLEC","8",144989321,145050902,61581
"10543","ENSG00000178226","PRSS36","16",31150246,31161415,11169
"10544","ENSG00000178229","ZNF543","19",57831877,57842144,10267
"10545","ENSG00000178233","TMEM151B","6",44238203,44275243,37040
"10546","ENSG00000178234","GALNT11","7",151722759,151819425,96666
"10547","ENSG00000178235","SLITRK1","13",84451344,84456528,5184
"10548","ENSG00000178252","WDR6","3",49044495,49053386,8891
"10549","ENSG00000178295","GEN1","2",17935125,17966632,31507
"10550","ENSG00000178301","AQP11","11",77300436,77321400,20964
"10551","ENSG00000178307","TMEM11","17",21100593,21117937,17344
"10552","ENSG00000178338","ZNF354B","5",178286954,178315123,28169
"10553","ENSG00000178343","SHISA3","4",42399856,42404504,4648
"10554","ENSG00000178381","ZFAND2A","7",1191707,1200395,8688
"10555","ENSG00000178385","PLEKHM3","2",208693027,208890284,197257
"10556","ENSG00000178386","ZNF223","19",44555520,44572144,16624
"10557","ENSG00000178397","FAM220A","7",6369040,6388612,19572
"10558","ENSG00000178403","NEUROG2","4",113434672,113437328,2656
"10559","ENSG00000178404","","17",76866992,76899299,32307
"10560","ENSG00000178409","BEND3","6",107386386,107436473,50087
"10561","ENSG00000178425","NT5DC1","6",116422012,116570660,148648
"10562","ENSG00000178440","LINC00843","10",51732523,51741813,9290
"10563","ENSG00000178445","GLDC","9",6532464,6645650,113186
"10564","ENSG00000178449","COX14","12",50505762,50514240,8478
"10565","ENSG00000178464","","19",12754089,12754733,644
"10566","ENSG00000178467","P4HTM","3",49027319,49044587,17268
"10567","ENSG00000178498","DTX3","12",57998405,58003587,5182
"10568","ENSG00000178502","KLHL11","17",40009797,40021684,11887
"10569","ENSG00000178531","CTXN1","19",7989372,7991051,1679
"10570","ENSG00000178537","SLC25A20","3",48894369,48936426,42057
"10571","ENSG00000178538","CA8","8",61099906,61193971,94065
"10572","ENSG00000178567","EPM2AIP1","3",37027357,37034795,7438
"10573","ENSG00000178568","ERBB4","2",212240446,213403565,1163119
"10574","ENSG00000178573","MAF","16",79619740,79634611,14871
"10575","ENSG00000178585","CTNNBIP1","1",9908334,9970394,62060
"10576","ENSG00000178605","GTPBP6","X",220025,230886,10861
"10577","ENSG00000178607","ERN1","17",62116502,62208179,91677
"10578","ENSG00000178631","ACTG1P1","3",139212651,139213779,1128
"10579","ENSG00000178662","CSRNP3","2",166326157,166545917,219760
"10580","ENSG00000178665","ZNF713","7",55955169,56009918,54749
"10581","ENSG00000178685","PARP10","8",145051321,145086940,35619
"10582","ENSG00000178691","SUZ12","17",30264037,30328064,64027
"10583","ENSG00000178694","NSUN3","3",93781760,93847389,65629
"10584","ENSG00000178695","KCTD12","13",77454312,77460540,6228
"10585","ENSG00000178700","DHFRL1","3",93766680,93782233,15553
"10586","ENSG00000178718","RPP25","15",75246757,75249805,3048
"10587","ENSG00000178719","GRINA","8",145064226,145067583,3357
"10588","ENSG00000178741","COX5A","15",75212132,75230509,18377
"10589","ENSG00000178761","FAM219B","15",75192328,75199462,7134
"10590","ENSG00000178764","ZHX2","8",123793633,123986750,193117
"10591","ENSG00000178802","MPI","15",75182346,75191798,9452
"10592","ENSG00000178814","OPLAH","8",145106167,145118735,12568
"10593","ENSG00000178852","EFCAB13","17",45400656,45518678,118022
"10594","ENSG00000178878","APOLD1","12",12878851,12982909,104058
"10595","ENSG00000178882","FAM101A","12",124457788,124800570,342782
"10596","ENSG00000178896","EXOSC4","8",145133529,145135550,2021
"10597","ENSG00000178904","DPY19L3","19",32896449,32976801,80352
"10598","ENSG00000178913","TAF7","5",140698057,140700330,2273
"10599","ENSG00000178917","ZNF852","3",44540462,44552128,11666
"10600","ENSG00000178921","PFAS","17",8150936,8173809,22873
"10601","ENSG00000178922","HYI","1",43916824,43919660,2836
"10602","ENSG00000178927","C17orf62","17",80400465,80408705,8240
"10603","ENSG00000178935","ZNF552","19",58315209,58326281,11072
"10604","ENSG00000178947","LINC00086","X",134555868,134561999,6131
"10605","ENSG00000178950","GAK","4",843064,926161,83097
"10606","ENSG00000178951","ZBTB7A","19",4044362,4066943,22581
"10607","ENSG00000178952","TUFM","16",28853732,28857729,3997
"10608","ENSG00000178966","RMI1","9",86595626,86618985,23359
"10609","ENSG00000178971","CTC1","17",8130191,8151362,21171
"10610","ENSG00000178974","FBXO34","14",55738021,55828636,90615
"10611","ENSG00000178977","LINC00324","17",8123960,8127361,3401
"10612","ENSG00000178980","SEPW1","19",48281829,48287943,6114
"10613","ENSG00000178982","EIF3K","19",39109735,39127595,17860
"10614","ENSG00000178988","MRFAP1L1","4",6709428,6711607,2179
"10615","ENSG00000178996","SNX18","5",53813589,53842415,28826
"10616","ENSG00000178999","AURKB","17",8108056,8113918,5862
"10617","ENSG00000179010","MRFAP1","4",6641818,6644472,2654
"10618","ENSG00000179021","C3orf38","3",88198893,88217879,18986
"10619","ENSG00000179029","TMEM107","17",8076555,8079717,3162
"10620","ENSG00000179041","RRS1","8",67341263,67342966,1703
"10621","ENSG00000179051","RCC2","1",17733256,17766220,32964
"10622","ENSG00000179083","FAM133A","X",92929012,92967273,38261
"10623","ENSG00000179085","DPM3","1",155112367,155113071,704
"10624","ENSG00000179091","CYC1","8",145149930,145152428,2498
"10625","ENSG00000179094","PER1","17",8043790,8059824,16034
"10626","ENSG00000179104","TMTC2","12",83080659,83528649,447990
"10627","ENSG00000179115","FARSA","19",13033293,13044851,11558
"10628","ENSG00000179119","SPTY2D1","11",18627948,18656338,28390
"10629","ENSG00000179133","C10orf67","10",23556124,23633774,77650
"10630","ENSG00000179134","SAMD4B","19",39833036,39876350,43314
"10631","ENSG00000179151","EDC3","15",74922899,74988633,65734
"10632","ENSG00000179152","TCAIM","3",44379611,44450943,71332
"10633","ENSG00000179163","FUCA1","1",24171567,24194784,23217
"10634","ENSG00000179195","ZNF664","12",124456392,124499986,43594
"10635","ENSG00000179218","CALR","19",13049392,13055303,5911
"10636","ENSG00000179222","MAGED1","X",51546103,51645453,99350
"10637","ENSG00000179240","","11",76092357,76125663,33306
"10638","ENSG00000179241","LDLRAD3","11",35965531,36253686,288155
"10639","ENSG00000179242","CDH4","20",59827482,60515673,688191
"10640","ENSG00000179262","RAD23A","19",13056669,13064456,7787
"10641","ENSG00000179271","GADD45GIP1","19",13064972,13068050,3078
"10642","ENSG00000179277","MEIS3P1","17",15689932,15690889,957
"10643","ENSG00000179294","C17orf96","17",36827961,36831187,3226
"10644","ENSG00000179295","PTPN11","12",112856155,112947717,91562
"10645","ENSG00000179299","NSUN7","4",40751914,40812002,60088
"10646","ENSG00000179304","FAM156B","X",52920336,52937587,17251
"10647","ENSG00000179314","WSCD1","17",5675554,6027747,352193
"10648","ENSG00000179331","RAB39A","11",107799229,107834208,34979
"10649","ENSG00000179335","CLK3","15",74890841,74932057,41216
"10650","ENSG00000179361","ARID3B","15",74833518,74890472,56954
"10651","ENSG00000179364","PACS2","14",105766900,105864484,97584
"10652","ENSG00000179387","ELMOD2","4",141445312,141474924,29612
"10653","ENSG00000179397","C1orf101","1",244617679,244804479,186800
"10654","ENSG00000179399","GPC5","13",92050929,93519490,1468561
"10655","ENSG00000179403","VWA1","1",1370241,1378262,8021
"10656","ENSG00000179406","LINC00174","7",65841031,65866325,25294
"10657","ENSG00000179409","GEMIN4","17",647654,657239,9585
"10658","ENSG00000179431","FJX1","11",35639735,35642419,2684
"10659","ENSG00000179454","KLHL28","14",45393522,45511525,118003
"10660","ENSG00000179455","MKRN3","15",23810454,23873064,62610
"10661","ENSG00000179456","ZBTB18","1",244214585,244220778,6193
"10662","ENSG00000179476","C14orf28","14",45366498,45376460,9962
"10663","ENSG00000179520","SLC17A8","12",100750857,100815837,64980
"10664","ENSG00000179523","EIF3J-AS1","15",44819455,44829121,9666
"10665","ENSG00000179526","SHARPIN","8",145153536,145163027,9491
"10666","ENSG00000179532","DNHD1","11",6518490,6614988,96498
"10667","ENSG00000179542","SLITRK4","X",142710596,142723596,13000
"10668","ENSG00000179546","HTR1D","1",23516993,23521222,4229
"10669","ENSG00000179562","GCC1","7",127220672,127233665,12993
"10670","ENSG00000179588","ZFPM1","16",88519725,88603424,83699
"10671","ENSG00000179598","PLD6","17",17104309,17109629,5320
"10672","ENSG00000179603","GRM8","7",126078652,126893348,814696
"10673","ENSG00000179604","CDC42EP4","17",71279763,71308314,28551
"10674","ENSG00000179627","ZBTB42","14",105266933,105271049,4116
"10675","ENSG00000179630","LACC1","13",44453420,44468068,14648
"10676","ENSG00000179632","MAF1","8",145159402,145162514,3112
"10677","ENSG00000179673","RPRML","17",45055523,45056614,1091
"10678","ENSG00000179698","KIAA1875","8",145162629,145173218,10589
"10679","ENSG00000179743","","1",16160560,16174642,14082
"10680","ENSG00000179750","APOBEC3B","22",39378352,39388809,10457
"10681","ENSG00000179761","PIPOX","17",27277531,27384234,106703
"10682","ENSG00000179776","CDH5","16",66400533,66438686,38153
"10683","ENSG00000179796","LRRC3B","3",26664297,26752267,87970
"10684","ENSG00000179818","PCBP1-AS1","2",70189395,70315978,126583
"10685","ENSG00000179820","MYADM","19",54369477,54379691,10214
"10686","ENSG00000179832","MROH1","8",145202919,145316843,113924
"10687","ENSG00000179833","SERTAD2","2",64858755,64978139,119384
"10688","ENSG00000179837","RBM15B","3",51428731,51435330,6599
"10689","ENSG00000179841","AKAP5","14",64932217,64941221,9004
"10690","ENSG00000179859","","17",7816642,7819271,2629
"10691","ENSG00000179862","CITED4","1",41326729,41328018,1289
"10692","ENSG00000179869","ABCA13","7",48211055,48687092,476037
"10693","ENSG00000179886","TIGD5","8",144680074,144682485,2411
"10694","ENSG00000179889","PDXDC1","16",15068448,15233196,164748
"10695","ENSG00000179899","PHC1P1","12",55804263,55808633,4370
"10696","ENSG00000179902","C1orf194","1",109648573,109656479,7906
"10697","ENSG00000179909","ZNF154","19",58208735,58220579,11844
"10698","ENSG00000179912","R3HDM2","12",57643392,57824788,181396
"10699","ENSG00000179915","NRXN1","2",50145643,51259674,1114031
"10700","ENSG00000179918","SEPHS2","16",30454952,30457502,2550
"10701","ENSG00000179922","ZNF784","19",56132108,56135967,3859
"10702","ENSG00000179933","C14orf119","14",23563974,23569665,5691
"10703","ENSG00000179941","BBS10","12",76738254,76742222,3968
"10704","ENSG00000179943","FIZ1","19",56102746,56113336,10590
"10705","ENSG00000179950","PUF60","8",144898514,144912029,13515
"10706","ENSG00000179958","DCTPP1","16",30434940,30441396,6456
"10707","ENSG00000179965","ZNF771","16",30418618,30440920,22302
"10708","ENSG00000179978","","5",69390202,69424261,34059
"10709","ENSG00000179979","CRIPAK","4",1385340,1389780,4440
"10710","ENSG00000179981","TSHZ1","18",72922710,73001905,79195
"10711","ENSG00000179988","PSTK","10",124713897,124757029,43132
"10712","ENSG00000180008","SOCS4","14",55493948,55516206,22258
"10713","ENSG00000180011","ZADH2","18",72907063,72921303,14240
"10714","ENSG00000180035","ZNF48","16",30389427,30411429,22002
"10715","ENSG00000180071","ANKRD18A","9",38540566,38620657,80091
"10716","ENSG00000180089","TMEM86B","19",55738007,55741647,3640
"10717","ENSG00000180098","TRNAU1AP","1",28879597,28905051,25454
"10718","ENSG00000180104","EXOC3","5",443273,472052,28779
"10719","ENSG00000180155","LYNX1","8",143845752,143859640,13888
"10720","ENSG00000180178","FAR2P1","2",130748029,130808704,60675
"10721","ENSG00000180182","MED14","X",40507558,40595110,87552
"10722","ENSG00000180185","FAHD1","16",1876968,1890208,13240
"10723","ENSG00000180190","TDRP","8",439803,495781,55978
"10724","ENSG00000180198","RCC1","1",28832455,28865812,33357
"10725","ENSG00000180221","TPT1P10","10",59972302,59972797,495
"10726","ENSG00000180228","PRKRA","2",179296141,179316239,20098
"10727","ENSG00000180233","ZNRF2","7",30323923,30452118,128195
"10728","ENSG00000180257","ZNF816","19",53430388,53466164,35776
"10729","ENSG00000180263","FGD6","12",95470525,95611258,140733
"10730","ENSG00000180287","PLD5","1",242246288,242687998,441710
"10731","ENSG00000180304","OAZ2","15",64979772,64995480,15708
"10732","ENSG00000180329","CCDC43","17",42750437,42767147,16710
"10733","ENSG00000180336","C17orf104","17",42733762,42767676,33914
"10734","ENSG00000180340","FZD2","17",42634925,42636907,1982
"10735","ENSG00000180346","TIGD2","4",90033968,90036050,2082
"10736","ENSG00000180353","HCLS1","3",121350246,121379774,29528
"10737","ENSG00000180354","MTURN","7",30174426,30202378,27952
"10738","ENSG00000180357","ZNF609","15",64752941,64978264,225323
"10739","ENSG00000180370","PAK2","3",196466728,196559518,92790
"10740","ENSG00000180376","CCDC66","3",56591189,56655846,64657
"10741","ENSG00000180385","EMC3-AS1","3",10028577,10048674,20097
"10742","ENSG00000180398","MCFD2","2",47129009,47168994,39985
"10743","ENSG00000180423","HARBI1","11",46624411,46639459,15048
"10744","ENSG00000180425","C11orf71","11",114262165,114271139,8974
"10745","ENSG00000180447","GAS1","9",89559279,89562104,2825
"10746","ENSG00000180458","","19",38036372,38040073,3701
"10747","ENSG00000180479","ZNF571","19",38045684,38085673,39989
"10748","ENSG00000180488","FAM73A","1",78245309,78344106,98797
"10749","ENSG00000180530","NRIP1","21",16333556,16437321,103765
"10750","ENSG00000180537","RNF182","6",13924677,13980533,55856
"10751","ENSG00000180543","TSPYL5","8",98285717,98290176,4459
"10752","ENSG00000180573","HIST1H2AC","6",26124373,26139344,14971
"10753","ENSG00000180581","SRP9P1","10",93565803,93567253,1450
"10754","ENSG00000180592","SKIDA1","10",21802407,21814611,12204
"10755","ENSG00000180596","HIST1H2BC","6",26115101,26124154,9053
"10756","ENSG00000180611","MB21D2","3",192514604,192635950,121346
"10757","ENSG00000180616","SSTR2","17",71161151,71167185,6034
"10758","ENSG00000180626","ZNF594","17",5082831,5095178,12347
"10759","ENSG00000180628","PCGF5","10",92979908,93044088,64180
"10760","ENSG00000180660","MAB21L1","13",36047926,36050832,2906
"10761","ENSG00000180667","YOD1","1",207217194,207226325,9131
"10762","ENSG00000180672","","2",206642540,206644433,1893
"10763","ENSG00000180694","TMEM64","8",91634223,91803860,169637
"10764","ENSG00000180730","SHISA2","13",26618735,26625169,6434
"10765","ENSG00000180747","","16",21458004,21531765,73761
"10766","ENSG00000180758","GPR157","1",9160364,9189229,28865
"10767","ENSG00000180769","WDFY3-AS2","4",85887538,85932430,44892
"10768","ENSG00000180771","SRSF8","11",94800056,94804388,4332
"10769","ENSG00000180773","SLC36A4","11",92877341,92931130,53789
"10770","ENSG00000180776","ZDHHC20","13",21950263,22033509,83246
"10771","ENSG00000180801","ARSJ","4",114821440,114900883,79443
"10772","ENSG00000180815","MAP3K15","X",19378174,19533379,155205
"10773","ENSG00000180817","PPA1","10",71962586,71993667,31081
"10774","ENSG00000180822","PSMG4","6",3231637,3303607,71970
"10775","ENSG00000180828","BHLHE22","8",65492814,65496181,3367
"10776","ENSG00000180834","MAP6D1","3",183533664,183543382,9718
"10777","ENSG00000180855","ZNF443","19",12540521,12551926,11405
"10778","ENSG00000180867","PDIA3P1","1",146649692,146651206,1514
"10779","ENSG00000180875","GREM2","1",240652873,240775449,122576
"10780","ENSG00000180879","SSR4","X",153058971,153063960,4989
"10781","ENSG00000180881","CAPS2","12",75669759,75784708,114949
"10782","ENSG00000180884","ZNF792","19",35447258,35454953,7695
"10783","ENSG00000180891","CUEDC1","17",55938604,56032684,94080
"10784","ENSG00000180900","SCRIB","8",144873090,144897549,24459
"10785","ENSG00000180901","KCTD2","17",73028670,73061984,33314
"10786","ENSG00000180902","D2HGDH","2",242673994,242708231,34237
"10787","ENSG00000180914","OXTR","3",8792094,8811314,19220
"10788","ENSG00000180917","CMTR2","16",71315292,71323618,8326
"10789","ENSG00000180921","FAM83H","8",144806103,144815971,9868
"10790","ENSG00000180938","ZNF572","8",125985540,125991631,6091
"10791","ENSG00000180953","ST20","15",80191182,80216044,24862
"10792","ENSG00000180957","PITPNB","22",28247657,28316122,68465
"10793","ENSG00000180964","TCEAL8","X",102507923,102510131,2208
"10794","ENSG00000180979","LRRC57","15",42834720,42841000,6280
"10795","ENSG00000180992","MRPL14","6",44081194,44095194,14000
"10796","ENSG00000180998","GPR137C","14",53019866,53104431,84565
"10797","ENSG00000181004","BBS12","4",123653857,123666098,12241
"10798","ENSG00000181007","ZFP82","19",36874022,36909558,35536
"10799","ENSG00000181016","LSMEM1","7",112120908,112131117,10209
"10800","ENSG00000181019","NQO1","16",69740899,69760854,19955
"10801","ENSG00000181026","AEN","15",89164527,89175513,10986
"10802","ENSG00000181027","FKRP","19",47249303,47280245,30942
"10803","ENSG00000181035","SLC25A42","19",19174808,19223697,48889
"10804","ENSG00000181038","METTL23","17",74722912,74730018,7106
"10805","ENSG00000181039","ANKRD34A","1",145470508,145475646,5138
"10806","ENSG00000181045","SLC26A11","17",78193498,78227299,33801
"10807","ENSG00000181061","HIGD1A","3",42798669,42846023,47354
"10808","ENSG00000181072","CHRM2","7",136553416,136705002,151586
"10809","ENSG00000181090","EHMT1","9",140513444,140764468,251024
"10810","ENSG00000181104","F2R","5",76011868,76031606,19738
"10811","ENSG00000181135","ZNF707","8",144766622,144796068,29446
"10812","ENSG00000181163","NPM1","5",170814120,170838141,24021
"10813","ENSG00000181191","PJA1","X",68380694,68385636,4942
"10814","ENSG00000181192","DHTKD1","10",12110971,12165224,54253
"10815","ENSG00000181218","HIST3H2A","1",228645065,228645560,495
"10816","ENSG00000181220","ZNF746","7",149169885,149194908,25023
"10817","ENSG00000181222","POLR2A","17",7387685,7417933,30248
"10818","ENSG00000181264","TMEM136","11",120195838,120204391,8553
"10819","ENSG00000181274","FRAT2","10",99092255,99094458,2203
"10820","ENSG00000181284","TMEM102","17",7338762,7340998,2236
"10821","ENSG00000181315","ZNF322","6",26636518,26659980,23462
"10822","ENSG00000181350","FAM211A","17",16344891,16395467,50576
"10823","ENSG00000181381","DDX60L","4",169277886,169458937,181051
"10824","ENSG00000181396","OGFOD3","17",80347099,80376513,29414
"10825","ENSG00000181404","","9",14511,29739,15228
"10826","ENSG00000181409","AATK","17",79091095,79139877,48782
"10827","ENSG00000181444","ZNF467","7",149461271,149470568,9297
"10828","ENSG00000181449","SOX2","3",181429714,181432221,2507
"10829","ENSG00000181450","ZNF678","1",227751244,227865144,113900
"10830","ENSG00000181458","TMEM45A","3",100211463,100296288,84825
"10831","ENSG00000181467","RAP2B","3",152880029,152886265,6236
"10832","ENSG00000181472","ZBTB2","6",151685252,151712683,27431
"10833","ENSG00000181481","RNF135","17",29295803,29326929,31126
"10834","ENSG00000181513","ACBD4","17",43209967,43221548,11581
"10835","ENSG00000181523","SGSH","17",78180515,78194722,14207
"10836","ENSG00000181541","MAB21L2","4",151503077,151505843,2766
"10837","ENSG00000181544","FANCB","X",14861529,14891191,29662
"10838","ENSG00000181555","SETD2","3",47057919,47205457,147538
"10839","ENSG00000181588","MEX3D","19",1554668,1568057,13389
"10840","ENSG00000181610","MRPS23","17",55916842,55927417,10575
"10841","ENSG00000181619","GPR135","14",59895740,59932060,36320
"10842","ENSG00000181638","ZFP41","8",144328991,144344875,15884
"10843","ENSG00000181652","ATG9B","7",150709297,150721586,12289
"10844","ENSG00000181666","HKR1","19",37803739,37860267,56528
"10845","ENSG00000181690","PLAG1","8",57073463,57123883,50420
"10846","ENSG00000181704","YIPF6","X",67718165,67757127,38962
"10847","ENSG00000181722","ZBTB20","3",114056941,114866118,809177
"10848","ENSG00000181744","C3orf58","3",143690640,143767561,76921
"10849","ENSG00000181751","C5orf30","5",102594403,102614361,19958
"10850","ENSG00000181754","AMIGO1","1",110046797,110052360,5563
"10851","ENSG00000181773","GPR3","1",27719148,27722318,3170
"10852","ENSG00000181788","SIAH2","3",150458914,150481264,22350
"10853","ENSG00000181789","COPG1","3",128968449,128996614,28165
"10854","ENSG00000181798","LINC00471","2",232373137,232379050,5913
"10855","ENSG00000181804","SLC9A9","3",142984064,143567373,583309
"10856","ENSG00000181817","LSM10","1",36856839,36863493,6654
"10857","ENSG00000181826","RELL1","4",37592422,37687998,95576
"10858","ENSG00000181827","RFX7","15",56379478,56535483,156005
"10859","ENSG00000181830","SLC35C1","11",45825623,45834566,8943
"10860","ENSG00000181852","RNF41","12",56598285,56615717,17432
"10861","ENSG00000181856","SLC2A4","17",7184986,7191576,6590
"10862","ENSG00000181873","IBA57","1",228353516,228369958,16442
"10863","ENSG00000181894","ZNF329","19",58637619,58666477,28858
"10864","ENSG00000181896","ZNF101","19",19779605,19794318,14713
"10865","ENSG00000181904","C5orf24","5",134181370,134195427,14057
"10866","ENSG00000181915","ADO","10",64564516,64568238,3722
"10867","ENSG00000181924","COA4","11",73583712,73588033,4321
"10868","ENSG00000181929","PRKAG1","12",49396057,49412980,16923
"10869","ENSG00000181938","GINS3","16",58328984,58440048,111064
"10870","ENSG00000181965","NEUROG1","5",134869991,134871639,1648
"10871","ENSG00000181982","CCDC149","4",24807739,24981826,174087
"10872","ENSG00000181991","MRPS11","15",89010684,89022222,11538
"10873","ENSG00000182004","SNRPE","1",203830731,203839678,8947
"10874","ENSG00000182010","RTKN2","10",63942794,64028466,85672
"10875","ENSG00000182013","PNMAL1","19",46969748,46974820,5072
"10876","ENSG00000182022","CHST15","10",125767184,125853206,86022
"10877","ENSG00000182050","MGAT4C","12",86372516,87232681,860165
"10878","ENSG00000182054","IDH2","15",90626277,90645736,19459
"10879","ENSG00000182087","TMEM259","19",1009647,1021117,11470
"10880","ENSG00000182093","WRB","21",40752170,40800454,48284
"10881","ENSG00000182095","TNRC18","7",5346421,5465045,118624
"10882","ENSG00000182108","DEXI","16",11022748,11036317,13569
"10883","ENSG00000182109","","1",39987952,40011859,23907
"10884","ENSG00000182117","NOP10","15",34633917,34635378,1461
"10885","ENSG00000182118","FAM89A","1",231154704,231175992,21288
"10886","ENSG00000182132","KCNIP1","5",169780491,170163636,383145
"10887","ENSG00000182134","TDRKH","1",151742583,151763892,21309
"10888","ENSG00000182141","ZNF708","19",21473962,21512227,38265
"10889","ENSG00000182149","IST1","16",71879899,71962913,83014
"10890","ENSG00000182150","ERCC6L2","9",98637983,98776842,138859
"10891","ENSG00000182154","MRPL41","9",140445651,140447007,1356
"10892","ENSG00000182158","CREB3L2","7",137559725,137686813,127088
"10893","ENSG00000182165","TP53TG1","7",86954541,86974831,20290
"10894","ENSG00000182168","UNC5C","4",96083655,96470357,386702
"10895","ENSG00000182173","TSEN54","17",73512141,73520820,8679
"10896","ENSG00000182175","RGMA","15",93586636,93632433,45797
"10897","ENSG00000182179","UBA7","3",49842640,49851379,8739
"10898","ENSG00000182180","MRPS16","10",75006510,75012451,5941
"10899","ENSG00000182185","RAD51B","14",68286496,69196935,910439
"10900","ENSG00000182195","LDOC1","X",140269934,140271310,1376
"10901","ENSG00000182197","EXT1","8",118806729,119124092,317363
"10902","ENSG00000182199","SHMT2","12",57623110,57628718,5608
"10903","ENSG00000182208","MOB2","11",1490687,1522477,31790
"10904","ENSG00000182218","HHIPL1","14",100111447,100146906,35459
"10905","ENSG00000182220","ATP6AP2","X",40440146,40465889,25743
"10906","ENSG00000182224","CYB5D1","17",7761064,7765600,4536
"10907","ENSG00000182240","BACE2","21",42539728,42654445,114717
"10908","ENSG00000182247","UBE2E2","3",23244511,23633284,388773
"10909","ENSG00000182253","SYNM","15",99638420,99675798,37378
"10910","ENSG00000182255","KCNA4","11",30031288,30038570,7282
"10911","ENSG00000182256","GABRG3","15",27216429,27778373,561944
"10912","ENSG00000182263","FIGN","2",164449906,164592522,142616
"10913","ENSG00000182272","B4GALNT4","11",369796,382116,12320
"10914","ENSG00000182287","AP1S2","X",15843929,15873054,29125
"10915","ENSG00000182307","C8orf33","8",146277764,146281416,3652
"10916","ENSG00000182310","SPACA6P","19",52196593,52215640,19047
"10917","ENSG00000182318","ZSCAN22","19",58838385,58853698,15313
"10918","ENSG00000182319","","8",8175258,8244008,68750
"10919","ENSG00000182324","KCNJ14","19",48958766,48969367,10601
"10920","ENSG00000182325","FBXL6","8",145579091,145583036,3945
"10921","ENSG00000182326","C1S","12",7096351,7178336,81985
"10922","ENSG00000182329","","2",202937978,203062585,124607
"10923","ENSG00000182348","ZNF804B","7",88388682,88966346,577664
"10924","ENSG00000182359","KBTBD3","11",105921825,105948492,26667
"10925","ENSG00000182362","YBEY","21",47706251,47717665,11414
"10926","ENSG00000182368","FAM27A","9",45727107,45728274,1167
"10927","ENSG00000182372","CLN8","8",1703944,1734738,30794
"10928","ENSG00000182378","PLCXD1","X",192989,220023,27034
"10929","ENSG00000182389","CACNB4","2",152689290,152955593,266303
"10930","ENSG00000182397","DNM1P46","15",100330361,100347132,16771
"10931","ENSG00000182400","TRAPPC6B","14",39617015,39639736,22721
"10932","ENSG00000182404","","6",128768543,128770446,1903
"10933","ENSG00000182405","PGBD4","15",34394274,34396591,2317
"10934","ENSG00000182446","NPLOC4","17",79523913,79615495,91582
"10935","ENSG00000182463","TSHZ2","20",51588946,52111869,522923
"10936","ENSG00000182473","EXOC7","17",74077087,74117657,40570
"10937","ENSG00000182481","KPNA2","17",66031635,66042958,11323
"10938","ENSG00000182484","WASH6P","X",155250491,155255375,4884
"10939","ENSG00000182492","BGN","X",152760397,152775012,14615
"10940","ENSG00000182500","ORAI1","12",122064455,122080583,16128
"10941","ENSG00000182504","CEP97","3",101442769,101489406,46637
"10942","ENSG00000182508","LHFPL1","X",111873876,111923375,49499
"10943","ENSG00000182511","FES","15",91426925,91439006,12081
"10944","ENSG00000182512","GLRX5","14",95999840,96011061,11221
"10945","ENSG00000182518","FAM104B","X",55169535,55187743,18208
"10946","ENSG00000182534","MXRA7","17",74668633,74707098,38465
"10947","ENSG00000182541","LIMK2","22",31608225,31676066,67841
"10948","ENSG00000182544","MFSD5","12",53645035,53648189,3154
"10949","ENSG00000182551","ADI1","2",3501132,3523507,22375
"10950","ENSG00000182552","RWDD4","4",184560788,184580378,19590
"10951","ENSG00000182568","SATB1","3",18386879,18487080,100201
"10952","ENSG00000182572","HIST1H3I","6",27839623,27840099,476
"10953","ENSG00000182575","NXPH3","17",47653220,47661189,7969
"10954","ENSG00000182580","EPHB3","3",184279572,184300197,20625
"10955","ENSG00000182600","C2orf82","2",233721980,233743418,21438
"10956","ENSG00000182606","TRAK1","3",42055294,42267381,212087
"10957","ENSG00000182611","HIST1H2AJ","6",27782112,27782607,495
"10958","ENSG00000182612","TSPAN10","17",79604197,79615779,11582
"10959","ENSG00000182621","PLCB1","20",8112824,8949003,836179
"10960","ENSG00000182628","SKA2","17",57187312,57232630,45318
"10961","ENSG00000182636","NDN","15",23930565,23932450,1885
"10962","ENSG00000182646","FAM156A","X",52976462,53024651,48189
"10963","ENSG00000182648","LINC01006","7",156264890,156433286,168396
"10964","ENSG00000182667","NTM","11",131240373,132206716,966343
"10965","ENSG00000182670","TTC3","21",38445526,38575413,129887
"10966","ENSG00000182674","KCNB2","8",73449626,73850584,400958
"10967","ENSG00000182685","BRICD5","16",2259254,2261951,2697
"10968","ENSG00000182700","IGIP","5",139505521,139508391,2870
"10969","ENSG00000182704","TSKU","11",76493295,76509198,15903
"10970","ENSG00000182718","ANXA2","15",60639333,60695082,55749
"10971","ENSG00000182732","RGS6","14",72399156,73030654,631498
"10972","ENSG00000182749","PAQR7","1",26187701,26197744,10043
"10973","ENSG00000182752","PAPPA","9",118916083,119164601,248518
"10974","ENSG00000182768","NGRN","15",90808891,90816463,7572
"10975","ENSG00000182771","GRID1","10",87359312,88126250,766938
"10976","ENSG00000182791","CCDC87","11",66357640,66360554,2914
"10977","ENSG00000182796","TMEM198B","12",56223529,56230030,6501
"10978","ENSG00000182809","CRIP2","14",105939299,105946499,7200
"10979","ENSG00000182810","DDX28","16",68055179,68057770,2591
"10980","ENSG00000182827","ACBD3","1",226332380,226374431,42051
"10981","ENSG00000182831","C16orf72","16",9185505,9215497,29992
"10982","ENSG00000182836","PLCXD3","5",41307056,41510730,203674
"10983","ENSG00000182841","RRP7B","22",42951229,42978044,26815
"10984","ENSG00000182858","ALG12","22",50293877,50312106,18229
"10985","ENSG00000182871","COL18A1","21",46825052,46933634,108582
"10986","ENSG00000182872","RBM10","X",47004268,47046212,41944
"10987","ENSG00000182873","","1",2113233,2115828,2595
"10988","ENSG00000182890","GLUD2","X",120181462,120183794,2332
"10989","ENSG00000182899","RPL35A","3",197676858,197683481,6623
"10990","ENSG00000182901","RGS7","1",240931554,241520530,588976
"10991","ENSG00000182902","SLC25A18","22",18043139,18073760,30621
"10992","ENSG00000182903","ZNF721","4",419604,492945,73341
"10993","ENSG00000182916","TCEAL7","X",102585124,102587254,2130
"10994","ENSG00000182919","C11orf54","11",93474757,93497915,23158
"10995","ENSG00000182923","CEP63","3",134204585,134293859,89274
"10996","ENSG00000182934","SRPR","11",126132814,126139039,6225
"10997","ENSG00000182944","EWSR1","22",29663998,29696515,32517
"10998","ENSG00000182952","HMGN4","6",26538633,26546482,7849
"10999","ENSG00000182957","SPATA13","13",24553944,24881212,327268
"11000","ENSG00000182963","GJC1","17",42875816,42908184,32368
"11001","ENSG00000182968","SOX1","13",112721913,112726020,4107
"11002","ENSG00000182973","CNOT10","3",32726637,32815367,88730
"11003","ENSG00000182979","MTA1","14",105886159,105937066,50907
"11004","ENSG00000182983","ZNF662","3",42947223,42960825,13602
"11005","ENSG00000182985","CADM1","11",115039938,115375675,335737
"11006","ENSG00000182986","ZNF320","19",53367043,53400946,33903
"11007","ENSG00000182993","C12orf60","12",14956506,15059520,103014
"11008","ENSG00000183010","PYCR1","17",79890260,79900288,10028
"11009","ENSG00000183011","LSMD1","17",7760003,7788556,28553
"11010","ENSG00000183018","SPNS2","17",4402133,4442330,40197
"11011","ENSG00000183020","AP2A2","11",924894,1012239,87345
"11012","ENSG00000183023","SLC8A1","2",40324410,40838193,513783
"11013","ENSG00000183032","SLC25A21","14",37147636,37642071,494435
"11014","ENSG00000183044","ABAT","16",8768422,8878432,110010
"11015","ENSG00000183048","SLC25A10","17",79670404,79688042,17638
"11016","ENSG00000183049","CAMK1D","10",12391481,12877545,486064
"11017","ENSG00000183060","LYSMD4","15",100255902,100273766,17864
"11018","ENSG00000183067","IGSF5","21",41117334,41174023,56689
"11019","ENSG00000183077","AFMID","17",76183398,76203782,20384
"11020","ENSG00000183087","GAS6","13",114523522,114567046,43524
"11021","ENSG00000183091","NEB","2",152341850,152591001,249151
"11022","ENSG00000183092","BEGAIN","14",101003486,101053750,50264
"11023","ENSG00000183098","GPC6","13",93879095,95059655,1180560
"11024","ENSG00000183111","ARHGEF37","5",148931510,149014531,83021
"11025","ENSG00000183117","CSMD1","8",2792875,4852494,2059619
"11026","ENSG00000183137","CEP57L1","6",109416313,109485135,68822
"11027","ENSG00000183145","RIPPLY3","21",38378450,38391959,13509
"11028","ENSG00000183150","GPR19","12",12813825,12849141,35316
"11029","ENSG00000183155","RABIF","1",202848085,202858263,10178
"11030","ENSG00000183161","FANCF","11",22644079,22647387,3308
"11031","ENSG00000183172","SMDT1","22",42475695,42480288,4593
"11032","ENSG00000183186","C2CD4C","19",405438,409139,3701
"11033","ENSG00000183196","CHST6","16",75510949,75529282,18333
"11034","ENSG00000183207","RUVBL2","19",49496705,49519252,22547
"11035","ENSG00000183208","GDPGP1","15",90777040,90785315,8275
"11036","ENSG00000183230","CTNNA3","10",67672276,69455927,1783651
"11037","ENSG00000183248","","19",7933605,7939326,5721
"11038","ENSG00000183250","C21orf67","21",46352729,46359828,7099
"11039","ENSG00000183255","PTTG1IP","21",46269500,46293752,24252
"11040","ENSG00000183258","DDX41","5",176938578,176944470,5892
"11041","ENSG00000183281","PLGLB1","2",87229682,87248975,19293
"11042","ENSG00000183283","DAZAP2","12",51632076,51665146,33070
"11043","ENSG00000183291","","1",87328132,87380107,51975
"11044","ENSG00000183307","CECR6","22",17597189,17602257,5068
"11045","ENSG00000183309","ZNF623","8",144718183,144735900,17717
"11046","ENSG00000183323","CCDC125","5",68576002,68628636,52634
"11047","ENSG00000183337","BCOR","X",39909068,40036582,127514
"11048","ENSG00000183340","JRKL","11",96123153,96240738,117585
"11049","ENSG00000183354","KIAA2026","9",5881596,6007901,126305
"11050","ENSG00000183386","FHL3","1",38462442,38471278,8836
"11051","ENSG00000183401","CCDC159","19",11455360,11465620,10260
"11052","ENSG00000183405","RPS7P1","17",26794814,26795460,646
"11053","ENSG00000183426","NPIPA1","16",15016659,15045915,29256
"11054","ENSG00000183431","SF3A3","1",38422647,38456593,33946
"11055","ENSG00000183439","TRIM61","4",165875598,165898820,23222
"11056","ENSG00000183444","OR7E38P","7",97595402,97596386,984
"11057","ENSG00000183454","GRIN2A","16",9852376,10276611,424235
"11058","ENSG00000183458","","16",15005408,15029565,24157
"11059","ENSG00000183474","GTF2H2C","5",68856035,68890550,34515
"11060","ENSG00000183475","ASB7","15",101142739,101191910,49171
"11061","ENSG00000183495","EP400","12",132434508,132565005,130497
"11062","ENSG00000183496","MEX3B","15",82334119,82338482,4363
"11063","ENSG00000183506","PI4KAP2","22",21827289,21871822,44533
"11064","ENSG00000183508","FAM46C","1",118148556,118170994,22438
"11065","ENSG00000183513","COA5","2",99215773,99224978,9205
"11066","ENSG00000183520","UTP11L","1",38474930,38490496,15566
"11067","ENSG00000183527","PSMG1","21",40546695,40555777,9082
"11068","ENSG00000183530","PRR14L","22",32072242,32146126,73884
"11069","ENSG00000183569","SERHL2","22",42949623,42970388,20765
"11070","ENSG00000183570","PCBP3","21",47063608,47362368,298760
"11071","ENSG00000183576","SETD3","14",99864083,99947216,83133
"11072","ENSG00000183579","ZNRF3","22",29279580,29453475,173895
"11073","ENSG00000183580","FBXL7","5",15500305,15939900,439595
"11074","ENSG00000183597","TANGO2","22",20004537,20053449,48912
"11075","ENSG00000183598","HIST2H3D","1",149784826,149785236,410
"11076","ENSG00000183604","","16",30234230,30346695,112465
"11077","ENSG00000183605","SFXN4","10",120900279,120925179,24900
"11078","ENSG00000183617","MRPL54","19",3762662,3768573,5911
"11079","ENSG00000183621","ZNF438","10",31109136,31320866,211730
"11080","ENSG00000183624","HMCES","3",128997671,129025029,27358
"11081","ENSG00000183628","DGCR6","22",18893541,18901751,8210
"11082","ENSG00000183647","ZNF530","19",58111253,58124090,12837
"11083","ENSG00000183648","NDUFB1","14",92582466,92588261,5795
"11084","ENSG00000183655","KLHL25","15",86302554,86338261,35707
"11085","ENSG00000183665","TRMT12","8",125463048,125474391,11343
"11086","ENSG00000183666","GUSBP1","5",21341942,21589481,247539
"11087","ENSG00000183671","GPR1","2",207040040,207082771,42731
"11088","ENSG00000183684","ALYREF","17",79845713,79849462,3749
"11089","ENSG00000183688","FAM101B","17",289769,295730,5961
"11090","ENSG00000183690","EFHC2","X",44007128,44202918,195790
"11091","ENSG00000183691","NOG","17",54671060,54672951,1891
"11092","ENSG00000183696","UPP1","7",48128225,48148330,20105
"11093","ENSG00000183715","OPCML","11",132284871,133402414,1117543
"11094","ENSG00000183718","TRIM52","5",180681417,180688119,6702
"11095","ENSG00000183722","LHFP","13",39917029,40177665,260636
"11096","ENSG00000183723","CMTM4","16",66648653,66730610,81957
"11097","ENSG00000183726","TMEM50A","1",25664408,25688852,24444
"11098","ENSG00000183735","TBK1","12",64845660,64895888,50228
"11099","ENSG00000183741","CBX6","22",39257455,39268319,10864
"11100","ENSG00000183742","MACC1","7",20174278,20257027,82749
"11101","ENSG00000183751","TBL3","16",2022038,2032934,10896
"11102","ENSG00000183762","KREMEN1","22",29469066,29564321,95255
"11103","ENSG00000183763","TRAIP","3",49866034,49894007,27973
"11104","ENSG00000183765","CHEK2","22",29083731,29138410,54679
"11105","ENSG00000183775","KCTD16","5",143550396,143865249,314853
"11106","ENSG00000183778","B3GALT5","21",40928369,41045064,116695
"11107","ENSG00000183780","SLC35F3","1",234040679,234460262,419583
"11108","ENSG00000183793","NPIPA5","16",15457516,15474904,17388
"11109","ENSG00000183798","EMILIN3","20",39988606,39995467,6861
"11110","ENSG00000183808","RBM12B","8",94741584,94753245,11661
"11111","ENSG00000183814","LIN9","1",226418850,226497570,78720
"11112","ENSG00000183826","BTBD9","6",38136227,38607924,471697
"11113","ENSG00000183828","NUDT14","14",105639275,105647660,8385
"11114","ENSG00000183831","ANKRD45","1",173578700,173639001,60301
"11115","ENSG00000183833","MAATS1","3",119421869,119485949,64080
"11116","ENSG00000183837","PNMA3","X",152224766,152228827,4061
"11117","ENSG00000183840","GPR39","2",133174147,133404132,229985
"11118","ENSG00000183850","ZNF730","19",23258012,23330021,72009
"11119","ENSG00000183853","KIRREL","1",157963063,158070052,106989
"11120","ENSG00000183856","IQGAP3","1",156495197,156542396,47199
"11121","ENSG00000183864","TOB2","22",41829496,41843027,13531
"11122","ENSG00000183876","ARSI","5",149675906,149718870,42964
"11123","ENSG00000183878","UTY","Y",15360259,15592553,232294
"11124","ENSG00000183889","","16",16411301,16444447,33146
"11125","ENSG00000183891","TTC32","2",20096404,20101747,5343
"11126","ENSG00000183908","LRRC55","11",56949221,56959191,9970
"11127","ENSG00000183914","DNAH2","17",7620672,7737062,116390
"11128","ENSG00000183935","HTR7P1","12",13152812,13155768,2956
"11129","ENSG00000183943","PRKX","X",3522411,3631649,109238
"11130","ENSG00000183955","SETD8","12",123868320,123893905,25585
"11131","ENSG00000183960","KCNH8","3",19189946,19577138,387192
"11132","ENSG00000183963","SMTN","22",31460091,31500743,40652
"11133","ENSG00000183978","COA3","17",40947165,40950722,3557
"11134","ENSG00000183979","NPB","17",79858621,79860781,2160
"11135","ENSG00000184005","ST6GALNAC3","1",76540404,77100286,559882
"11136","ENSG00000184007","PTP4A2","1",32372022,32410457,38435
"11137","ENSG00000184009","ACTG1","17",79476997,79490873,13876
"11138","ENSG00000184014","DENND5A","11",9160372,9286937,126565
"11139","ENSG00000184047","DIABLO","12",122692210,122712081,19871
"11140","ENSG00000184056","VPS33B","15",91541646,91565833,24187
"11141","ENSG00000184060","ADAP2","17",29233362,29286340,52978
"11142","ENSG00000184068","","22",42227219,42230669,3450
"11143","ENSG00000184076","UQCR10","22",30163358,30166402,3044
"11144","ENSG00000184083","FAM120C","X",54094757,54209714,114957
"11145","ENSG00000184110","EIF3C","16",28699879,28747051,47172
"11146","ENSG00000184113","CLDN5","22",19510547,19515068,4521
"11147","ENSG00000184117","NIPSNAP1","22",29950797,29977326,26529
"11148","ENSG00000184144","CNTN2","1",205012325,205047627,35302
"11149","ENSG00000184154","LRTOMT","11",71791382,71821828,30446
"11150","ENSG00000184156","KCNQ3","8",133133108,133493200,360092
"11151","ENSG00000184162","NR2C2AP","19",19312225,19314233,2008
"11152","ENSG00000184164","CRELD2","22",50311815,50321188,9373
"11153","ENSG00000184178","SCFD2","4",53739149,54232242,493093
"11154","ENSG00000184182","UBE2F","2",238875469,238951236,75767
"11155","ENSG00000184185","KCNJ12","17",21279509,21323179,43670
"11156","ENSG00000184194","GPR173","X",53078273,53109797,31524
"11157","ENSG00000184203","PPP1R2","3",195241221,195270209,28988
"11158","ENSG00000184205","TSPYL2","X",53111549,53117722,6173
"11159","ENSG00000184207","PGP","16",2261998,2264808,2810
"11160","ENSG00000184208","C22orf46","22",42084943,42094140,9197
"11161","ENSG00000184209","SNRNP35","12",123942188,123957701,15513
"11162","ENSG00000184216","IRAK1","X",153275951,153285431,9480
"11163","ENSG00000184220","CMSS1","3",99536678,99897447,360769
"11164","ENSG00000184226","PCDH9","13",66876967,67804468,927501
"11165","ENSG00000184227","ACOT1","14",74003818,74010498,6680
"11166","ENSG00000184232","OAF","11",120081475,120101041,19566
"11167","ENSG00000184260","HIST2H2AC","1",149858525,149858961,436
"11168","ENSG00000184261","KCNK12","2",47743720,47798078,54358
"11169","ENSG00000184270","HIST2H2AB","1",149859019,149859466,447
"11170","ENSG00000184271","POU6F1","12",51580719,51611477,30758
"11171","ENSG00000184277","TM2D3","15",102161847,102192594,30747
"11172","ENSG00000184281","TSSC4","11",2421718,2425106,3388
"11173","ENSG00000184304","PRKD1","14",30045687,30661104,615417
"11174","ENSG00000184305","CCSER1","4",91048686,92523064,1474378
"11175","ENSG00000184307","ZDHHC23","3",113666748,113684248,17500
"11176","ENSG00000184319","RPL23AP82","22",51195376,51239737,44361
"11177","ENSG00000184347","SLIT3","5",168088745,168728133,639388
"11178","ENSG00000184348","HIST1H2AK","6",27805658,27806117,459
"11179","ENSG00000184349","EFNA5","5",106712590,107006596,294006
"11180","ENSG00000184357","HIST1H1B","6",27834570,27835359,789
"11181","ENSG00000184368","MAP7D2","X",20024831,20135035,110204
"11182","ENSG00000184371","CSF1","1",110452864,110473614,20750
"11183","ENSG00000184378","ACTRT3","3",169484709,169487683,2974
"11184","ENSG00000184381","PLA2G6","22",38507502,38601697,94195
"11185","ENSG00000184384","MAML2","11",95709762,96076344,366582
"11186","ENSG00000184402","SS18L1","20",60718822,60757540,38718
"11187","ENSG00000184408","KCND2","7",119913722,120390385,476663
"11188","ENSG00000184428","TOP1MT","8",144386554,144442149,55595
"11189","ENSG00000184432","COPB2","3",139074442,139108574,34132
"11190","ENSG00000184436","THAP7","22",21353393,21356485,3092
"11191","ENSG00000184441","","21",45751117,45755734,4617
"11192","ENSG00000184445","KNTC1","12",123011793,123110943,99150
"11193","ENSG00000184465","WDR27","6",169857307,170102159,244852
"11194","ENSG00000184470","TXNRD2","22",19863040,19929341,66301
"11195","ENSG00000184481","FOXO4","X",70316047,70323385,7338
"11196","ENSG00000184486","POU3F2","6",99282580,99286660,4080
"11197","ENSG00000184489","PTP4A3","8",142402093,142441620,39527
"11198","ENSG00000184500","PROS1","3",93591881,93692910,101029
"11199","ENSG00000184508","HDDC3","15",91474148,91475799,1651
"11200","ENSG00000184517","ZFP1","16",75182390,75206134,23744
"11201","ENSG00000184524","CEND1","11",787104,790123,3019
"11202","ENSG00000184545","DUSP8","11",1575274,1593150,17876
"11203","ENSG00000184557","SOCS3","17",76352864,76356158,3294
"11204","ENSG00000184575","XPOT","12",64798130,64844907,46777
"11205","ENSG00000184588","PDE4B","1",66258197,66840259,582062
"11206","ENSG00000184602","SNN","16",11762270,11773015,10745
"11207","ENSG00000184611","KCNH7","2",163227917,163695240,467323
"11208","ENSG00000184613","NELL2","12",44902058,45315631,413573
"11209","ENSG00000184619","KRBA2","17",8271955,8280029,8074
"11210","ENSG00000184634","MED12","X",70338406,70362303,23897
"11211","ENSG00000184635","ZNF93","19",20011722,20046384,34662
"11212","ENSG00000184640","SEPT9","17",75276651,75496678,220027
"11213","ENSG00000184661","CDCA2","8",25316513,25365436,48923
"11214","ENSG00000184669","OR7E14P","11",17035545,17074583,39038
"11215","ENSG00000184672","RALYL","8",85095022,85834079,739057
"11216","ENSG00000184674","GSTT1","22",24376133,24384680,8547
"11217","ENSG00000184675","AMER1","X",63404997,63425624,20627
"11218","ENSG00000184677","ZBTB40","1",22778344,22857650,79306
"11219","ENSG00000184678","HIST2H2BE","1",149856010,149858232,2222
"11220","ENSG00000184702","SEPT5","22",19701987,19712295,10308
"11221","ENSG00000184708","EIF4ENIF1","22",31832963,31892094,59131
"11222","ENSG00000184719","RNLS","10",90033621,90344287,310666
"11223","ENSG00000184731","FAM110C","2",38814,46870,8056
"11224","ENSG00000184743","ATL3","11",63391559,63439393,47834
"11225","ENSG00000184752","NDUFA12","12",95290831,95397546,106715
"11226","ENSG00000184787","UBE2G2","21",46188955,46221934,32979
"11227","ENSG00000184792","OSBP2","22",31089769,31303811,214042
"11228","ENSG00000184809","C21orf88","21",40969074,40984748,15674
"11229","ENSG00000184825","HIST1H2AH","6",27114861,27115317,456
"11230","ENSG00000184828","ZBTB7C","18",45553044,45937123,384079
"11231","ENSG00000184831","APOO","X",23851470,23926057,74587
"11232","ENSG00000184838","PRR16","5",119799973,120023027,223054
"11233","ENSG00000184840","TMED9","5",177019159,177023125,3966
"11234","ENSG00000184857","TMEM186","16",8874241,8891505,17264
"11235","ENSG00000184863","RBM33","7",155437145,155574179,137034
"11236","ENSG00000184867","ARMCX2","X",100910267,100914876,4609
"11237","ENSG00000184886","PIGW","17",34890847,34895159,4312
"11238","ENSG00000184887","BTBD6","14",105714827,105717430,2603
"11239","ENSG00000184897","H1FX","3",129033615,129035120,1505
"11240","ENSG00000184898","RBM43","2",152104454,152118393,13939
"11241","ENSG00000184900","SUMO3","21",46225532,46238694,13162
"11242","ENSG00000184903","IMMP2L","7",110303110,111202573,899463
"11243","ENSG00000184908","CLCNKB","1",16370272,16383803,13531
"11244","ENSG00000184924","PTRHD1","2",25012603,25016251,3648
"11245","ENSG00000184939","ZFP90","16",68563993,68609975,45982
"11246","ENSG00000184949","FAM227A","22",38974125,39052634,78509
"11247","ENSG00000184967","NOC4L","12",132628993,132637013,8020
"11248","ENSG00000184979","USP18","22",18632666,18660164,27498
"11249","ENSG00000184983","NDUFA6","22",42481529,42486959,5430
"11250","ENSG00000184985","SORCS2","4",7194265,7744554,550289
"11251","ENSG00000184988","TMEM106A","17",41363854,41372061,8207
"11252","ENSG00000184990","SIVA1","14",105219437,105234831,15394
"11253","ENSG00000184992","BRI3BP","12",125478246,125515777,37531
"11254","ENSG00000185000","DGAT1","8",145539954,145550573,10619
"11255","ENSG00000185008","ROBO2","3",75955846,77699115,1743269
"11256","ENSG00000185009","AP3M1","10",75881524,75910821,29297
"11257","ENSG00000185010","F8","X",154064063,154255215,191152
"11258","ENSG00000185015","CA13","8",86132816,86196302,63486
"11259","ENSG00000185019","UBOX5","20",3088219,3140842,52623
"11260","ENSG00000185020","","9",40293025,40339528,46503
"11261","ENSG00000185022","MAFF","22",38597889,38612518,14629
"11262","ENSG00000185024","BRF1","14",105675623,105781926,106303
"11263","ENSG00000185033","SEMA4B","15",90703836,90772911,69075
"11264","ENSG00000185043","CIB1","15",90773207,90777279,4072
"11265","ENSG00000185046","ANKS1B","12",99120235,100378432,1258197
"11266","ENSG00000185049","NELFA","4",1984441,2043630,59189
"11267","ENSG00000185065","","22",19435416,19437628,2212
"11268","ENSG00000185070","FLRT2","14",85996488,86095034,98546
"11269","ENSG00000185085","INTS5","11",62414320,62420774,6454
"11270","ENSG00000185088","RPS27L","15",63418071,63450220,32149
"11271","ENSG00000185090","MANEAL","1",38259474,38266809,7335
"11272","ENSG00000185100","ADSSL1","14",105190523,105213662,23139
"11273","ENSG00000185104","FAF1","1",50905150,51425935,520785
"11274","ENSG00000185112","FAM43A","3",194406622,194409762,3140
"11275","ENSG00000185115","NDNL2","15",29560353,29562033,1680
"11276","ENSG00000185122","HSF1","8",145515280,145538385,23105
"11277","ENSG00000185127","C6orf120","6",170102233,170106401,4168
"11278","ENSG00000185128","TBC1D3F","17",36283971,36294915,10944
"11279","ENSG00000185129","PURA","5",139487362,139496321,8959
"11280","ENSG00000185130","HIST1H2BL","6",27775257,27775709,452
"11281","ENSG00000185133","INPP5J","22",31518717,31530682,11965
"11282","ENSG00000185158","LRRC37B","17",30334891,30380523,45632
"11283","ENSG00000185163","DDX51","12",132621139,132628880,7741
"11284","ENSG00000185164","NOMO2","16",18511182,18573533,62351
"11285","ENSG00000185187","SIGIRR","11",405716,417455,11739
"11286","ENSG00000185189","NRBP2","8",144915764,144924200,8436
"11287","ENSG00000185201","IFITM2","11",307631,315272,7641
"11288","ENSG00000185215","TNFAIP2","14",103589779,103603776,13997
"11289","ENSG00000185219","ZNF445","3",44481262,44519162,37900
"11290","ENSG00000185220","PGBD2","1",249200395,249214145,13750
"11291","ENSG00000185222","WBP5","X",102611373,102613397,2024
"11292","ENSG00000185236","RAB11B","19",8454865,8469318,14453
"11293","ENSG00000185238","PRMT3","11",20409076,20530840,121764
"11294","ENSG00000185246","PRPF39","14",45553302,45585485,32183
"11295","ENSG00000185250","PPIL6","6",109711418,109762374,50956
"11296","ENSG00000185252","ZNF74","22",20748405,20762745,14340
"11297","ENSG00000185261","KIAA0825","5",93488671,93954309,465638
"11298","ENSG00000185262","UBALD2","17",74261283,74267375,6092
"11299","ENSG00000185267","CDNF","10",14861249,14880574,19325
"11300","ENSG00000185274","WBSCR17","7",70597155,71178585,581430
"11301","ENSG00000185275","CD24P4","Y",21154353,21154595,242
"11302","ENSG00000185278","ZBTB37","1",173837220,173872687,35467
"11303","ENSG00000185298","CCDC137","17",79633394,79640934,7540
"11304","ENSG00000185304","RGPD2","2",88055474,88285309,229835
"11305","ENSG00000185305","ARL15","5",53179775,53606412,426637
"11306","ENSG00000185324","CDK10","16",89747145,89762772,15627
"11307","ENSG00000185339","TCN2","22",31002825,31023265,20440
"11308","ENSG00000185340","GAS2L1","22",29702572,29708774,6202
"11309","ENSG00000185344","ATP6V0A2","12",124196865,124246302,49437
"11310","ENSG00000185345","PARK2","6",161768452,163148803,1380351
"11311","ENSG00000185347","C14orf80","14",105956192,105965912,9720
"11312","ENSG00000185352","HS6ST3","13",96743093,97485671,742578
"11313","ENSG00000185359","HGS","17",79650356,79670168,19812
"11314","ENSG00000185361","TNFAIP8L1","19",4639530,4655580,16050
"11315","ENSG00000185379","RAD51D","17",33426811,33448541,21730
"11316","ENSG00000185386","MAPK11","22",50702142,50709196,7054
"11317","ENSG00000185404","SP140L","2",231191899,231268447,76548
"11318","ENSG00000185418","TARSL2","15",102193801,102264807,71006
"11319","ENSG00000185420","SMYD3","1",245912642,246670614,757972
"11320","ENSG00000185432","METTL7A","12",51317255,51326300,9045
"11321","ENSG00000185437","SH3BGR","21",40817781,40887433,69652
"11322","ENSG00000185442","FAM174B","15",93160673,93353114,192441
"11323","ENSG00000185453","C19orf68","19",48673949,48700877,26928
"11324","ENSG00000185475","TMEM179B","11",62554887,62557877,2990
"11325","ENSG00000185477","GPRIN3","4",90157537,90229161,71624
"11326","ENSG00000185480","PARPBP","12",102513956,102591298,77342
"11327","ENSG00000185482","STAC3","12",57637236,57644976,7740
"11328","ENSG00000185483","ROR1","1",64239693,64647181,407488
"11329","ENSG00000185485","SDHAP1","3",195686619,195717189,30570
"11330","ENSG00000185499","MUC1","1",155158300,155162707,4407
"11331","ENSG00000185504","C17orf70","17",79506911,79520987,14076
"11332","ENSG00000185507","IRF7","11",612553,615999,3446
"11333","ENSG00000185513","L3MBTL1","20",42136320,42179590,43270
"11334","ENSG00000185515","BRCC3","X",154299695,154351349,51654
"11335","ENSG00000185532","PRKG1","10",52750945,54058110,1307165
"11336","ENSG00000185551","NR2F2","15",96869167,96883492,14325
"11337","ENSG00000185559","DLK1","14",101192042,101201539,9497
"11338","ENSG00000185565","LSAMP","3",115521235,117716095,2194860
"11339","ENSG00000185567","AHNAK2","14",105403581,105444694,41113
"11340","ENSG00000185585","OLFML2A","9",127539437,127577164,37727
"11341","ENSG00000185591","SP1","12",53773960,53810230,36270
"11342","ENSG00000185596","WASH3P","15",102501356,102516768,15412
"11343","ENSG00000185608","MRPL40","22",19419425,19423598,4173
"11344","ENSG00000185619","PCGF3","4",699537,764428,64891
"11345","ENSG00000185621","LMLN","3",197687071,197770591,83520
"11346","ENSG00000185624","P4HB","17",79801035,79818570,17535
"11347","ENSG00000185627","PSMD13","11",236546,252983,16437
"11348","ENSG00000185630","PBX1","1",164524821,164868533,343712
"11349","ENSG00000185634","SHC4","15",49115932,49255641,139709
"11350","ENSG00000185650","ZFP36L1","14",69254377,69263190,8813
"11351","ENSG00000185651","UBE2L3","22",21903736,21978323,74587
"11352","ENSG00000185652","NTF3","12",5541278,5630702,89424
"11353","ENSG00000185658","BRWD1","21",40556102,40693485,137383
"11354","ENSG00000185664","PMEL","12",56347889,56367101,19212
"11355","ENSG00000185668","POU3F1","1",38509523,38512450,2927
"11356","ENSG00000185670","ZBTB3","11",62515791,62521660,5869
"11357","ENSG00000185684","EP400NL","12",132568828,132613029,44201
"11358","ENSG00000185686","PRAME","22",22890123,22901768,11645
"11359","ENSG00000185697","MYBL1","8",67474410,67526482,52072
"11360","ENSG00000185710","","16",21890659,21930477,39818
"11361","ENSG00000185716","C16orf52","16",22018959,22098855,79896
"11362","ENSG00000185721","DRG1","22",31795509,31924726,129217
"11363","ENSG00000185722","ANKFY1","17",4067201,4167274,100073
"11364","ENSG00000185728","YTHDF3","8",64081112,64125346,44234
"11365","ENSG00000185730","ZNF696","8",144371846,144380231,8385
"11366","ENSG00000185736","ADARB2","10",1228073,1779670,551597
"11367","ENSG00000185737","NRG3","10",83635070,84746935,1111865
"11368","ENSG00000185742","C11orf87","11",109292846,109299840,6994
"11369","ENSG00000185745","IFIT1","10",91152303,91163745,11442
"11370","ENSG00000185753","CXorf38","X",40488285,40506819,18534
"11371","ENSG00000185760","KCNQ5","6",73331520,73908574,577054
"11372","ENSG00000185787","MORF4L1","15",79102829,79190475,87646
"11373","ENSG00000185798","WDR53","3",196281056,196295545,14489
"11374","ENSG00000185800","DMWD","19",46286205,46296060,9855
"11375","ENSG00000185803","SLC52A2","8",145577795,145584932,7137
"11376","ENSG00000185808","PIGP","21",38431470,38445470,14000
"11377","ENSG00000185811","IKZF1","7",50343720,50472799,129079
"11378","ENSG00000185813","PCYT2","17",79858841,79869340,10499
"11379","ENSG00000185818","NAT8L","4",2061239,2070816,9577
"11380","ENSG00000185825","BCAP31","X",152965947,152990152,24205
"11381","ENSG00000185829","ARL17A","17",44594068,44657088,63020
"11382","ENSG00000185838","GNB1L","22",19770747,19842462,71715
"11383","ENSG00000185842","DNAH14","1",225083964,225586996,503032
"11384","ENSG00000185864","NPIPB4","16",21845890,21892148,46258
"11385","ENSG00000185869","ZNF829","19",37379026,37407193,28167
"11386","ENSG00000185875","THNSL1","10",25305587,25315593,10006
"11387","ENSG00000185880","TRIM69","15",45021186,45060027,38841
"11388","ENSG00000185885","IFITM1","11",313506,315272,1766
"11389","ENSG00000185896","LAMP1","13",113951556,113977987,26431
"11390","ENSG00000185900","POMK","8",42948658,42978577,29919
"11391","ENSG00000185909","KLHDC8B","3",49209044,49213917,4873
"11392","ENSG00000185917","SETD4","21",37406839,37451687,44848
"11393","ENSG00000185920","PTCH1","9",98205262,98279339,74077
"11394","ENSG00000185924","RTN4RL1","17",1837971,1928639,90668
"11395","ENSG00000185928","PAGR1","16",29827285,29841948,14663
"11396","ENSG00000185942","NKAIN3","8",63161150,63912211,751061
"11397","ENSG00000185946","RNPC3","1",104068313,104097861,29548
"11398","ENSG00000185947","ZNF267","16",31885079,31928668,43589
"11399","ENSG00000185950","IRS2","13",110406184,110438915,32731
"11400","ENSG00000185963","BICD2","9",95473645,95527094,53449
"11401","ENSG00000185973","TMLHE","X",154719776,154899605,179829
"11402","ENSG00000185985","SLITRK2","X",144899350,144907360,8010
"11403","ENSG00000185986","SDHAP3","5",1568637,1594735,26098
"11404","ENSG00000185989","RASA3","13",114747194,114898086,150892
"11405","ENSG00000186001","LRCH3","3",197518097,197615307,97210
"11406","ENSG00000186010","NDUFA13","19",19626545,19644285,17740
"11407","ENSG00000186017","ZNF566","19",36936021,36980804,44783
"11408","ENSG00000186019","","19",44609616,44617298,7682
"11409","ENSG00000186020","ZNF529","19",37025676,37096178,70502
"11410","ENSG00000186026","ZNF284","19",44576297,44593766,17469
"11411","ENSG00000186047","DLEU7","13",51285144,51418075,132931
"11412","ENSG00000186051","TAL2","9",108424738,108425367,629
"11413","ENSG00000186063","AIDA","1",222841355,222886552,45197
"11414","ENSG00000186073","C15orf41","15",36871812,37102449,230637
"11415","ENSG00000186088","GSAP","7",76940068,77045717,105649
"11416","ENSG00000186094","AGBL4","1",48998527,50489585,1491058
"11417","ENSG00000186104","CYP2R1","11",14899553,14913798,14245
"11418","ENSG00000186105","LRRC70","5",61874562,61877275,2713
"11419","ENSG00000186106","ANKRD46","8",101521980,101572012,50032
"11420","ENSG00000186111","PIP5K1C","19",3630181,3700477,70296
"11421","ENSG00000186130","ZBTB6","9",125670335,125675609,5274
"11422","ENSG00000186132","C2orf76","2",120059801,120124404,64603
"11423","ENSG00000186141","POLR3C","1",145592605,145611025,18420
"11424","ENSG00000186153","WWOX","16",78133310,79246564,1113254
"11425","ENSG00000186162","CIDECP","3",10055932,10068049,12117
"11426","ENSG00000186166","CCDC84","11",118868852,118886501,17649
"11427","ENSG00000186174","BCL9L","11",118764584,118796317,31733
"11428","ENSG00000186184","POLR1D","13",28194903,28241548,46645
"11429","ENSG00000186185","KIF18B","17",43002077,43025082,23005
"11430","ENSG00000186187","ZNRF1","16",75032928,75144892,111964
"11431","ENSG00000186193","SAPCD2","9",139956581,139965040,8459
"11432","ENSG00000186205","MARC1","1",220960101,220987735,27634
"11433","ENSG00000186222","BLOC1S4","4",6717842,6719387,1545
"11434","ENSG00000186230","ZNF749","19",57946697,57956853,10156
"11435","ENSG00000186231","KLHL32","6",97372605,97588630,216025
"11436","ENSG00000186260","MKL2","16",14165178,14360630,195452
"11437","ENSG00000186272","ZNF17","19",57922531,57933307,10776
"11438","ENSG00000186275","NBPF12","1",146373546,146467744,94198
"11439","ENSG00000186280","KDM4D","11",94706845,94732682,25837
"11440","ENSG00000186283","TOR3A","1",179050512,179067158,16646
"11441","ENSG00000186297","GABRA5","15",27111510,27194354,82844
"11442","ENSG00000186298","PPP1CC","12",111157485,111180744,23259
"11443","ENSG00000186300","ZNF555","19",2841433,2860482,19049
"11444","ENSG00000186301","MST1P2","1",16972069,16976914,4845
"11445","ENSG00000186310","NAP1L3","X",92925929,92928567,2638
"11446","ENSG00000186312","CA5BP1","X",15693055,15721847,28792
"11447","ENSG00000186314","PRELID2","5",144851362,145214932,363570
"11448","ENSG00000186318","BACE1","11",117156402,117186975,30573
"11449","ENSG00000186340","THBS2","6",169615875,169654139,38264
"11450","ENSG00000186350","RXRA","9",137208944,137332431,123487
"11451","ENSG00000186354","C9orf47","9",91605778,91611055,5277
"11452","ENSG00000186364","NUDT17","1",145586115,145589439,3324
"11453","ENSG00000186376","ZNF75D","X",134382867,134478012,95145
"11454","ENSG00000186395","KRT10","17",38974369,38978847,4478
"11455","ENSG00000186409","CCDC30","1",42929001,43120335,191334
"11456","ENSG00000186416","NKRF","X",118722300,118739858,17558
"11457","ENSG00000186432","KPNA4","3",160212783,160283376,70593
"11458","ENSG00000186446","ZNF501","3",44771088,44778575,7487
"11459","ENSG00000186448","ZNF197","3",44626380,44689963,63583
"11460","ENSG00000186462","NAP1L2","X",72432135,72434684,2549
"11461","ENSG00000186468","RPS23","5",81569177,81574396,5219
"11462","ENSG00000186469","GNG2","14",52292913,52446060,153147
"11463","ENSG00000186470","BTN3A2","6",26365387,26378546,13159
"11464","ENSG00000186472","PCLO","7",82383329,82792246,408917
"11465","ENSG00000186479","RGS7BP","5",63802084,63908139,106055
"11466","ENSG00000186480","INSIG1","7",155089486,155101945,12459
"11467","ENSG00000186487","MYT1L","2",1792885,2335032,542147
"11468","ENSG00000186493","C5orf38","5",2752245,2755508,3263
"11469","ENSG00000186496","ZNF396","18",32946661,32957301,10640
"11470","ENSG00000186501","TMEM222","1",27648651,27662891,14240
"11471","ENSG00000186522","SEPT10","2",110300559,110371783,71224
"11472","ENSG00000186523","FAM86B1","8",12039605,12051642,12037
"11473","ENSG00000186530","XKR5","8",6666038,6693166,27128
"11474","ENSG00000186532","SMYD4","17",1682779,1733928,51149
"11475","ENSG00000186566","GPATCH8","17",42472652,42580798,108146
"11476","ENSG00000186567","CEACAM19","19",45165545,45187631,22086
"11477","ENSG00000186575","NF2","22",29999545,30094587,95042
"11478","ENSG00000186577","C6orf1","6",34214157,34217247,3090
"11479","ENSG00000186591","UBE2H","7",129470572,129592789,122217
"11480","ENSG00000186594","MIR22HG","17",1614805,1620468,5663
"11481","ENSG00000186603","HPDL","1",45792545,45794347,1802
"11482","ENSG00000186615","KTN1-AS1","14",55965996,56046828,80832
"11483","ENSG00000186625","KATNA1","6",149916009,149970108,54099
"11484","ENSG00000186635","ARAP1","11",72396114,72504644,108530
"11485","ENSG00000186638","KIF24","9",34252379,34329198,76819
"11486","ENSG00000186642","PDE2A","11",72287185,72385635,98450
"11487","ENSG00000186648","LRRC16B","14",24521206,24538937,17731
"11488","ENSG00000186654","PRR5","22",45064593,45133561,68968
"11489","ENSG00000186660","ZFP91","11",58346584,58388515,41931
"11490","ENSG00000186665","C17orf58","17",65987217,65989765,2548
"11491","ENSG00000186666","BCDIN3D","12",50231573,50236912,5339
"11492","ENSG00000186684","CYP27C1","2",127941696,127977654,35958
"11493","ENSG00000186687","LYRM7","5",130506503,130541119,34616
"11494","ENSG00000186704","DTX2P1","7",76607934,76673092,65158
"11495","ENSG00000186716","BCR","22",23521891,23660224,138333
"11496","ENSG00000186767","SPIN4","X",62567107,62571223,4116
"11497","ENSG00000186777","ZNF732","4",264464,299110,34646
"11498","ENSG00000186787","SPIN2B","X",57144984,57147980,2996
"11499","ENSG00000186792","HYAL3","3",50330262,50336899,6637
"11500","ENSG00000186806","VSIG10L","19",51834790,51845378,10588
"11501","ENSG00000186812","ZNF397","18",32820994,32847097,26103
"11502","ENSG00000186814","ZSCAN30","18",32831032,32870196,39164
"11503","ENSG00000186815","TPCN1","12",113658855,113736390,77535
"11504","ENSG00000186834","HEXIM1","17",43224684,43229468,4784
"11505","ENSG00000186842","LINC00846","21",33944548,33948191,3643
"11506","ENSG00000186854","TRABD2A","2",85048774,85134132,85358
"11507","ENSG00000186866","POFUT2","21",46683843,46707813,23970
"11508","ENSG00000186868","MAPT","17",43971748,44105700,133952
"11509","ENSG00000186871","ERCC6L","X",71424510,71458897,34387
"11510","ENSG00000186889","TMEM17","2",62727356,62739029,11673
"11511","ENSG00000186897","C1QL4","12",49726200,49730971,4771
"11512","ENSG00000186907","RTN4RL2","11",57228022,57245007,16985
"11513","ENSG00000186908","ZDHHC17","12",77157368,77247476,90108
"11514","ENSG00000186918","ZNF395","8",28203102,28260218,57116
"11515","ENSG00000186951","PPARA","22",46546424,46639653,93229
"11516","ENSG00000186952","TMEM232","5",109624934,110074657,449723
"11517","ENSG00000186976","EFCAB6","22",43924624,44208217,283593
"11518","ENSG00000186998","EMID1","22",29601840,29655586,53746
"11519","ENSG00000187024","PTRH1","9",130455257,130487152,31895
"11520","ENSG00000187049","TMEM216","11",61159159,61166335,7176
"11521","ENSG00000187051","RPS19BP1","22",39925098,39928860,3762
"11522","ENSG00000187068","C3orf70","3",184795838,184870802,74964
"11523","ENSG00000187079","TEAD1","11",12695969,12966298,270329
"11524","ENSG00000187091","PLCD1","3",38048987,38071253,22266
"11525","ENSG00000187097","ENTPD5","14",74424713,74486102,61389
"11526","ENSG00000187098","MITF","3",69788586,70017488,228902
"11527","ENSG00000187109","NAP1L1","12",76438670,76478813,40143
"11528","ENSG00000187118","CMC1","3",28283075,28366633,83558
"11529","ENSG00000187122","SLIT1","10",98757795,98945677,187882
"11530","ENSG00000187123","LYPD6","2",150186499,150330662,144163
"11531","ENSG00000187134","AKR1C1","10",4934796,5025475,90679
"11532","ENSG00000187145","MRPS21","1",150266289,150281414,15125
"11533","ENSG00000187147","RNF220","1",44870866,45117396,246530
"11534","ENSG00000187164","KIAA1598","10",118643742,118886097,242355
"11535","ENSG00000187187","ZNF546","19",40490041,40523514,33473
"11536","ENSG00000187189","TSPYL4","6",116571151,116575261,4110
"11537","ENSG00000187193","MT1X","16",56716336,56718108,1772
"11538","ENSG00000187210","GCNT1","9",79034752,79122332,87580
"11539","ENSG00000187231","SESTD1","2",179966419,180129517,163098
"11540","ENSG00000187239","FNBP1","9",132649466,132805473,156007
"11541","ENSG00000187240","DYNC2H1","11",102980160,103350591,370431
"11542","ENSG00000187244","BCAM","19",45312328,45324673,12345
"11543","ENSG00000187257","RSBN1L","7",77325760,77412339,86579
"11544","ENSG00000187260","WDR86","7",151072995,151107813,34818
"11545","ENSG00000187266","EPOR","19",11488236,11495018,6782
"11546","ENSG00000187323","DCC","18",49866542,51057784,1191242
"11547","ENSG00000187325","TAF9B","X",77385245,77395203,9958
"11548","ENSG00000187372","PCDHB13","5",140593509,140596993,3484
"11549","ENSG00000187391","MAGI2","7",77646393,79082890,1436497
"11550","ENSG00000187398","LUZP2","11",24518516,25104150,585634
"11551","ENSG00000187416","LHFPL3","7",103969104,104549001,579897
"11552","ENSG00000187446","CHP1","15",41523037,41574043,51006
"11553","ENSG00000187456","RDM1","17",34245070,34257777,12707
"11554","ENSG00000187475","HIST1H1T","6",26107640,26108364,724
"11555","ENSG00000187486","KCNJ11","11",17407406,17410878,3472
"11556","ENSG00000187498","COL4A1","13",110801318,110959496,158178
"11557","ENSG00000187514","PTMA","2",232571605,232578251,6646
"11558","ENSG00000187522","HSPA14","10",14880163,14913740,33577
"11559","ENSG00000187531","SIRT7","17",79869815,79879199,9384
"11560","ENSG00000187535","IFT140","16",1560428,1662111,101683
"11561","ENSG00000187553","CYP26C1","10",94821021,94828454,7433
"11562","ENSG00000187555","USP7","16",8985951,9058371,72420
"11563","ENSG00000187566","NHLRC1","6",18120718,18122851,2133
"11564","ENSG00000187595","ZNF385C","17",40177594,40217383,39789
"11565","ENSG00000187601","MAGEH1","X",55478538,55479998,1460
"11566","ENSG00000187605","TET3","2",74229840,74335303,105463
"11567","ENSG00000187607","","17",15602891,15640874,37983
"11568","ENSG00000187608","ISG15","1",948803,949920,1117
"11569","ENSG00000187609","EXD3","9",140201348,140317714,116366
"11570","ENSG00000187624","C17orf97","17",260118,273510,13392
"11571","ENSG00000187626","ZKSCAN4","6",28212401,28227011,14610
"11572","ENSG00000187627","RGPD1","2",87135076,87241104,106028
"11573","ENSG00000187630","DHRS4L2","14",24439148,24475617,36469
"11574","ENSG00000187634","SAMD11","1",860260,879955,19695
"11575","ENSG00000187650","VMAC","19",5904869,5910864,5995
"11576","ENSG00000187653","TMSB4XP8","4",91759652,91760263,611
"11577","ENSG00000187672","ERC2","3",55542336,56502391,960055
"11578","ENSG00000187676","B3GALTL","13",31774073,31906413,132340
"11579","ENSG00000187678","SPRY4","5",141689992,141706020,16028
"11580","ENSG00000187686","KRT18P59","11",124983057,124996677,13620
"11581","ENSG00000187695","","3",128628717,128690173,61456
"11582","ENSG00000187699","C2orf88","2",190744335,191068210,323875
"11583","ENSG00000187713","TMEM203","9",140098534,140100090,1556
"11584","ENSG00000187720","THSD4","15",71389291,72075722,686431
"11585","ENSG00000187735","TCEA1","8",54879112,54935089,55977
"11586","ENSG00000187736","NHEJ1","2",219940039,220025587,85548
"11587","ENSG00000187741","FANCA","16",89803957,89883065,79108
"11588","ENSG00000187742","SECISBP2","9",91933421,91974557,41136
"11589","ENSG00000187753","C9orf153","9",88835180,88874572,39392
"11590","ENSG00000187764","SEMA4D","9",91975702,92113045,137343
"11591","ENSG00000187772","LIN28B","6",105404923,105531207,126284
"11592","ENSG00000187778","MCRS1","12",49950327,49961936,11609
"11593","ENSG00000187790","FANCM","14",45605143,45670093,64950
"11594","ENSG00000187792","ZNF70","22",24083769,24093279,9510
"11595","ENSG00000187801","ZFP69B","1",40915774,40929390,13616
"11596","ENSG00000187815","ZFP69","1",40942887,40962015,19128
"11597","ENSG00000187824","TMEM220","17",10602332,10633633,31301
"11598","ENSG00000187837","HIST1H1C","6",26055968,26056699,731
"11599","ENSG00000187840","EIF4EBP1","8",37887859,37917883,30024
"11600","ENSG00000187860","CCDC157","22",30752624,30774647,22023
"11601","ENSG00000187866","FAM122A","9",71394964,71398609,3645
"11602","ENSG00000187867","PALM3","19",14164177,14169971,5794
"11603","ENSG00000187944","C2orf66","2",197669726,197675000,5274
"11604","ENSG00000187950","OVCH1","12",29565407,29650619,85212
"11605","ENSG00000187951","ARHGAP11B","15",30916697,31065196,148499
"11606","ENSG00000187953","PMS2CL","7",6749759,6793493,43734
"11607","ENSG00000187954","CYHR1","8",145674965,145691060,16095
"11608","ENSG00000187955","COL14A1","8",121072019,121384275,312256
"11609","ENSG00000187957","DNER","2",230222345,230579274,356929
"11610","ENSG00000187961","KLHL17","1",895967,901095,5128
"11611","ENSG00000187987","ZSCAN23","6",28399707,28411279,11572
"11612","ENSG00000187990","HIST1H2BG","6",26216428,26216872,444
"11613","ENSG00000187994","RINL","19",39358470,39368919,10449
"11614","ENSG00000188001","TPRG1","3",188665003,189043093,378090
"11615","ENSG00000188002","","5",1599035,1634120,35085
"11616","ENSG00000188010","MORN2","2",39103103,39156213,53110
"11617","ENSG00000188013","MEIS3P2","17",20492371,20494013,1642
"11618","ENSG00000188021","UBQLN2","X",56590026,56593443,3417
"11619","ENSG00000188026","RILPL1","12",123955925,124018265,62340
"11620","ENSG00000188033","ZNF490","19",12688775,12750912,62137
"11621","ENSG00000188042","ARL4C","2",235401685,235405697,4012
"11622","ENSG00000188060","RAB42","1",28918712,28921955,3243
"11623","ENSG00000188064","WNT7B","22",46316242,46373009,56767
"11624","ENSG00000188070","C11orf95","11",63527364,63536113,8749
"11625","ENSG00000188092","GPR89B","1",147400506,147465753,65247
"11626","ENSG00000188130","MAPK12","22",50683879,50700254,16375
"11627","ENSG00000188153","COL4A5","X",107683074,107940775,257701
"11628","ENSG00000188157","AGRN","1",955503,991496,35993
"11629","ENSG00000188158","NHS","X",17393543,17754114,360571
"11630","ENSG00000188167","TMPPE","3",33131913,33138293,6380
"11631","ENSG00000188171","ZNF626","19",20802867,20844402,41535
"11632","ENSG00000188177","ZC3H6","2",113033171,113097640,64469
"11633","ENSG00000188185","LINC00265","7",39773231,39832691,59460
"11634","ENSG00000188186","LAMTOR4","7",99746530,99753567,7037
"11635","ENSG00000188191","PRKAR1B","7",588834,767287,178453
"11636","ENSG00000188199","NUTM2B","10",81462983,81474437,11454
"11637","ENSG00000188206","HNRNPU-AS1","1",245003940,245018799,14859
"11638","ENSG00000188211","NCR3LG1","11",17373273,17398888,25615
"11639","ENSG00000188215","DCUN1D3","16",20866247,20911706,45459
"11640","ENSG00000188219","POTEE","2",131975882,132022965,47083
"11641","ENSG00000188227","ZNF793","19",37997841,38039664,41823
"11642","ENSG00000188229","TUBB4B","9",140135665,140138159,2494
"11643","ENSG00000188234","AGAP4","10",46321042,46349323,28281
"11644","ENSG00000188242","","5",466239,473213,6974
"11645","ENSG00000188243","COMMD6","13",76099350,76123575,24225
"11646","ENSG00000188266","HYKK","15",78799906,78829714,29808
"11647","ENSG00000188283","ZNF383","19",37708828,37734828,26000
"11648","ENSG00000188290","HES4","1",934342,935552,1210
"11649","ENSG00000188295","ZNF669","1",247263264,247267674,4410
"11650","ENSG00000188312","CENPP","9",95087766,95382815,295049
"11651","ENSG00000188313","PLSCR1","3",146232967,146262651,29684
"11652","ENSG00000188315","C3orf62","3",49306035,49315342,9307
"11653","ENSG00000188316","ENO4","10",118609023,118671299,62276
"11654","ENSG00000188321","ZNF559","19",9434448,9461838,27390
"11655","ENSG00000188322","SBK1","16",28303840,28335170,31330
"11656","ENSG00000188338","SLC38A3","3",50242679,50258411,15732
"11657","ENSG00000188342","GTF2F2","13",45694650,45858237,163587
"11658","ENSG00000188343","FAM92A1","8",94710789,94743755,32966
"11659","ENSG00000188352","FOCAD","9",20658308,20995954,337646
"11660","ENSG00000188368","PRR19","19",42806250,42814973,8723
"11661","ENSG00000188385","JAKMIP3","10",133918175,133998313,80138
"11662","ENSG00000188394","GPR21","9",125796806,125797975,1169
"11663","ENSG00000188419","CHM","X",85116185,85302566,186381
"11664","ENSG00000188428","BLOC1S5","6",8013800,8064647,50847
"11665","ENSG00000188483","IER5L","9",131937835,131940540,2705
"11666","ENSG00000188486","H2AFX","11",118964564,118966177,1613
"11667","ENSG00000188488","SERPINA5","14",95027779,95059457,31678
"11668","ENSG00000188493","C19orf54","19",41246761,41257458,10697
"11669","ENSG00000188501","LCTL","15",66839517,66858317,18800
"11670","ENSG00000188517","COL25A1","4",109731877,110223813,491936
"11671","ENSG00000188522","FAM83G","17",18872102,18908117,36015
"11672","ENSG00000188529","SRSF10","1",24291294,24307417,16123
"11673","ENSG00000188542","DUSP28","2",241499471,241503431,3960
"11674","ENSG00000188554","NBR1","17",41322498,41363708,41210
"11675","ENSG00000188559","RALGAPA2","20",20370196,20693131,322935
"11676","ENSG00000188566","NDOR1","9",140100147,140111461,11314
"11677","ENSG00000188573","FBLL1","5",167956121,167957639,1518
"11678","ENSG00000188580","NKAIN2","6",124125286,125146803,1021517
"11679","ENSG00000188582","PAQR9","3",142668006,142682178,14172
"11680","ENSG00000188596","C12orf55","12",96883349,97269333,385984
"11681","ENSG00000188599","NPIPP1","16",15198178,15225458,27280
"11682","ENSG00000188603","CLN3","16",28477983,28506896,28913
"11683","ENSG00000188610","FAM72B","1",120837756,120855681,17925
"11684","ENSG00000188611","ASAH2","10",51942538,52008370,65832
"11685","ENSG00000188612","SUMO2","17",73163408,73179078,15670
"11686","ENSG00000188613","NANOS1","10",120789228,120793854,4626
"11687","ENSG00000188636","LDOC1L","22",44888452,44894178,5726
"11688","ENSG00000188641","DPYD","1",97543299,98386605,843306
"11689","ENSG00000188643","S100A16","1",153579362,153585621,6259
"11690","ENSG00000188647","PTAR1","9",72324438,72374875,50437
"11691","ENSG00000188659","FAM154B","15",82555151,82577271,22120
"11692","ENSG00000188677","PARVB","22",44395091,44568829,173738
"11693","ENSG00000188690","UROS","10",127477146,127511817,34671
"11694","ENSG00000188706","ZDHHC9","X",128937264,128977885,40621
"11695","ENSG00000188707","ZBED6CL","7",150026938,150029808,2870
"11696","ENSG00000188725","SMIM15","5",60453536,60458301,4765
"11697","ENSG00000188730","VWC2","7",49813257,49961546,148289
"11698","ENSG00000188732","FAM221A","7",23719749,23742868,23119
"11699","ENSG00000188735","TMEM120B","12",122150658,122220907,70249
"11700","ENSG00000188738","FSIP2","2",186603355,186698017,94662
"11701","ENSG00000188739","RBM34","1",235294498,235324772,30274
"11702","ENSG00000188760","TMEM198","2",220408385,220415317,6932
"11703","ENSG00000188763","FZD9","7",72848109,72850450,2341
"11704","ENSG00000188785","ZNF548","19",57901218,57912786,11568
"11705","ENSG00000188786","MTF1","1",38275239,38325292,50053
"11706","ENSG00000188801","ZNF322P1","9",99959537,99961910,2373
"11707","ENSG00000188807","TMEM201","1",9648932,9674935,26003
"11708","ENSG00000188811","NHLRC3","13",39612443,39624246,11803
"11709","ENSG00000188818","ZDHHC11","5",710471,851101,140630
"11710","ENSG00000188825","LINC00910","17",41447213,41466567,19354
"11711","ENSG00000188827","SLX4","16",3631182,3661599,30417
"11712","ENSG00000188846","RPL14","3",40498783,40503861,5078
"11713","ENSG00000188848","BEND4","4",42112955,42154895,41940
"11714","ENSG00000188856","RPSAP47","8",81471105,81471992,887
"11715","ENSG00000188868","ZNF563","19",12428291,12444534,16243
"11716","ENSG00000188878","FBF1","17",73905655,73937221,31566
"11717","ENSG00000188895","MSL1","17",38278551,38293042,14491
"11718","ENSG00000188897","","16",11453702,11617444,163742
"11719","ENSG00000188906","LRRK2","12",40590546,40763087,172541
"11720","ENSG00000188916","FAM196A","10",128933694,128994422,60728
"11721","ENSG00000188917","TRMT2B","X",100264335,100307105,42770
"11722","ENSG00000188921","PTPLAD2","9",20995306,21031635,36329
"11723","ENSG00000188938","FAM120AOS","9",96208776,96215874,7098
"11724","ENSG00000188958","UTS2B","3",190984957,191048325,63368
"11725","ENSG00000188971","","2",69685129,69693664,8535
"11726","ENSG00000188976","NOC2L","1",879584,894689,15105
"11727","ENSG00000188985","DHFRP1","18",23749724,23751313,1589
"11728","ENSG00000188986","NELFB","9",140149625,140167998,18373
"11729","ENSG00000188987","HIST1H4D","6",26188938,26189304,366
"11730","ENSG00000188993","LRRC66","4",52859868,52883786,23918
"11731","ENSG00000188994","ZNF292","6",87862551,87973914,111363
"11732","ENSG00000188997","KCTD21","11",77882295,77899868,17573
"11733","ENSG00000189007","ADAT2","6",143743969,143771810,27841
"11734","ENSG00000189011","","7",74702428,74714647,12219
"11735","ENSG00000189014","FAM35DP","10",47379727,47420712,40985
"11736","ENSG00000189042","ZNF567","19",37178514,37218603,40089
"11737","ENSG00000189043","NDUFA4","7",10971578,10979883,8305
"11738","ENSG00000189046","ALKBH2","12",109525996,109531436,5440
"11739","ENSG00000189050","RNFT1","17",58029601,58042122,12521
"11740","ENSG00000189056","RELN","7",103112231,103629963,517732
"11741","ENSG00000189057","FAM111B","11",58874658,58894883,20225
"11742","ENSG00000189060","H1F0","22",38201114,38203442,2328
"11743","ENSG00000189067","LITAF","16",11641853,11730237,88384
"11744","ENSG00000189077","TMEM120A","7",75616155,75623977,7822
"11745","ENSG00000189079","ARID2","12",46123448,46301823,178375
"11746","ENSG00000189091","SF3B3","16",70557691,70608820,51129
"11747","ENSG00000189114","BLOC1S3","19",45682003,45685059,3056
"11748","ENSG00000189127","ANKRD34B","5",79852574,79866307,13733
"11749","ENSG00000189136","UBE2Q2P1","15",85070012,85114447,44435
"11750","ENSG00000189144","ZNF573","19",38226734,38307940,81206
"11751","ENSG00000189157","FAM47E","4",77135193,77204933,69740
"11752","ENSG00000189159","HN1","17",73131343,73164376,33033
"11753","ENSG00000189164","ZNF527","19",37861963,37883968,22005
"11754","ENSG00000189171","S100A13","1",153591263,153606568,15305
"11755","ENSG00000189180","ZNF33A","10",38299578,38354016,54438
"11756","ENSG00000189184","PCDH18","4",138440072,138453648,13576
"11757","ENSG00000189190","ZNF600","19",53267448,53290044,22596
"11758","ENSG00000189195","BTBD8","1",92545862,92613393,67531
"11759","ENSG00000189212","DPY19L2P1","7",35119601,35225934,106333
"11760","ENSG00000189221","MAOA","X",43515467,43606068,90601
"11761","ENSG00000189223","PAX8-AS1","2",113969099,114034158,65059
"11762","ENSG00000189227","C15orf61","15",67813406,67819628,6222
"11763","ENSG00000189229","","3",6532166,6777816,245650
"11764","ENSG00000189241","TSPYL1","6",116597741,116601066,3325
"11765","ENSG00000189266","PNRC2","1",24285599,24289952,4353
"11766","ENSG00000189283","FHIT","3",59735036,61237133,1502097
"11767","ENSG00000189292","FAM150B","2",279558,288851,9293
"11768","ENSG00000189298","ZKSCAN3","6",28317691,28336947,19256
"11769","ENSG00000189306","RRP7A","22",42905974,42915808,9834
"11770","ENSG00000189308","LIN54","4",83831126,83934079,102953
"11771","ENSG00000189319","FAM53B","10",126307861,126432838,124977
"11772","ENSG00000189337","KAZN","1",14925200,15444539,519339
"11773","ENSG00000189339","SLC35E2B","1",1592939,1624167,31228
"11774","ENSG00000189343","RPS2P46","17",19349246,19350169,923
"11775","ENSG00000189362","TMEM194B","2",191369068,191399448,30380
"11776","ENSG00000189367","KIAA0408","6",127761488,127780536,19048
"11777","ENSG00000189369","GSPT2","X",51486481,51489324,2843
"11778","ENSG00000189376","C8orf76","8",124232196,124253638,21442
"11779","ENSG00000189403","HMGB1","13",31032884,31191734,158850
"11780","ENSG00000189410","SH2D5","1",21046225,21059330,13105
"11781","ENSG00000189423","USP32P3","17",20318860,20334321,15461
"11782","ENSG00000196072","BLOC1S2","10",102033713,102046469,12756
"11783","ENSG00000196074","SYCP2","20",58438618,58508710,70092
"11784","ENSG00000196081","ZNF724P","19",23404401,23433192,28791
"11785","ENSG00000196083","IL1RAP","3",190231840,190375843,144003
"11786","ENSG00000196092","PAX5","9",36833272,37034103,200831
"11787","ENSG00000196110","ZNF699","19",9404951,9420514,15563
"11788","ENSG00000196116","TDRD7","9",100174232,100258407,84175
"11789","ENSG00000196118","C16orf93","16",30768744,30774031,5287
"11790","ENSG00000196123","KIAA0895L","16",67209505,67217943,8438
"11791","ENSG00000196132","MYT1","20",62783144,62873604,90460
"11792","ENSG00000196141","SPATS2L","2",201170604,201346986,176382
"11793","ENSG00000196150","ZNF250","8",146076632,146127553,50921
"11794","ENSG00000196151","WDSUB1","2",160092304,160143310,51006
"11795","ENSG00000196152","ZNF79","9",130186661,130207651,20990
"11796","ENSG00000196154","S100A4","1",153516089,153522612,6523
"11797","ENSG00000196155","PLEKHG4","16",67311413,67323402,11989
"11798","ENSG00000196159","FAT4","4",126237554,126414087,176533
"11799","ENSG00000196169","KIF19","17",72322349,72351959,29610
"11800","ENSG00000196172","ZNF681","19",23921997,23941693,19696
"11801","ENSG00000196176","HIST1H4A","6",26021907,26022278,371
"11802","ENSG00000196177","ACADSB","10",124768495,124817827,49332
"11803","ENSG00000196182","STK40","1",36805225,36851497,46272
"11804","ENSG00000196187","TMEM63A","1",226033237,226070069,36832
"11805","ENSG00000196189","SEMA4A","1",156117157,156147543,30386
"11806","ENSG00000196199","MPHOSPH8","13",20207788,20247599,39811
"11807","ENSG00000196204","RNF216P1","7",5013619,5080306,66687
"11808","ENSG00000196205","EEF1A1P5","9",135894816,135896553,1737
"11809","ENSG00000196208","GREB1","2",11674242,11782914,108672
"11810","ENSG00000196214","ZNF766","19",52772824,52795977,23153
"11811","ENSG00000196218","RYR1","19",38924339,39078204,153865
"11812","ENSG00000196220","SRGAP3","3",9022275,9404737,382462
"11813","ENSG00000196226","HIST1H2BB","6",26043455,26043885,430
"11814","ENSG00000196227","FAM217B","20",58508819,58523735,14916
"11815","ENSG00000196230","TUBB","6",30687978,30693203,5225
"11816","ENSG00000196233","LCOR","10",98592017,98740800,148783
"11817","ENSG00000196235","SUPT5H","19",39926796,39967310,40514
"11818","ENSG00000196236","XPNPEP3","22",41253081,41363838,110757
"11819","ENSG00000196247","ZNF107","7",64126511,64171404,44893
"11820","ENSG00000196262","PPIA","7",44836279,44864163,27884
"11821","ENSG00000196263","ZNF471","19",57019212,57041590,22378
"11822","ENSG00000196267","ZNF836","19",52657117,52674896,17779
"11823","ENSG00000196268","ZNF493","19",21579921,21610375,30454
"11824","ENSG00000196275","GTF2IRD2","7",74210483,74267847,57364
"11825","ENSG00000196277","GRM7","3",6811688,7783215,971527
"11826","ENSG00000196284","SUPT3H","6",44777054,45345690,568636
"11827","ENSG00000196290","NIF3L1","2",201754050,201768655,14605
"11828","ENSG00000196295","","7",30555925,30634425,78500
"11829","ENSG00000196296","ATP2A1","16",28889726,28915830,26104
"11830","ENSG00000196305","IARS","9",94972489,95056038,83549
"11831","ENSG00000196312","HIATL2","9",99660348,99775862,115514
"11832","ENSG00000196313","POM121","7",72349936,72421979,72043
"11833","ENSG00000196323","ZBTB44","11",130096572,130184581,88009
"11834","ENSG00000196331","HIST1H2BO","6",27861203,27861669,466
"11835","ENSG00000196335","STK31","7",23749786,23872132,122346
"11836","ENSG00000196338","NLGN3","X",70364681,70391051,26370
"11837","ENSG00000196345","ZKSCAN7","3",44596685,44624975,28290
"11838","ENSG00000196353","CPNE4","3",131252399,132004254,751855
"11839","ENSG00000196355","","4",38628029,38666430,38401
"11840","ENSG00000196357","ZNF565","19",36673188,36737159,63971
"11841","ENSG00000196358","NTNG2","9",135037334,135119921,82587
"11842","ENSG00000196361","ELAVL3","19",11562141,11591861,29720
"11843","ENSG00000196363","WDR5","9",137000487,137025093,24606
"11844","ENSG00000196365","LONP1","19",5691845,5720583,28738
"11845","ENSG00000196367","TRRAP","7",98475556,98610866,135310
"11846","ENSG00000196368","NUDT11","X",51232863,51239448,6585
"11847","ENSG00000196369","SRGAP2B","1",143913615,144094424,180809
"11848","ENSG00000196371","FUT4","11",94277017,94283063,6046
"11849","ENSG00000196372","ASB13","10",5680830,5708558,27728
"11850","ENSG00000196374","HIST1H2BM","6",27782822,27783267,445
"11851","ENSG00000196376","SLC35F1","6",118228689,118638839,410150
"11852","ENSG00000196378","ZNF34","8",145998499,146012730,14231
"11853","ENSG00000196381","ZNF781","19",38158652,38183223,24571
"11854","ENSG00000196387","ZNF140","12",133656424,133684130,27706
"11855","ENSG00000196391","ZNF774","15",90895477,90909324,13847
"11856","ENSG00000196396","PTPN1","20",49126891,49201299,74408
"11857","ENSG00000196405","EVL","14",100437786,100610573,172787
"11858","ENSG00000196409","ZNF658","9",40760700,40836415,75715
"11859","ENSG00000196411","EPHB4","7",100400187,100425121,24934
"11860","ENSG00000196417","ZNF765","19",53893046,53930574,37528
"11861","ENSG00000196418","ZNF124","1",247285277,247335318,50041
"11862","ENSG00000196419","XRCC6","22",42017123,42060044,42921
"11863","ENSG00000196421","LINC00176","20",62665697,62671315,5618
"11864","ENSG00000196422","PPP1R26","9",138370925,138380739,9814
"11865","ENSG00000196428","TSC22D2","3",150126122,150184218,58096
"11866","ENSG00000196436","NPIPB15","16",74411776,74425978,14202
"11867","ENSG00000196437","ZNF569","19",37902057,37960177,58120
"11868","ENSG00000196440","ARMCX4","X",100673275,100788446,115171
"11869","ENSG00000196449","YRDC","1",38268616,38273857,5241
"11870","ENSG00000196453","ZNF777","7",149128454,149158214,29760
"11871","ENSG00000196455","PIK3R4","3",130397779,130465673,67894
"11872","ENSG00000196456","ZNF775","7",150065879,150109558,43679
"11873","ENSG00000196458","ZNF605","12",133498019,133532892,34873
"11874","ENSG00000196459","TRAPPC2","X",13730363,13752754,22391
"11875","ENSG00000196465","MYL6B","12",56546040,56553431,7391
"11876","ENSG00000196466","ZNF799","19",12500830,12512085,11255
"11877","ENSG00000196470","SIAH1","16",48390275,48482313,92038
"11878","ENSG00000196476","C20orf96","20",251504,271390,19886
"11879","ENSG00000196482","ESRRG","1",216676588,217311097,634509
"11880","ENSG00000196497","IPO4","14",24649425,24658170,8745
"11881","ENSG00000196498","NCOR2","12",124808961,125052135,243174
"11882","ENSG00000196504","PRPF40A","2",153508107,153574511,66404
"11883","ENSG00000196505","GDAP2","1",118406107,118472253,66146
"11884","ENSG00000196507","TCEAL3","X",102862379,102884618,22239
"11885","ENSG00000196510","ANAPC7","12",110810705,110841535,30830
"11886","ENSG00000196511","TPK1","7",144149034,144533488,384454
"11887","ENSG00000196517","SLC6A9","1",44457172,44497139,39967
"11888","ENSG00000196526","AFAP1","4",7760441,7941653,181212
"11889","ENSG00000196531","NACA","12",57106212,57125412,19200
"11890","ENSG00000196532","HIST1H3C","6",26045639,26046097,458
"11891","ENSG00000196535","MYO18A","17",27400528,27507430,106902
"11892","ENSG00000196544","C17orf59","17",8091652,8093564,1912
"11893","ENSG00000196547","MAN2A2","15",91445448,91465814,20366
"11894","ENSG00000196549","MME","3",154741913,154901497,159584
"11895","ENSG00000196550","FAM72A","1",206136916,206155151,18235
"11896","ENSG00000196557","CACNA1H","16",1203241,1271771,68530
"11897","ENSG00000196559","LINC00610","11",36290834,36294909,4075
"11898","ENSG00000196562","SULF2","20",46285092,46415360,130268
"11899","ENSG00000196569","LAMA2","6",129204342,129837714,633372
"11900","ENSG00000196576","PLXNB2","22",50713408,50746056,32648
"11901","ENSG00000196581","AJAP1","1",4714792,4852594,137802
"11902","ENSG00000196584","XRCC2","7",152341864,152373250,31386
"11903","ENSG00000196586","MYO6","6",76458909,76629254,170345
"11904","ENSG00000196588","MKL1","22",40806285,41032706,226421
"11905","ENSG00000196591","HDAC2","6",114254192,114332472,78280
"11906","ENSG00000196597","ZNF782","9",99578754,99637905,59151
"11907","ENSG00000196604","POTEF","2",130831108,130886795,55687
"11908","ENSG00000196605","ZNF846","19",9862669,9903856,41187
"11909","ENSG00000196622","RIMBP3","22",20456003,20461786,5783
"11910","ENSG00000196628","TCF4","18",52889562,53332018,442456
"11911","ENSG00000196632","WNK3","X",54219256,54385075,165819
"11912","ENSG00000196636","ACN9","7",96745902,96811075,65173
"11913","ENSG00000196642","RABL6","9",139702374,139735639,33265
"11914","ENSG00000196646","ZNF136","19",12273879,12300064,26185
"11915","ENSG00000196648","GOLGA6L20","15",83098710,83108085,9375
"11916","ENSG00000196652","ZKSCAN5","7",99102274,99132323,30049
"11917","ENSG00000196653","ZNF502","3",44754135,44765323,11188
"11918","ENSG00000196655","TRAPPC4","11",118889142,118896164,7022
"11919","ENSG00000196656","","4",114135137,114138326,3189
"11920","ENSG00000196659","TTC30B","2",178413726,178417742,4016
"11921","ENSG00000196660","SLC30A10","1",219858769,220131989,273220
"11922","ENSG00000196663","TECPR2","14",102829300,102968818,139518
"11923","ENSG00000196668","LINC00173","12",116971227,116974323,3096
"11924","ENSG00000196670","ZFP62","5",180274611,180288286,13675
"11925","ENSG00000196678","ERI2","16",20791515,20911671,120156
"11926","ENSG00000196683","TOMM7","7",22852251,22862470,10219
"11927","ENSG00000196689","TRPV1","17",3468738,3500392,31654
"11928","ENSG00000196693","ZNF33B","10",43084555,43133992,49437
"11929","ENSG00000196696","PDXDC2P","16",70010200,70099851,89651
"11930","ENSG00000196700","ZNF512B","20",62588055,62680113,92058
"11931","ENSG00000196704","AMZ2","17",66243715,66253297,9582
"11932","ENSG00000196705","ZNF431","19",21324827,21373034,48207
"11933","ENSG00000196712","NF1","17",29421945,29709134,287189
"11934","ENSG00000196715","VKORC1L1","7",65338254,65424550,86296
"11935","ENSG00000196724","ZNF418","19",58433252,58446761,13509
"11936","ENSG00000196730","DAPK1","9",90112143,90323548,211405
"11937","ENSG00000196739","COL27A1","9",116917840,117074791,156951
"11938","ENSG00000196741","CXorf24","X",47342970,47344207,1237
"11939","ENSG00000196743","GM2A","5",150591711,150650001,58290
"11940","ENSG00000196747","HIST1H2AI","6",27775899,27776429,530
"11941","ENSG00000196756","SNHG17","20",37049235,37063996,14761
"11942","ENSG00000196757","ZNF700","19",12035883,12061588,25705
"11943","ENSG00000196767","POU3F4","X",82763269,82764775,1506
"11944","ENSG00000196776","CD47","3",107762145,107809872,47727
"11945","ENSG00000196781","TLE1","9",84198598,84304220,105622
"11946","ENSG00000196782","MAML3","4",140637907,141075338,437431
"11947","ENSG00000196787","HIST1H2AG","6",27100832,27103070,2238
"11948","ENSG00000196792","STRN3","14",31363005,31495607,132602
"11949","ENSG00000196793","ZNF239","10",44051792,44070066,18274
"11950","ENSG00000196810","CTBP1-AS2","4",1243088,1282079,38991
"11951","ENSG00000196812","ZSCAN16","6",28092338,28097860,5522
"11952","ENSG00000196814","MVB12B","9",129089128,129269320,180192
"11953","ENSG00000196821","C6orf106","6",34555065,34664636,109571
"11954","ENSG00000196839","ADA","20",43248163,43280874,32711
"11955","ENSG00000196843","ARID5A","2",97202480,97218375,15895
"11956","ENSG00000196850","PPTC7","12",110969120,111021125,52005
"11957","ENSG00000196865","NHLRC2","10",115614420,115676953,62533
"11958","ENSG00000196867","ZFP28","19",57050317,57068169,17852
"11959","ENSG00000196873","CBWD3","9",70856397,70914929,58532
"11960","ENSG00000196876","SCN8A","12",51984050,52206648,222598
"11961","ENSG00000196890","HIST3H2BB","1",228645808,228646259,451
"11962","ENSG00000196911","KPNA5","6",117002350,117063029,60679
"11963","ENSG00000196912","ANKRD36B","2",98108978,98206428,97450
"11964","ENSG00000196914","ARHGEF12","11",120207787,120360645,152858
"11965","ENSG00000196922","ZNF252P","8",146198975,146228281,29306
"11966","ENSG00000196923","PDLIM7","5",176910395,176924607,14212
"11967","ENSG00000196924","FLNA","X",153576892,153603006,26114
"11968","ENSG00000196932","TMEM26","10",63166401,63213208,46807
"11969","ENSG00000196935","SRGAP1","12",64238073,64541613,303540
"11970","ENSG00000196937","FAM3C","7",120988905,121036418,47513
"11971","ENSG00000196943","NOP9","14",24769068,24778330,9262
"11972","ENSG00000196950","SLC39A10","2",196440701,196602426,161725
"11973","ENSG00000196951","","4",141204878,141294535,89657
"11974","ENSG00000196961","AP2A1","19",50270225,50310370,40145
"11975","ENSG00000196963","PCDHB16","5",140560980,140565793,4813
"11976","ENSG00000196966","HIST1H3E","6",26225383,26225844,461
"11977","ENSG00000196967","ZNF585A","19",37597636,37663643,66007
"11978","ENSG00000196968","FUT11","10",75532049,75540009,7960
"11979","ENSG00000196972","LINC00087","X",134229058,134232664,3606
"11980","ENSG00000196975","ANXA4","2",69871557,70053596,182039
"11981","ENSG00000196976","LAGE3","X",153706028,153707596,1568
"11982","ENSG00000196981","WDR5B","3",122130715,122134882,4167
"11983","ENSG00000196998","WDR45","X",48929385,48958108,28723
"11984","ENSG00000197006","METTL9","16",21608539,21668794,60255
"11985","ENSG00000197008","ZNF138","7",64254766,64294054,39288
"11986","ENSG00000197013","ZNF429","19",21679484,21739072,59588
"11987","ENSG00000197016","ZNF470","19",57078880,57100279,21399
"11988","ENSG00000197019","SERTAD1","19",40927499,40931932,4433
"11989","ENSG00000197020","ZNF100","19",21905568,21950430,44862
"11990","ENSG00000197021","CXorf40B","X",149097745,149107029,9284
"11991","ENSG00000197024","ZNF398","7",148823508,148880116,56608
"11992","ENSG00000197037","ZSCAN25","7",99214569,99230030,15461
"11993","ENSG00000197043","ANXA6","5",150480273,150537443,57170
"11994","ENSG00000197044","ZNF441","19",11877815,11894893,17078
"11995","ENSG00000197045","GMFB","14",54941202,54955914,14712
"11996","ENSG00000197050","ZNF420","19",37498759,37621216,122457
"11997","ENSG00000197054","ZNF763","19",12035890,12091196,55306
"11998","ENSG00000197056","ZMYM1","1",35525387,35581460,56073
"11999","ENSG00000197061","HIST1H4C","6",26104104,26104518,414
"12000","ENSG00000197062","","6",28234788,28245974,11186
"12001","ENSG00000197063","MAFG","17",79876146,79885590,9444
"12002","ENSG00000197070","ARRDC1","9",140500106,140509812,9706
"12003","ENSG00000197077","KIAA1671","22",25348697,25593415,244718
"12004","ENSG00000197081","IGF2R","6",160390131,160534539,144408
"12005","ENSG00000197083","ZNF300P1","5",150310207,150325851,15644
"12006","ENSG00000197093","GAL3ST4","7",99756867,99766373,9506
"12007","ENSG00000197102","DYNC1H1","14",102430865,102517129,86264
"12008","ENSG00000197106","SLC6A17","1",110693108,110744824,51716
"12009","ENSG00000197111","PCBP2","12",53835525,53874946,39421
"12010","ENSG00000197114","ZGPAT","20",62338817,62367494,28677
"12011","ENSG00000197119","SLC25A29","14",100757448,100772884,15436
"12012","ENSG00000197121","PGAP1","2",197697728,197792520,94792
"12013","ENSG00000197122","SRC","20",35973088,36034453,61365
"12014","ENSG00000197124","ZNF682","19",20107867,20150315,42448
"12015","ENSG00000197128","ZNF772","19",57978031,57988938,10907
"12016","ENSG00000197136","PCNXL3","11",65383244,65404910,21666
"12017","ENSG00000197140","ADAM32","8",38964509,39142430,177921
"12018","ENSG00000197146","","6",167357853,167360151,2298
"12019","ENSG00000197147","LRRC8B","1",89990395,90063423,73028
"12020","ENSG00000197150","ABCB8","7",150725510,150744869,19359
"12021","ENSG00000197153","HIST1H3J","6",27858093,27860884,2791
"12022","ENSG00000197157","SND1","7",127292234,127732661,440427
"12023","ENSG00000197162","ZNF785","16",30585061,30597092,12031
"12024","ENSG00000197170","PSMD12","17",65334032,65362743,28711
"12025","ENSG00000197181","PIWIL2","8",22132810,22215076,82266
"12026","ENSG00000197183","C20orf112","20",31030862,31172876,142014
"12027","ENSG00000197191","C9orf169","9",140119087,140120763,1676
"12028","ENSG00000197208","SLC22A4","5",131630136,131679899,49763
"12029","ENSG00000197217","ENTPD4","8",23243296,23315208,71912
"12030","ENSG00000197223","C1D","2",68268262,68338080,69818
"12031","ENSG00000197226","TBC1D9B","5",179289066,179334859,45793
"12032","ENSG00000197238","HIST1H4J","6",27791884,27792257,373
"12033","ENSG00000197256","KANK2","19",11274943,11308467,33524
"12034","ENSG00000197258","EIF4BP6","7",104308196,104310023,1827
"12035","ENSG00000197265","GTF2E2","8",30435835,30515768,79933
"12036","ENSG00000197275","RAD54B","8",95384188,95487337,103149
"12037","ENSG00000197279","ZNF165","6",28048753,28057341,8588
"12038","ENSG00000197283","SYNGAP1","6",33387847,33421466,33619
"12039","ENSG00000197291","RAMP2-AS1","17",40905932,40913275,7343
"12040","ENSG00000197296","FITM2","20",42931478,42939809,8331
"12041","ENSG00000197299","BLM","15",91260558,91358859,98301
"12042","ENSG00000197302","ZNF720","16",31724550,31806190,81640
"12043","ENSG00000197312","DDI2","1",15943995,15995539,51544
"12044","ENSG00000197321","SVIL","10",29746267,30025710,279443
"12045","ENSG00000197323","TRIM33","1",114935399,115053781,118382
"12046","ENSG00000197324","LRP10","14",23340822,23350789,9967
"12047","ENSG00000197329","PELI1","2",64319786,64371588,51802
"12048","ENSG00000197332","ZNF833P","19",11750591,11797382,46791
"12049","ENSG00000197343","ZNF655","7",99156029,99174076,18047
"12050","ENSG00000197345","MRPL21","11",68658744,68671303,12559
"12051","ENSG00000197362","ZNF786","7",148766735,148787874,21139
"12052","ENSG00000197363","ZNF517","8",146024261,146036554,12293
"12053","ENSG00000197372","ZNF675","19",23708433,23870022,161589
"12054","ENSG00000197375","SLC22A5","5",131705444,131731306,25862
"12055","ENSG00000197380","DACT3","19",47150869,47164395,13526
"12056","ENSG00000197381","ADARB1","21",46493768,46646478,152710
"12057","ENSG00000197386","HTT","4",3076408,3245676,169268
"12058","ENSG00000197406","DIO3","14",102027688,102029789,2101
"12059","ENSG00000197409","HIST1H3D","6",26197068,26199521,2453
"12060","ENSG00000197415","VEPH1","3",156977531,157251408,273877
"12061","ENSG00000197417","SHPK","17",3511556,3539616,28060
"12062","ENSG00000197429","IPP","1",46159996,46216322,56326
"12063","ENSG00000197442","MAP3K5","6",136878185,137113656,235471
"12064","ENSG00000197444","OGDHL","10",50942689,50970425,27736
"12065","ENSG00000197448","GSTK1","7",142941186,142967947,26761
"12066","ENSG00000197451","HNRNPAB","5",177631508,177638164,6656
"12067","ENSG00000197457","STMN3","20",62271061,62284780,13719
"12068","ENSG00000197459","HIST1H2BH","6",26251879,26252303,424
"12069","ENSG00000197467","COL13A1","10",71561644,71724031,162387
"12070","ENSG00000197472","ZNF695","1",247108849,247171395,62546
"12071","ENSG00000197479","PCDHB11","5",140579183,140582618,3435
"12072","ENSG00000197483","ZNF628","19",55987699,55995854,8155
"12073","ENSG00000197496","SLC2A10","20",45338126,45364965,26839
"12074","ENSG00000197497","ZNF665","19",53662466,53696639,34173
"12075","ENSG00000197498","RPF2","6",111303218,111349466,46248
"12076","ENSG00000197502","","14",50300810,50311552,10742
"12077","ENSG00000197530","MIB2","1",1550795,1565990,15195
"12078","ENSG00000197535","MYO5A","15",52599480,52821247,221767
"12079","ENSG00000197536","C5orf56","5",131746328,131811736,65408
"12080","ENSG00000197548","ATG7","3",11313995,11599139,285144
"12081","ENSG00000197550","","9",69830288,69848759,18471
"12082","ENSG00000197555","SIPA1L1","14",71787166,72207946,420780
"12083","ENSG00000197557","TTC30A","2",178477720,178483694,5974
"12084","ENSG00000197558","SSPO","7",149473131,149531068,57937
"12085","ENSG00000197562","RAB40C","16",639357,679272,39915
"12086","ENSG00000197563","PIGN","18",59710800,59854351,143551
"12087","ENSG00000197565","COL4A6","X",107386780,107682727,295947
"12088","ENSG00000197566","ZNF624","17",16524051,16557170,33119
"12089","ENSG00000197568","HHLA3","1",70820488,70851022,30534
"12090","ENSG00000197579","TOPORS","9",32540542,32552551,12009
"12091","ENSG00000197580","BCO2","11",112046190,112095422,49232
"12092","ENSG00000197586","ENTPD6","20",25176329,25207365,31036
"12093","ENSG00000197594","ENPP1","6",132129156,132216295,87139
"12094","ENSG00000197601","FAR1","11",13690217,13753893,63676
"12095","ENSG00000197603","C5orf42","5",37106330,37249530,143200
"12096","ENSG00000197604","","10",72194585,72196314,1729
"12097","ENSG00000197608","ZNF841","19",52567719,52599018,31299
"12098","ENSG00000197619","ZNF615","19",52494585,52511483,16898
"12099","ENSG00000197620","CXorf40A","X",148621900,148632055,10155
"12100","ENSG00000197622","CDC42SE1","1",151023447,151042801,19354
"12101","ENSG00000197635","DPP4","2",162848751,162931052,82301
"12102","ENSG00000197647","ZNF433","19",12125547,12146556,21009
"12103","ENSG00000197681","TBC1D3","17",36337711,36358166,20455
"12104","ENSG00000197694","SPTAN1","9",131314866,131395941,81075
"12105","ENSG00000197696","NMB","15",85198360,85201794,3434
"12106","ENSG00000197697","HIST1H2BE","6",26183958,26184454,496
"12107","ENSG00000197701","ZNF595","4",53179,88099,34920
"12108","ENSG00000197702","PARVA","11",12398732,12552348,153616
"12109","ENSG00000197705","KLHL14","18",30252634,30353025,100391
"12110","ENSG00000197712","FAM114A1","4",38869298,38947360,78062
"12111","ENSG00000197713","RPE","2",210867289,210886300,19011
"12112","ENSG00000197714","ZNF460","19",57791419,57804937,13518
"12113","ENSG00000197724","PHF2","9",96338689,96441869,103180
"12114","ENSG00000197728","RPS26","12",56435637,56438116,2479
"12115","ENSG00000197744","PTMAP2","5",118309491,118309817,326
"12116","ENSG00000197746","PSAP","10",73576055,73611126,35071
"12117","ENSG00000197747","S100A10","1",151955391,151966866,11475
"12118","ENSG00000197748","WDR96","10",105889646,105992120,102474
"12119","ENSG00000197756","RPL37A","2",217362912,217443903,80991
"12120","ENSG00000197763","TXNRD3","3",126290622,126373998,83376
"12121","ENSG00000197769","MAP1LC3C","1",242158792,242162375,3583
"12122","ENSG00000197771","MCMBP","10",121588972,121652068,63096
"12123","ENSG00000197774","EME2","16",1823208,1831709,8501
"12124","ENSG00000197776","KLHDC1","14",50159823,50219870,60047
"12125","ENSG00000197779","ZNF81","X",47696301,47861960,165659
"12126","ENSG00000197780","TAF13","1",109605108,109618624,13516
"12127","ENSG00000197782","ZNF780A","19",40575059,40596845,21786
"12128","ENSG00000197785","ATAD3A","1",1447531,1470067,22536
"12129","ENSG00000197798","FAM118B","11",126081309,126132881,51572
"12130","ENSG00000197808","ZNF461","19",37128094,37157755,29661
"12131","ENSG00000197813","","19",49834874,49843865,8991
"12132","ENSG00000197816","CCDC180","9",100000765,100140806,140041
"12133","ENSG00000197818","SLC9A8","20",48429250,48508779,79529
"12134","ENSG00000197822","OCLN","5",68788119,68853931,65812
"12135","ENSG00000197837","HIST4H4","12",14920933,14924065,3132
"12136","ENSG00000197841","ZNF181","19",35225060,35233777,8717
"12137","ENSG00000197846","HIST1H2BF","6",26199748,26200942,1194
"12138","ENSG00000197852","FAM212B","1",112223252,112298446,75194
"12139","ENSG00000197857","ZNF44","19",12335501,12405702,70201
"12140","ENSG00000197858","GPAA1","8",145137493,145141119,3626
"12141","ENSG00000197860","SGTB","5",64961755,65018862,57107
"12142","ENSG00000197863","ZNF790","19",37308330,37341689,33359
"12143","ENSG00000197872","FAM49A","2",16730727,16847599,116872
"12144","ENSG00000197879","MYO1C","17",1367392,1396106,28714
"12145","ENSG00000197885","NKIRAS1","3",23933151,23988082,54931
"12146","ENSG00000197892","KIF13B","8",28924796,29120641,195845
"12147","ENSG00000197894","ADH5","4",99992132,100009952,17820
"12148","ENSG00000197903","HIST1H2BK","6",27106073,27114619,8546
"12149","ENSG00000197905","TEAD4","12",3068496,3149839,81343
"12150","ENSG00000197912","SPG7","16",89557325,89624176,66851
"12151","ENSG00000197914","HIST1H4K","6",27798952,27799305,353
"12152","ENSG00000197921","HES5","1",2460184,2461684,1500
"12153","ENSG00000197927","C2orf27A","2",132479948,132524973,45025
"12154","ENSG00000197928","ZNF677","19",53731577,53758151,26574
"12155","ENSG00000197930","ERO1L","14",53106634,53162618,55984
"12156","ENSG00000197932","F8A1","X",154114635,154116335,1700
"12157","ENSG00000197933","ZNF823","19",11832080,11849824,17744
"12158","ENSG00000197935","ZNF311","6",28962562,28973093,10531
"12159","ENSG00000197937","ZNF347","19",53627325,53662328,35003
"12160","ENSG00000197943","PLCG2","16",81772702,81991899,219197
"12161","ENSG00000197948","FCHSD1","5",141018869,141030986,12117
"12162","ENSG00000197951","ZNF71","19",57106632,57137849,31217
"12163","ENSG00000197956","S100A6","1",153507075,153508720,1645
"12164","ENSG00000197958","RPL12","9",130209953,130213684,3731
"12165","ENSG00000197959","DNM3","1",171810621,172387606,576985
"12166","ENSG00000197961","ZNF121","19",9671029,9695209,24180
"12167","ENSG00000197965","MPZL1","1",167690429,167761156,70727
"12168","ENSG00000197969","VPS13A","9",79792269,80036457,244188
"12169","ENSG00000197971","MBP","18",74690783,74845639,154856
"12170","ENSG00000197976","AKAP17A","X",1710486,1721407,10921
"12171","ENSG00000197977","ELOVL2","6",10980992,11044547,63555
"12172","ENSG00000197982","C1orf122","1",38272651,38275126,2475
"12173","ENSG00000197989","SNHG12","1",28905050,28909495,4445
"12174","ENSG00000197991","PCDH20","13",61983818,62002220,18402
"12175","ENSG00000198000","NOL8","9",95059640,95087918,28278
"12176","ENSG00000198001","IRAK4","12",44152747,44183346,30599
"12177","ENSG00000198003","CCDC151","19",11531272,11546603,15331
"12178","ENSG00000198015","MRPL42","12",93861264,93897545,36281
"12179","ENSG00000198018","ENTPD7","10",101419263,101465997,46734
"12180","ENSG00000198026","ZNF335","20",44577292,44600833,23541
"12181","ENSG00000198028","ZNF560","19",9577183,9609283,32100
"12182","ENSG00000198034","RPS4X","X",71475529,71497150,21621
"12183","ENSG00000198035","AGAP9","10",48189612,48237508,47896
"12184","ENSG00000198039","ZNF273","7",64330550,64391344,60794
"12185","ENSG00000198040","ZNF84","12",133613878,133639885,26007
"12186","ENSG00000198042","MAK16","8",33342268,33358778,16510
"12187","ENSG00000198046","ZNF667","19",56950694,56989434,38740
"12188","ENSG00000198053","SIRPA","20",1875154,1920543,45389
"12189","ENSG00000198055","GRK6","5",176830205,176869902,39697
"12190","ENSG00000198056","PRIM1","12",57125380,57146157,20777
"12191","ENSG00000198060","MARCH5","10",94050920,94113721,62801
"12192","ENSG00000198075","SULT1C4","2",108994367,109004513,10146
"12193","ENSG00000198081","ZBTB14","18",5289018,5297052,8034
"12194","ENSG00000198087","CD2AP","6",47445525,47594999,149474
"12195","ENSG00000198088","NUP62CL","X",106366657,106449670,83013
"12196","ENSG00000198089","SFI1","22",31884674,32014572,129898
"12197","ENSG00000198093","ZNF649","19",52392477,52408293,15816
"12198","ENSG00000198105","ZNF248","10",38091751,38147034,55283
"12199","ENSG00000198108","CHSY3","5",129240165,129522327,282162
"12200","ENSG00000198121","LPAR1","9",113635543,113800981,165438
"12201","ENSG00000198130","HIBCH","2",191054461,191208919,154458
"12202","ENSG00000198131","ZNF544","19",58739960,58788815,48855
"12203","ENSG00000198133","TMEM229B","14",67913801,68000456,86655
"12204","ENSG00000198142","SOWAHC","2",110371911,110376563,4652
"12205","ENSG00000198146","ZNF770","15",35270542,35280488,9946
"12206","ENSG00000198150","","17",8261731,8263538,1807
"12207","ENSG00000198155","ZNF876P","4",206399,249774,43375
"12208","ENSG00000198156","NPIPB6","16",28353876,28374829,20953
"12209","ENSG00000198157","HMGN5","X",80369200,80457441,88241
"12210","ENSG00000198160","MIER1","1",67390578,67454302,63724
"12211","ENSG00000198162","MAN1A2","1",117910071,118071494,161423
"12212","ENSG00000198168","SVIP","11",22835345,22851845,16500
"12213","ENSG00000198169","ZNF251","8",145946298,145981802,35504
"12214","ENSG00000198171","DDRGK1","20",3170996,3185331,14335
"12215","ENSG00000198176","TFDP1","13",114239013,114295785,56772
"12216","ENSG00000198182","ZNF607","19",38187264,38210691,23427
"12217","ENSG00000198185","ZNF334","20",45129701,45142198,12497
"12218","ENSG00000198189","HSD17B11","4",88257762,88312538,54776
"12219","ENSG00000198198","SZT2","1",43855553,43918321,62768
"12220","ENSG00000198205","ZXDA","X",57931864,57937067,5203
"12221","ENSG00000198208","RPS6KL1","14",75370657,75390099,19442
"12222","ENSG00000198216","CACNA1E","1",181382238,181777219,394981
"12223","ENSG00000198218","QRICH1","3",49067140,49131796,64656
"12224","ENSG00000198221","MLLT4-AS1","6",168224556,168227389,2833
"12225","ENSG00000198231","DDX42","17",61850963,61896677,45714
"12226","ENSG00000198237","","5",69171098,69274436,103338
"12227","ENSG00000198242","RPL23A","17",27046411,27051377,4966
"12228","ENSG00000198246","SLC29A3","10",73079015,73123142,44127
"12229","ENSG00000198252","STYX","14",53196898,53241716,44818
"12230","ENSG00000198258","UBL5","19",9938568,9940791,2223
"12231","ENSG00000198265","HELZ","17",65066554,65242105,175551
"12232","ENSG00000198270","TMEM116","12",112369086,112450970,81884
"12233","ENSG00000198276","UCKL1","20",62571186,62587769,16583
"12234","ENSG00000198298","ZNF485","10",44101855,44113351,11496
"12235","ENSG00000198301","SDAD1","4",76862103,76912115,50012
"12236","ENSG00000198315","ZKSCAN8","6",28109688,28127250,17562
"12237","ENSG00000198324","FAM109A","12",111798455,111806925,8470
"12238","ENSG00000198327","HIST1H4F","6",26240561,26240976,415
"12239","ENSG00000198331","HYLS1","11",125753509,125770543,17034
"12240","ENSG00000198339","HIST1H4I","6",27107076,27108418,1342
"12241","ENSG00000198342","ZNF442","19",12460185,12476719,16534
"12242","ENSG00000198346","ZNF813","19",53970989,54006950,35961
"12243","ENSG00000198355","PIM3","22",50354161,50357728,3567
"12244","ENSG00000198356","ASNA1","19",12847953,12859137,11184
"12245","ENSG00000198363","ASPH","8",62413116,62627155,214039
"12246","ENSG00000198366","HIST1H3A","6",26020718,26021186,468
"12247","ENSG00000198369","SPRED2","2",65537985,65659771,121786
"12248","ENSG00000198373","WWP2","16",69796209,69975644,179435
"12249","ENSG00000198374","HIST1H2AL","6",27833034,27833606,572
"12250","ENSG00000198380","GFPT1","2",69546905,69614382,67477
"12251","ENSG00000198382","UVRAG","11",75526212,75854239,328027
"12252","ENSG00000198393","ZNF26","12",133562951,133589154,26203
"12253","ENSG00000198399","ITSN2","2",24425733,24583583,157850
"12254","ENSG00000198400","NTRK1","1",156785432,156851642,66210
"12255","ENSG00000198406","BZW1P2","3",116364592,116365574,982
"12256","ENSG00000198408","MGEA5","10",103544200,103578696,34496
"12257","ENSG00000198420","FAM115A","7",143548468,143599291,50823
"12258","ENSG00000198429","ZNF69","19",11998599,12025144,26545
"12259","ENSG00000198431","TXNRD1","12",104609557,104744061,134504
"12260","ENSG00000198435","NRARP","9",140194083,140196703,2620
"12261","ENSG00000198440","ZNF583","19",56909335,56947404,38069
"12262","ENSG00000198453","ZNF568","19",37407231,37489602,82371
"12263","ENSG00000198455","ZXDB","X",57618269,57623906,5637
"12264","ENSG00000198464","ZNF480","19",52800430,52829175,28745
"12265","ENSG00000198466","ZNF587","19",58361225,58376480,15255
"12266","ENSG00000198467","TPM2","9",35681989,35691017,9028
"12267","ENSG00000198468","FLVCR1-AS1","1",213025450,213031430,5980
"12268","ENSG00000198477","ZNF280B","22",22838767,22863505,24738
"12269","ENSG00000198478","SH3BGRL2","6",80341000,80413372,72372
"12270","ENSG00000198482","ZNF808","19",53030905,53067717,36812
"12271","ENSG00000198492","YTHDF2","1",29063133,29096287,33154
"12272","ENSG00000198496","NBR2","17",41277627,41305688,28061
"12273","ENSG00000198498","TMA16","4",164415594,164441691,26097
"12274","ENSG00000198513","ATL1","14",50999227,51099786,100559
"12275","ENSG00000198517","MAFK","7",1570350,1582679,12329
"12276","ENSG00000198518","HIST1H4E","6",26204858,26206266,1408
"12277","ENSG00000198520","C1orf228","1",45140364,45191263,50899
"12278","ENSG00000198521","ZNF43","19",21987752,22034927,47175
"12279","ENSG00000198522","GPN1","2",27851114,27874375,23261
"12280","ENSG00000198538","ZNF28","19",53300662,53360853,60191
"12281","ENSG00000198546","ZNF511","10",135121979,135166033,44054
"12282","ENSG00000198551","ZNF627","19",11670189,11729950,59761
"12283","ENSG00000198553","KCNRG","13",50589390,50595058,5668
"12284","ENSG00000198554","WDHD1","14",55405668,55493823,88155
"12285","ENSG00000198556","ZNF789","7",99070464,99101273,30809
"12286","ENSG00000198558","HIST1H4L","6",27840926,27841289,363
"12287","ENSG00000198561","CTNND1","11",57520715,57587018,66303
"12288","ENSG00000198563","DDX39B","6",31497996,31510225,12229
"12289","ENSG00000198576","ARC","8",143692405,143696833,4428
"12290","ENSG00000198580","","7",6713376,6715991,2615
"12291","ENSG00000198585","NUDT16","3",131100515,131107674,7159
"12292","ENSG00000198586","TLK1","2",171847333,172087824,240491
"12293","ENSG00000198589","LRBA","4",151185594,151936879,751285
"12294","ENSG00000198590","C3orf35","3",37427760,37476988,49228
"12295","ENSG00000198597","ZNF536","19",30719197,31204445,485248
"12296","ENSG00000198598","MMP17","12",132312938,132336328,23390
"12297","ENSG00000198604","BAZ1A","14",35221937,35344853,122916
"12298","ENSG00000198612","COPS8","2",237993955,238009109,15154
"12299","ENSG00000198618","PPIAP22","21",20230097,20230594,497
"12300","ENSG00000198624","CCDC69","5",150560613,150603706,43093
"12301","ENSG00000198625","MDM4","1",204485511,204542871,57360
"12302","ENSG00000198626","RYR2","1",237205505,237997288,791783
"12303","ENSG00000198642","KLHL9","9",21329670,21335379,5709
"12304","ENSG00000198646","NCOA6","20",33284722,33413452,128730
"12305","ENSG00000198648","STK39","2",168810530,169104651,294121
"12306","ENSG00000198663","C6orf89","6",36839646,36896740,57094
"12307","ENSG00000198668","CALM1","14",90862846,90874605,11759
"12308","ENSG00000198673","FAM19A2","12",62102040,62672931,570891
"12309","ENSG00000198677","TTC37","5",94799599,94890711,91112
"12310","ENSG00000198680","TUSC1","9",25676396,25678856,2460
"12311","ENSG00000198682","PAPSS2","10",89419370,89507462,88092
"12312","ENSG00000198689","SLC9A6","X",135067598,135129423,61825
"12313","ENSG00000198690","FAN1","15",31196055,31235311,39256
"12314","ENSG00000198692","EIF1AY","Y",22737611,22755040,17429
"12315","ENSG00000198695","MT-ND6","MT",14149,14673,524
"12316","ENSG00000198700","IPO9","1",201798269,201853422,55153
"12317","ENSG00000198707","CEP290","12",88442793,88535993,93200
"12318","ENSG00000198712","MT-CO2","MT",7586,8269,683
"12319","ENSG00000198715","C1orf85","1",156259880,156265463,5583
"12320","ENSG00000198718","FAM179B","14",45431411,45543634,112223
"12321","ENSG00000198719","DLL1","6",170591294,170599561,8267
"12322","ENSG00000198720","ANKRD13B","17",27916787,27941779,24992
"12323","ENSG00000198721","ECI2","6",4115923,4135831,19908
"12324","ENSG00000198722","UNC13B","9",35161999,35405335,243336
"12325","ENSG00000198727","MT-CYB","MT",14747,15887,1140
"12326","ENSG00000198728","LDB1","10",103867317,103880210,12893
"12327","ENSG00000198729","PPP1R14C","6",150464212,150571493,107281
"12328","ENSG00000198730","CTR9","11",10772534,10801290,28756
"12329","ENSG00000198732","SMOC1","14",70320848,70499083,178235
"12330","ENSG00000198736","MSRB1","16",1988211,1993327,5116
"12331","ENSG00000198739","LRRTM3","10",68685764,68859588,173824
"12332","ENSG00000198740","ZNF652","17",47366568,47439835,73267
"12333","ENSG00000198742","SMURF1","7",98625061,98741723,116662
"12334","ENSG00000198746","GPATCH3","1",27216979,27226957,9978
"12335","ENSG00000198752","CDC42BPB","14",103398716,103523799,125083
"12336","ENSG00000198755","RPL10A","6",35436185,35438562,2377
"12337","ENSG00000198756","COLGALT2","1",183898796,184006863,108067
"12338","ENSG00000198763","MT-ND2","MT",4470,5511,1041
"12339","ENSG00000198780","FAM169A","5",74073399,74162776,89377
"12340","ENSG00000198783","ZNF830","17",33288549,33290205,1656
"12341","ENSG00000198786","MT-ND5","MT",12337,14148,1811
"12342","ENSG00000198791","CNOT7","8",17086737,17104387,17650
"12343","ENSG00000198792","TMEM184B","22",38615298,38669040,53742
"12344","ENSG00000198793","MTOR","1",11166592,11322564,155972
"12345","ENSG00000198794","SCAMP5","15",75249560,75313837,64277
"12346","ENSG00000198795","ZNF521","18",22641890,22932154,290264
"12347","ENSG00000198796","ALPK2","18",56148479,56296189,147710
"12348","ENSG00000198797","BRINP2","1",177140633,177251558,110925
"12349","ENSG00000198799","LRIG2","1",113615831,113674882,59051
"12350","ENSG00000198804","MT-CO1","MT",5904,7445,1541
"12351","ENSG00000198805","PNP","14",20937113,20945253,8140
"12352","ENSG00000198814","GK","X",30671476,30748725,77249
"12353","ENSG00000198815","FOXJ3","1",42642210,42801548,159338
"12354","ENSG00000198816","ZNF358","19",7580178,7585912,5734
"12355","ENSG00000198818","SFT2D1","6",166733216,166756079,22863
"12356","ENSG00000198822","GRM3","7",86273230,86494200,220970
"12357","ENSG00000198824","CHAMP1","13",115079988,115092796,12808
"12358","ENSG00000198825","INPP5F","10",121485609,121588652,103043
"12359","ENSG00000198826","ARHGAP11A","15",32907345,32932150,24805
"12360","ENSG00000198830","HMGN2","1",26798941,26802463,3522
"12361","ENSG00000198832","","22",31500758,31516055,15297
"12362","ENSG00000198833","UBE2J1","6",90036344,90062567,26223
"12363","ENSG00000198836","OPA1","3",193310933,193415612,104679
"12364","ENSG00000198837","DENND4B","1",153901977,153919172,17195
"12365","ENSG00000198838","RYR3","15",33603163,34158303,555140
"12366","ENSG00000198839","ZNF277","7",111846643,111983151,136508
"12367","ENSG00000198840","MT-ND3","MT",10059,10404,345
"12368","ENSG00000198841","KTI12","1",52497775,52499488,1713
"12369","ENSG00000198843","","3",150320662,150348222,27560
"12370","ENSG00000198846","TOX","8",59717977,60031767,313790
"12371","ENSG00000198853","RUSC2","9",35490124,35561895,71771
"12372","ENSG00000198855","FICD","12",108908962,108919614,10652
"12373","ENSG00000198856","OSTC","4",109571740,109588976,17236
"12374","ENSG00000198858","R3HDM4","19",896503,913240,16737
"12375","ENSG00000198860","TSEN15","1",184020811,184043346,22535
"12376","ENSG00000198862","LTN1","21",30300466,30365270,64804
"12377","ENSG00000198863","RUNDC1","17",41132582,41145707,13125
"12378","ENSG00000198865","CCDC152","5",42756903,42802462,45559
"12379","ENSG00000198870","C9orf96","9",136243117,136271220,28103
"12380","ENSG00000198873","GRK5","10",120967101,121215131,248030
"12381","ENSG00000198874","TYW1","7",66460160,66704501,244341
"12382","ENSG00000198876","DCAF12","9",34086385,34127397,41012
"12383","ENSG00000198879","SFMBT2","10",7200586,7453450,252864
"12384","ENSG00000198885","ITPRIPL1","2",96991069,96994091,3022
"12385","ENSG00000198886","MT-ND4","MT",10760,12137,1377
"12386","ENSG00000198887","SMC5","9",72873937,72969804,95867
"12387","ENSG00000198888","MT-ND1","MT",3307,4262,955
"12388","ENSG00000198890","PRMT6","1",107599267,107601916,2649
"12389","ENSG00000198892","SHISA4","1",201857808,201861434,3626
"12390","ENSG00000198894","CIPC","14",77564440,77583630,19190
"12391","ENSG00000198898","CAPZA2","7",116451124,116562103,110979
"12392","ENSG00000198899","MT-ATP6","MT",8527,9207,680
"12393","ENSG00000198900","TOP1","20",39657458,39753127,95669
"12394","ENSG00000198901","PRC1","15",91509270,91538859,29589
"12395","ENSG00000198908","BHLHB9","X",101975616,102008468,32852
"12396","ENSG00000198909","MAP3K3","17",61699775,61773663,73888
"12397","ENSG00000198910","L1CAM","X",153126969,153174677,47708
"12398","ENSG00000198911","SREBF2","22",42229109,42303312,74203
"12399","ENSG00000198912","C1orf174","1",3805689,3816857,11168
"12400","ENSG00000198914","POU3F3","2",105471969,105476929,4960
"12401","ENSG00000198917","C9orf114","9",131581930,131592100,10170
"12402","ENSG00000198918","RPL39","X",118920467,118925606,5139
"12403","ENSG00000198919","DZIP3","3",108308529,108413693,105164
"12404","ENSG00000198920","KIAA0753","17",6481468,6544247,62779
"12405","ENSG00000198924","DCLRE1A","10",115594488,115614142,19654
"12406","ENSG00000198925","ATG9A","2",220074494,220094439,19945
"12407","ENSG00000198929","NOS1AP","1",162039564,162353321,313757
"12408","ENSG00000198931","APRT","16",88875747,88878352,2605
"12409","ENSG00000198932","GPRASP1","X",101906294,101914011,7717
"12410","ENSG00000198933","TBKBP1","17",45771447,45789416,17969
"12411","ENSG00000198934","MAGEE1","X",75648046,75651744,3698
"12412","ENSG00000198937","CCDC167","6",37450696,37467698,17002
"12413","ENSG00000198938","MT-CO3","MT",9207,9990,783
"12414","ENSG00000198939","ZFP2","5",178322895,178360213,37318
"12415","ENSG00000198945","L3MBTL3","6",130334844,130462594,127750
"12416","ENSG00000198947","DMD","X",31115794,33357558,2241764
"12417","ENSG00000198948","MFAP3L","4",170907748,170954182,46434
"12418","ENSG00000198951","NAGA","22",42454358,42466846,12488
"12419","ENSG00000198952","SMG5","1",156219015,156252620,33605
"12420","ENSG00000198954","KIAA1279","10",70748487,70776738,28251
"12421","ENSG00000198960","ARMCX6","X",100870110,100872991,2881
"12422","ENSG00000198961","PJA2","5",108670410,108745695,75285
"12423","ENSG00000198963","RORB","9",77112281,77308093,195812
"12424","ENSG00000198964","SGMS1","10",52065360,52384923,319563
"12425","ENSG00000198995","MIR340","5",179442303,179442397,94
"12426","ENSG00000199030","MIRLET7C","21",17912143,17912236,93
"12427","ENSG00000199036","MIR219-1","6",33175612,33175721,109
"12428","ENSG00000199043","MIR335","7",130135952,130136045,93
"12429","ENSG00000199109","MIR411","14",101489662,101489757,95
"12430","ENSG00000199133","MIRLET7D","9",96941116,96941202,86
"12431","ENSG00000199172","MIR331","12",95702196,95702289,93
"12432","ENSG00000199331","","9",111804666,111804767,101
"12433","ENSG00000199347","RNU5E-1","1",11968209,11968328,119
"12434","ENSG00000199390","SNORD114-7","14",101429391,101429467,76
"12435","ENSG00000199545","RNA5SP195","5",138635541,138635657,116
"12436","ENSG00000199568","RNU5A-1","15",65588389,65588504,115
"12437","ENSG00000199575","SNORD114-1","14",101416170,101416241,71
"12438","ENSG00000199593","SNORD114-14","14",101438440,101438514,74
"12439","ENSG00000199645","RNU6-1330P","5",74075134,74075238,104
"12440","ENSG00000199753","SNORD104","17",62223443,62223512,69
"12441","ENSG00000199977","","18",19397585,19397789,204
"12442","ENSG00000199990","VTRNA1-1","5",140090860,140090958,98
"12443","ENSG00000200087","SNORA73B","1",28835071,28835274,203
"12444","ENSG00000200090","","11",47748446,47748544,98
"12445","ENSG00000200150","","14",101422577,101422649,72
"12446","ENSG00000200156","RNU5B-1","15",65597015,65597130,115
"12447","ENSG00000200169","RNU5D-1","1",45196727,45196842,115
"12448","ENSG00000200170","","10",73980510,73980610,100
"12449","ENSG00000200279","SNORD114-10","14",101433389,101433460,71
"12450","ENSG00000200312","RN7SKP255","14",90178855,90179167,312
"12451","ENSG00000200354","SNORA71D","20",37062508,37062641,133
"12452","ENSG00000200367","SNORD113-8","14",101409788,101409861,73
"12453","ENSG00000200406","SNORD114-23","14",101450213,101450284,71
"12454","ENSG00000200413","SNORD114-26","14",101453383,101453454,71
"12455","ENSG00000200434","RNA5-8SP2","16",33965426,33965577,151
"12456","ENSG00000200480","SNORD114-28","14",101455467,101455538,71
"12457","ENSG00000200488","RN7SKP203","2",76672205,76672536,331
"12458","ENSG00000200502","","9",37160134,37160234,100
"12459","ENSG00000200534","SNORA33","6",133138358,133138487,129
"12460","ENSG00000200608","SNORD114-11","14",101434448,101434522,74
"12461","ENSG00000200612","SNORD114-25","14",101452394,101452465,71
"12462","ENSG00000200753","","7",20416954,20417024,70
"12463","ENSG00000200785","SNORD8","14",21865451,21865560,109
"12464","ENSG00000200792","SNORA80","21",33749496,33749631,135
"12465","ENSG00000200795","RNU4-1","12",120730900,120731040,140
"12466","ENSG00000200816","SNORA38","6",31590856,31590987,131
"12467","ENSG00000200823","SNORD114-2","14",101418193,101418270,77
"12468","ENSG00000200832","SNORD114-4","14",101420711,101420785,74
"12469","ENSG00000200879","SNORD14E","11",122928785,122928869,84
"12470","ENSG00000200882","RNU6-681P","3",176843805,176843908,103
"12471","ENSG00000200913","SNORD46","1",45242162,45242265,103
"12472","ENSG00000200959","SNORA74A","5",138614470,138614667,197
"12473","ENSG00000200972","RNU5A-8P","1",210547498,210547611,113
"12474","ENSG00000201036","","14",101445339,101445427,88
"12475","ENSG00000201098","RNY1","7",148684228,148684340,112
"12476","ENSG00000201217","","3",152167061,152167173,112
"12477","ENSG00000201247","SNORD114-13","14",101436216,101436289,73
"12478","ENSG00000201263","SNORD114-6","14",101423503,101423574,71
"12479","ENSG00000201264","","4",152023209,152023280,71
"12480","ENSG00000201297","","4",126283974,126284084,110
"12481","ENSG00000201302","SNORA65","9",130210780,130210909,129
"12482","ENSG00000201321","RNA5S9","1",228763895,228764013,118
"12483","ENSG00000201343","","3",176838479,176838588,109
"12484","ENSG00000201457","SNORA55","1",40033046,40033180,134
"12485","ENSG00000201512","SNORA71C","20",37058313,37058446,133
"12486","ENSG00000201557","SNORD114-15","14",101439007,101439078,71
"12487","ENSG00000201558","RNVU1-6","1",145382757,145382920,163
"12488","ENSG00000201592","","X",20154424,20154503,79
"12489","ENSG00000201672","SNORD113-4","14",101402828,101402902,74
"12490","ENSG00000201678","","12",49321722,49321816,94
"12491","ENSG00000201699","RNU1-59P","1",144534038,144534199,161
"12492","ENSG00000201700","SNORD113-3","14",101396256,101396328,72
"12493","ENSG00000201710","","14",101446329,101446403,74
"12494","ENSG00000201772","SNORA5C","7",45144505,45144641,136
"12495","ENSG00000201793","RN7SKP9","13",99857962,99858260,298
"12496","ENSG00000201839","SNORD114-3","14",101419686,101419760,74
"12497","ENSG00000201944","","1",205700349,205700480,131
"12498","ENSG00000201950","SNORD113-9","14",101411986,101412057,71
"12499","ENSG00000201998","SNORA23","11",9450320,9450501,181
"12500","ENSG00000202048","SNORD114-20","14",101447341,101447412,71
"12501","ENSG00000202058","RN7SKP80","22",42961054,42961336,282
"12502","ENSG00000202077","RNU1-60P","17",56736510,56736666,156
"12503","ENSG00000202107","SNORD103B","1",31421964,31422049,85
"12504","ENSG00000202141","","2",183887587,183887699,112
"12505","ENSG00000202191","SNORD113-1","14",101391161,101391229,68
"12506","ENSG00000202198","RN7SK","6",52860418,52860748,330
"12507","ENSG00000202222","","1",40347238,40347350,112
"12508","ENSG00000202337","RNU6-8","14",32672369,32672475,106
"12509","ENSG00000202347","RNU1-16P","13",114133230,114133393,163
"12510","ENSG00000202354","RNY3","7",148680847,148680948,101
"12511","ENSG00000202408","RNU1-122P","1",147806736,147806886,150
"12512","ENSG00000202496","RNVU1-20","1",149605917,149606079,162
"12513","ENSG00000202515","VTRNA1-3","5",140105743,140105831,88
"12514","ENSG00000202538","RNU4-2","12",120729566,120729706,140
"12515","ENSG00000202566","MIR421","X",73438212,73438296,84
"12516","ENSG00000203276","","1",54498816,54500553,1737
"12517","ENSG00000203286","","9",3452305,3469181,16876
"12518","ENSG00000203288","","1",151763280,151766878,3598
"12519","ENSG00000203326","ZNF525","19",53868946,53895470,26524
"12520","ENSG00000203327","","2",55441523,55443262,1739
"12521","ENSG00000203485","INF2","14",105155943,105185942,29999
"12522","ENSG00000203497","PDCD4-AS1","10",112629626,112631991,2365
"12523","ENSG00000203504","","11",31705636,31707478,1842
"12524","ENSG00000203602","","13",28008286,28008752,466
"12525","ENSG00000203632","","3",186650337,186652182,1845
"12526","ENSG00000203644","","3",129565893,129566800,907
"12527","ENSG00000203652","","3",30030355,30031951,1596
"12528","ENSG00000203666","EFCAB2","1",245133007,245290466,157459
"12529","ENSG00000203667","COX20","1",244998624,245008359,9735
"12530","ENSG00000203668","CHML","1",241792155,241799232,7077
"12531","ENSG00000203684","IBA57-AS1","1",228351787,228353213,1426
"12532","ENSG00000203685","C1orf95","1",226736501,226796915,60414
"12533","ENSG00000203688","","6",168080306,168084467,4161
"12534","ENSG00000203705","TATDN3","1",212965170,212989968,24798
"12535","ENSG00000203709","C1orf132","1",207974863,208042495,67632
"12536","ENSG00000203727","SAMD5","6",147830063,148058683,228620
"12537","ENSG00000203737","GPR52","1",174417212,174418683,1471
"12538","ENSG00000203739","","1",173386932,173430501,43569
"12539","ENSG00000203760","CENPW","6",126661320,126670021,8701
"12540","ENSG00000203761","MSTO2P","1",155581011,155720105,139094
"12541","ENSG00000203778","FAM229B","6",112408802,112423993,15191
"12542","ENSG00000203780","FANK1","10",127585108,127698161,113053
"12543","ENSG00000203791","METTL10","10",126436718,126480439,43721
"12544","ENSG00000203813","HIST1H3H","6",27777842,27778314,472
"12545","ENSG00000203814","HIST2H2BF","1",149754245,149783928,29683
"12546","ENSG00000203817","FAM72C","1",149438750,149459549,20799
"12547","ENSG00000203819","HIST2H2BC","1",149821760,149822339,579
"12548","ENSG00000203827","NBPF16","1",148739443,148758311,18868
"12549","ENSG00000203832","NBPF20","1",148250249,148347506,97257
"12550","ENSG00000203836","NBPF24","1",147574428,147634886,60458
"12551","ENSG00000203863","","6",89674246,89676685,2439
"12552","ENSG00000203865","ATP1A1OS","1",116934869,116961244,26375
"12553","ENSG00000203867","RBM20","10",112404155,112599227,195072
"12554","ENSG00000203871","C6orf164","6",88106840,88109467,2627
"12555","ENSG00000203872","C6orf163","6",88054567,88075181,20614
"12556","ENSG00000203875","SNHG5","6",86370710,86388451,17741
"12557","ENSG00000203879","GDI1","X",153665266,153671814,6548
"12558","ENSG00000203880","PCMTD2","20",62887094,62926855,39761
"12559","ENSG00000203896","LIME1","20",62366815,62370456,3641
"12560","ENSG00000203930","LINC00632","X",139791932,139854844,62912
"12561","ENSG00000203943","SAMD13","1",84764049,84855640,91591
"12562","ENSG00000203950","FAM127B","X",134184962,134186226,1264
"12563","ENSG00000203952","CCDC160","X",133371077,133380237,9160
"12564","ENSG00000203965","EFCAB7","1",63989043,64038364,49321
"12565","ENSG00000203993","C9orf37","9",140509784,140513358,3574
"12566","ENSG00000203995","ZYG11A","1",53308183,53360670,52487
"12567","ENSG00000204054","LINC00963","9",132245730,132275947,30217
"12568","ENSG00000204070","SYS1","20",43990577,44005438,14861
"12569","ENSG00000204084","INPP5B","1",38326369,38412729,86360
"12570","ENSG00000204103","MAFB","20",39314488,39317880,3392
"12571","ENSG00000204104","TRAF3IP1","2",239229082,239309541,80459
"12572","ENSG00000204116","CHIC1","X",72783036,72906937,123901
"12573","ENSG00000204120","GIGYF2","2",233562009,233725285,163276
"12574","ENSG00000204128","C2orf72","2",231902205,231914434,12229
"12575","ENSG00000204130","RUFY2","10",70100864,70167051,66187
"12576","ENSG00000204131","NHSL2","X",71130938,71363424,232486
"12577","ENSG00000204138","PHACTR4","1",28696114,28826881,130767
"12578","ENSG00000204147","ASAH2B","10",52499078,52576255,77177
"12579","ENSG00000204149","AGAP6","10",51748078,51770259,22181
"12580","ENSG00000204152","TIMM23B","10",51371390,51387768,16378
"12581","ENSG00000204160","ZDHHC18","1",27153201,27184093,30892
"12582","ENSG00000204164","BMS1P5","10",48901102,48950972,49870
"12583","ENSG00000204169","AGAP7","10",51464162,51486327,22165
"12584","ENSG00000204175","GPRIN2","10",46994087,47005643,11556
"12585","ENSG00000204177","BMS1P1","10",46737612,46761205,23593
"12586","ENSG00000204178","TMEM57","1",25757388,25826700,69312
"12587","ENSG00000204186","ZDBF2","2",207139387,207179148,39761
"12588","ENSG00000204209","DAXX","6",33286335,33297046,10711
"12589","ENSG00000204217","BMPR2","2",203241659,203432474,190815
"12590","ENSG00000204219","TCEA3","1",23707554,23751233,43679
"12591","ENSG00000204220","PFDN6","6",33257079,33266178,9099
"12592","ENSG00000204227","RING1","6",33176272,33180499,4227
"12593","ENSG00000204228","HSD17B8","6",33172419,33174608,2189
"12594","ENSG00000204231","RXRB","6",33161365,33168630,7265
"12595","ENSG00000204237","OXLD1","17",79632066,79633665,1599
"12596","ENSG00000204241","","11",133902167,133916744,14577
"12597","ENSG00000204248","COL11A2","6",33130458,33160276,29818
"12598","ENSG00000204253","HNRNPCP2","2",190788062,190788942,880
"12599","ENSG00000204256","BRD2","6",32936437,32949282,12845
"12600","ENSG00000204257","HLA-DMA","6",32916390,32936871,20481
"12601","ENSG00000204262","COL5A2","2",189896622,190044605,147983
"12602","ENSG00000204264","PSMB8","6",32808494,32812480,3986
"12603","ENSG00000204267","TAP2","6",32789610,32806557,16947
"12604","ENSG00000204271","SPIN3","X",57002803,57021970,19167
"12605","ENSG00000204272","","X",56755692,56844813,89121
"12606","ENSG00000204291","COL15A1","9",101705461,101833069,127608
"12607","ENSG00000204301","NOTCH4","6",32162620,32191844,29224
"12608","ENSG00000204304","PBX2","6",32152512,32157963,5451
"12609","ENSG00000204305","AGER","6",32148745,32152101,3356
"12610","ENSG00000204308","RNF5","6",32146131,32151930,5799
"12611","ENSG00000204310","AGPAT1","6",32135989,32145873,9884
"12612","ENSG00000204311","DFNB59","2",179316163,179326117,9954
"12613","ENSG00000204314","PRRT1","6",32116136,32122150,6014
"12614","ENSG00000204315","FKBPL","6",32096484,32098068,1584
"12615","ENSG00000204316","MRPL38","17",73894724,73905899,11175
"12616","ENSG00000204323","SMIM5","17",73629514,73637484,7970
"12617","ENSG00000204344","STK19","6",31938868,31950598,11730
"12618","ENSG00000204347","BTBD17","17",72352555,72358085,5530
"12619","ENSG00000204348","DXO","6",31937587,31940069,2482
"12620","ENSG00000204351","SKIV2L","6",31926857,31937532,10675
"12621","ENSG00000204356","NELFE","6",31919864,31926887,7023
"12622","ENSG00000204366","ZBTB12","6",31867384,31869769,2385
"12623","ENSG00000204370","SDHD","11",111957497,111990353,32856
"12624","ENSG00000204371","EHMT2","6",31847536,31865464,17928
"12625","ENSG00000204377","C1orf134","1",16555368,16556038,670
"12626","ENSG00000204381","LAYN","11",111411005,111432264,21259
"12627","ENSG00000204386","NEU1","6",31825436,31830683,5247
"12628","ENSG00000204387","C6orf48","6",31802385,31807541,5156
"12629","ENSG00000204388","HSPA1B","6",31795512,31798031,2519
"12630","ENSG00000204389","HSPA1A","6",31783291,31785723,2432
"12631","ENSG00000204390","HSPA1L","6",31777396,31783437,6041
"12632","ENSG00000204392","LSM2","6",31765173,31774761,9588
"12633","ENSG00000204394","VARS","6",31745295,31763730,18435
"12634","ENSG00000204406","MBD5","2",148778580,149275805,497225
"12635","ENSG00000204410","MSH5","6",31707725,31732622,24897
"12636","ENSG00000204427","ABHD16A","6",31654726,31671221,16495
"12637","ENSG00000204428","LY6G5C","6",31644461,31651817,7356
"12638","ENSG00000204435","CSNK2B","6",31633013,31638120,5107
"12639","ENSG00000204438","GPANK1","6",31629006,31634060,5054
"12640","ENSG00000204439","C6orf47","6",31626075,31628549,2474
"12641","ENSG00000204442","FAM155A","13",107820883,108519083,698200
"12642","ENSG00000204444","APOM","6",31620193,31625987,5794
"12643","ENSG00000204463","BAG6","6",31606805,31620482,13677
"12644","ENSG00000204469","PRRC2A","6",31588497,31605548,17051
"12645","ENSG00000204498","NFKBIL1","6",31514647,31526606,11959
"12646","ENSG00000204514","ZNF814","19",58360099,58400442,40343
"12647","ENSG00000204516","MICB","6",31462658,31478901,16243
"12648","ENSG00000204519","ZNF551","19",58193337,58228669,35332
"12649","ENSG00000204520","MICA","6",31371356,31383092,11736
"12650","ENSG00000204524","ZNF805","19",57751973,57766503,14530
"12651","ENSG00000204525","HLA-C","6",31236526,31239907,3381
"12652","ENSG00000204536","CCHCR1","6",31110216,31126015,15799
"12653","ENSG00000204556","","20",25999468,26001320,1852
"12654","ENSG00000204560","DHX16","6",30620896,30640814,19918
"12655","ENSG00000204564","C6orf136","6",30614816,30620987,6171
"12656","ENSG00000204568","MRPS18B","6",30585486,30594172,8686
"12657","ENSG00000204569","PPP1R10","6",30568177,30586389,18212
"12658","ENSG00000204574","ABCF1","6",30539153,30564956,25803
"12659","ENSG00000204576","PRR3","6",30524663,30531500,6837
"12660","ENSG00000204580","DDR1","6",30844198,30867933,23735
"12661","ENSG00000204584","","17",47923272,47926199,2927
"12662","ENSG00000204590","GNL1","6",30509154,30524951,15797
"12663","ENSG00000204592","HLA-E","6",30457244,30461982,4738
"12664","ENSG00000204599","TRIM39","6",30294256,30311506,17250
"12665","ENSG00000204604","ZNF468","19",53341261,53360902,19641
"12666","ENSG00000204611","ZNF616","19",52616344,52643175,26831
"12667","ENSG00000204619","PPP1R11","6",30034486,30038110,3624
"12668","ENSG00000204623","ZNRD1-AS1","6",29968788,30029417,60629
"12669","ENSG00000204624","PTCHD2","1",11539223,11597641,58418
"12670","ENSG00000204628","GNB2L1","5",180663909,180675096,11187
"12671","ENSG00000204634","TBC1D8","2",101624079,101869328,245249
"12672","ENSG00000204650","CRHR1-IT1","17",43697694,43725582,27888
"12673","ENSG00000204673","AKT1S1","19",50372295,50381716,9421
"12674","ENSG00000204681","GABBR1","6",29523406,29601753,78347
"12675","ENSG00000204682","CASC10","10",21781587,21786191,4604
"12676","ENSG00000204683","C10orf113","10",21414692,21435488,20796
"12677","ENSG00000204685","STARD7-AS1","2",96874154,96908359,34205
"12678","ENSG00000204706","MAMDC2-AS1","9",72700732,72790804,90072
"12679","ENSG00000204711","C9orf135","9",72435709,72521148,85439
"12680","ENSG00000204713","TRIM27","6",28870779,28891766,20987
"12681","ENSG00000204745","","2",87352513,87423770,71257
"12682","ENSG00000204764","RANBP17","5",170288874,170727019,438145
"12683","ENSG00000204767","FAM196B","5",169291268,169407744,116476
"12684","ENSG00000204778","","9",70181520,70216621,35101
"12685","ENSG00000204790","CBWD6","9",69204538,69269662,65124
"12686","ENSG00000204794","PGM5P1","9",68741234,68809906,68672
"12687","ENSG00000204802","","9",46685429,46688137,2708
"12688","ENSG00000204805","FAM27E4","9",44997777,44999352,1575
"12689","ENSG00000204815","TTC25","17",40086888,40117648,30760
"12690","ENSG00000204822","MRPL53","2",74699085,74700449,1364
"12691","ENSG00000204839","MROH6","8",144648357,144655141,6784
"12692","ENSG00000204842","ATXN2","12",111890018,112037480,147462
"12693","ENSG00000204843","DCTN1","2",74588281,74619214,30933
"12694","ENSG00000204851","PNMAL2","19",46990163,46999755,9592
"12695","ENSG00000204852","TCTN1","12",111051832,111087235,35403
"12696","ENSG00000204856","FAM216A","12",110906169,110928190,22021
"12697","ENSG00000204859","ZBTB48","1",6640061,6649340,9279
"12698","ENSG00000204899","MZT1","13",73282495,73301825,19330
"12699","ENSG00000204920","ZNF155","19",44472014,44502477,30463
"12700","ENSG00000204922","C11orf83","11",62437745,62441159,3414
"12701","ENSG00000204923","FBXO48","2",68686551,68694390,7839
"12702","ENSG00000204934","ATP6V0E2-AS1","7",149564786,149577699,12913
"12703","ENSG00000204946","ZNF783","7",148959262,148994393,35131
"12704","ENSG00000204947","ZNF425","7",148799876,148823438,23562
"12705","ENSG00000204950","LRRC10B","11",61276272,61278482,2210
"12706","ENSG00000204954","C12orf73","12",104343980,104359486,15506
"12707","ENSG00000204956","PCDHGA1","5",140710252,140892546,182294
"12708","ENSG00000204957","","19",42746927,42749125,2198
"12709","ENSG00000204961","PCDHA9","5",140227048,140391929,164881
"12710","ENSG00000204962","PCDHA8","5",140220907,140391929,171022
"12711","ENSG00000204963","PCDHA7","5",140213969,140391929,177960
"12712","ENSG00000204965","PCDHA5","5",140201222,140391929,190707
"12713","ENSG00000204967","PCDHA4","5",140186659,140391929,205270
"12714","ENSG00000204969","PCDHA2","5",140174444,140391929,217485
"12715","ENSG00000204977","TRIM13","13",50570024,50594617,24593
"12716","ENSG00000204991","SPIRE2","16",89884587,89937727,53140
"12717","ENSG00000205002","AARD","8",117950438,117956726,6288
"12718","ENSG00000205038","PKHD1L1","8",110374706,110542559,167853
"12719","ENSG00000205041","","19",40779396,40781386,1990
"12720","ENSG00000205047","","16",87731749,87739290,7541
"12721","ENSG00000205060","SLC35B4","7",133974084,134001803,27719
"12722","ENSG00000205078","SYCE1L","16",77233294,77247112,13818
"12723","ENSG00000205084","TMEM231","16",75572015,75590184,18169
"12724","ENSG00000205085","FAM71F2","7",128312342,128326929,14587
"12725","ENSG00000205086","C2orf91","2",42162508,42181406,18898
"12726","ENSG00000205111","CDKL4","2",39402787,39456729,53942
"12727","ENSG00000205129","C4orf47","4",186347394,186370980,23586
"12728","ENSG00000205133","TRIQK","8",93895758,94029901,134143
"12729","ENSG00000205138","SDHAF1","19",36486090,36487220,1130
"12730","ENSG00000205148","","15",96831280,96831660,380
"12731","ENSG00000205155","PSENEN","19",36236015,36237911,1896
"12732","ENSG00000205181","LINC00654","20",5476713,5485259,8546
"12733","ENSG00000205189","ZBTB10","8",81397854,81438500,40646
"12734","ENSG00000205208","C4orf46","4",159587831,159593407,5576
"12735","ENSG00000205209","SCGB2B2","19",35084234,35166604,82370
"12736","ENSG00000205213","LGR4","11",27387508,27494322,106814
"12737","ENSG00000205220","PSMB10","16",67968405,67970990,2585
"12738","ENSG00000205246","RPSAP58","19",23945807,24010937,65130
"12739","ENSG00000205250","E2F4","16",67226072,67232821,6749
"12740","ENSG00000205268","PDE7A","8",66629745,66754557,124812
"12741","ENSG00000205269","TMEM170B","6",11537938,11583757,45819
"12742","ENSG00000205277","MUC12","7",100612904,100662230,49326
"12743","ENSG00000205302","SNX2","5",122110691,122165803,55112
"12744","ENSG00000205309","NT5M","17",17206649,17250977,44328
"12745","ENSG00000205323","SARNP","12",56146247,56211540,65293
"12746","ENSG00000205325","","17",14670900,14683520,12620
"12747","ENSG00000205336","GPR56","16",57644564,57698944,54380
"12748","ENSG00000205339","IPO7","11",9406169,9469673,63504
"12749","ENSG00000205352","PRR13","12",53835389,53840429,5040
"12750","ENSG00000205356","TECPR1","7",97843936,97881563,37627
"12751","ENSG00000205363","C15orf59","15",74032141,74045088,12947
"12752","ENSG00000205413","SAMD9","7",92728829,92747336,18507
"12753","ENSG00000205423","CNEP1R1","16",50058321,50070999,12678
"12754","ENSG00000205464","ATP6AP1L","5",81575281,81682796,107515
"12755","ENSG00000205476","CCDC85C","14",99977603,100070363,92760
"12756","ENSG00000205485","","7",76178677,76257299,78622
"12757","ENSG00000205531","NAP1L4","11",2965667,3013607,47940
"12758","ENSG00000205534","","16",29538889,29606395,67506
"12759","ENSG00000205542","TMSB4X","X",12993227,12995346,2119
"12760","ENSG00000205544","TMEM256","17",7306294,7307456,1162
"12761","ENSG00000205559","CHKB-AS1","22",51021455,51022306,851
"12762","ENSG00000205571","SMN2","5",69345350,69374349,28999
"12763","ENSG00000205572","SERF1B","5",69321074,69338940,17866
"12764","ENSG00000205578","POM121B","7",72707497,72716496,8999
"12765","ENSG00000205581","HMGN1","21",40714241,40721573,7332
"12766","ENSG00000205583","STAG3L1","7",74988448,75024657,36209
"12767","ENSG00000205592","MUC19","12",40787197,40964632,177435
"12768","ENSG00000205593","DENND6B","22",50747459,50765489,18030
"12769","ENSG00000205629","LCMT1","16",25123050,25189552,66502
"12770","ENSG00000205643","CDPF1","22",46639908,46646576,6668
"12771","ENSG00000205659","LIN52","14",74551499,74667936,116437
"12772","ENSG00000205664","","X",3735569,3761898,26329
"12773","ENSG00000205670","SMIM11","21",35747779,35780164,32385
"12774","ENSG00000205683","DPF3","14",73086004,73360809,274805
"12775","ENSG00000205702","CYP2D7P","22",42536214,42540576,4362
"12776","ENSG00000205707","LYRM5","12",25348150,25362579,14429
"12777","ENSG00000205726","ITSN1","21",35014706,35272165,257459
"12778","ENSG00000205730","ITPRIPL2","16",19125254,19132946,7692
"12779","ENSG00000205758","CRYZL1","21",34961647,35016232,54585
"12780","ENSG00000205763","RP9P","7",32956427,32982788,26361
"12781","ENSG00000205765","C5orf51","5",41904290,41921738,17448
"12782","ENSG00000205771","CATSPER2P1","15",44019116,44039292,20176
"12783","ENSG00000205791","LOH12CR2","12",12508342,12510001,1659
"12784","ENSG00000205808","PPAPDC2","9",4662298,4665256,2958
"12785","ENSG00000205838","TTC23L","5",34838938,34899561,60623
"12786","ENSG00000205853","RFPL3S","22",32755893,32778039,22146
"12787","ENSG00000205903","ZNF316","7",6676953,6694242,17289
"12788","ENSG00000205913","SRRM2-AS1","16",2787077,2802601,15524
"12789","ENSG00000205922","ONECUT3","19",1752372,1780987,28615
"12790","ENSG00000205927","OLIG2","21",34398153,34401504,3351
"12791","ENSG00000205929","C21orf62","21",34162985,34186053,23068
"12792","ENSG00000205930","C21orf49","21",34144411,34266043,121632
"12793","ENSG00000205937","RNPS1","16",2303117,2318413,15296
"12794","ENSG00000205959","","4",8483997,8514337,30340
"12795","ENSG00000205978","NYNRIN","14",24867992,24888494,20502
"12796","ENSG00000205981","DNAJC19","3",180701497,180707562,6065
"12797","ENSG00000206052","DOK6","18",67068291,67516323,448032
"12798","ENSG00000206053","HN1L","16",1728257,1752281,24024
"12799","ENSG00000206077","ZDHHC11B","5",710475,767067,56592
"12800","ENSG00000206120","EGFEM1P","3",167967310,168548387,581077
"12801","ENSG00000206149","HERC2P9","15",28834638,28930410,95772
"12802","ENSG00000206190","ATP10A","15",25922420,26110317,187897
"12803","ENSG00000206341","HLA-H","6",29855350,29858259,2909
"12804","ENSG00000206344","HCG27","6",31165537,31171745,6208
"12805","ENSG00000206417","H1FX-AS1","3",129034235,129045068,10833
"12806","ENSG00000206418","RAB12","18",8609443,8639379,29936
"12807","ENSG00000206432","TMEM200C","18",5882071,5895954,13883
"12808","ENSG00000206503","HLA-A","6",29909037,29913661,4624
"12809","ENSG00000206527","PTPLB","3",123209667,123304032,94365
"12810","ENSG00000206530","WDR52","3",113005777,113160457,154680
"12811","ENSG00000206532","","3",110607231,110612323,5092
"12812","ENSG00000206535","LNP1","3",100120037,100175163,55126
"12813","ENSG00000206538","VGLL3","3",86987119,87040269,53150
"12814","ENSG00000206557","TRIM71","3",32859510,32939318,79808
"12815","ENSG00000206559","ZCWPW2","3",28390637,28579613,188976
"12816","ENSG00000206560","ANKRD28","3",15708743,15901278,192535
"12817","ENSG00000206561","COLQ","3",15491640,15563258,71618
"12818","ENSG00000206562","METTL6","3",15422782,15482073,59291
"12819","ENSG00000206567","","3",10048102,10052893,4791
"12820","ENSG00000206573","SETD5-AS1","3",9391373,9440263,48890
"12821","ENSG00000206579","XKR4","8",56014949,56454613,439664
"12822","ENSG00000206612","SNORA2A","12",49050431,49050565,134
"12823","ENSG00000206621","SNORD116-14","15",25325289,25325380,91
"12824","ENSG00000206630","SNORD60","16",2205024,2205106,82
"12825","ENSG00000206633","SNORA80B","2",10586840,10586975,135
"12826","ENSG00000206634","SNORA22","7",65220513,65220646,133
"12827","ENSG00000206652","RNU1-1","1",16840617,16840780,163
"12828","ENSG00000206656","SNORD116-17","15",25328735,25328826,91
"12829","ENSG00000206688","SNORD116-18","15",25330532,25330623,91
"12830","ENSG00000206712","RNU6-26P","3",98523822,98523928,106
"12831","ENSG00000206727","SNORD116-9","15",25318254,25318348,94
"12832","ENSG00000206737","RNVU1-18","1",149224058,149224221,163
"12833","ENSG00000206754","SNORD101","6",133136446,133136518,72
"12834","ENSG00000206885","SNORA75","2",232320511,232320647,136
"12835","ENSG00000206952","SNORA50","16",58593700,58593835,135
"12836","ENSG00000207001","SNORD116-2","15",25299357,25299451,94
"12837","ENSG00000207005","RNU1-2","1",17222475,17222638,163
"12838","ENSG00000207008","SNORA54","11",2985001,2985123,122
"12839","ENSG00000207014","SNORD116-3","15",25302007,25302101,94
"12840","ENSG00000207034","","18",2778939,2779055,116
"12841","ENSG00000207063","SNORD116-1","15",25296624,25296718,94
"12842","ENSG00000207067","SNORA72","8",99054314,99054445,131
"12843","ENSG00000207082","RNU6-171P","1",164608802,164608908,106
"12844","ENSG00000207088","SNORA7B","3",129116053,129116191,138
"12845","ENSG00000207093","SNORD116-8","15",25315579,25315673,94
"12846","ENSG00000207117","","2",160392755,160392857,102
"12847","ENSG00000207133","SNORD116-7","15",25312935,25313029,94
"12848","ENSG00000207137","SNORD116-13","15",25324205,25324296,91
"12849","ENSG00000207174","SNORD116-15","15",25326434,25326525,91
"12850","ENSG00000207181","SNORA14B","1",235291118,235291252,134
"12851","ENSG00000207205","RNVU1-15","1",148604908,148605072,164
"12852","ENSG00000207217","","7",6056508,6056642,134
"12853","ENSG00000207233","SNORA37","18",51748654,51748782,128
"12854","ENSG00000207234","RNU6-125P","1",89282462,89282568,106
"12855","ENSG00000207245","SNORD116-29","15",25351668,25351750,82
"12856","ENSG00000207263","SNORD116-16","15",25327915,25328006,91
"12857","ENSG00000207279","SNORD116-24","15",25339184,25339275,91
"12858","ENSG00000207280","SNORD20","2",232321155,232321234,79
"12859","ENSG00000207313","SNORA2B","12",49061240,49061376,136
"12860","ENSG00000207357","RNU6-2","19",1021521,1021627,106
"12861","ENSG00000207370","","3",193341978,193342090,112
"12862","ENSG00000207375","SNORD116-23","15",25336933,25337024,91
"12863","ENSG00000207389","RNU1-4","1",17067011,17067174,163
"12864","ENSG00000207417","","8",75288922,75289028,106
"12865","ENSG00000207425","","16",15009314,15009413,99
"12866","ENSG00000207442","SNORD116-6","15",25310173,25310268,95
"12867","ENSG00000207445","SNORD15B","11",75115465,75115610,145
"12868","ENSG00000207460","SNORD116-19","15",25331674,25331765,91
"12869","ENSG00000207468","SNORA19","10",120819523,120819650,127
"12870","ENSG00000207475","SNORA42","1",155889700,155889836,136
"12871","ENSG00000207493","SNORA46","16",58582403,58582537,134
"12872","ENSG00000207497","","4",186631027,186631121,94
"12873","ENSG00000207501","RNVU1-14","1",148241465,148241628,163
"12874","ENSG00000207523","SNORA66","1",93306276,93306408,132
"12875","ENSG00000207547","MIR25","7",99691183,99691266,83
"12876","ENSG00000207569","MIR433","14",101348220,101348343,123
"12877","ENSG00000207586","MIR135A2","12",97957590,97957689,99
"12878","ENSG00000207608","MIR127","14",101349316,101349412,96
"12879","ENSG00000207609","MIR491","9",20716104,20716187,83
"12880","ENSG00000207642","MIR571","4",343946,344041,95
"12881","ENSG00000207643","","4",65017,65125,108
"12882","ENSG00000207652","MIR621","13",41384902,41384997,95
"12883","ENSG00000207697","MIR573","4",24521815,24521913,98
"12884","ENSG00000207709","MIR197","1",110141515,110141589,74
"12885","ENSG00000207721","MIR186","1",71533314,71533399,85
"12886","ENSG00000207741","MIR590","7",73605528,73605624,96
"12887","ENSG00000207770","MIR568","3",114035322,114035416,94
"12888","ENSG00000207798","MIR216A","2",56216085,56216194,109
"12889","ENSG00000207816","MIR124-2","8",65291706,65291814,108
"12890","ENSG00000207827","MIR30A","6",72113254,72113324,70
"12891","ENSG00000207863","MIR125B2","21",17962557,17962645,88
"12892","ENSG00000207870","MIR221","X",45605585,45605694,109
"12893","ENSG00000207926","MIR135A1","3",52328235,52328324,89
"12894","ENSG00000207934","MIR654","14",101506556,101506636,80
"12895","ENSG00000207951","MIR561","2",189162219,189162315,96
"12896","ENSG00000207955","MIR219-2","9",131154291,131155789,1498
"12897","ENSG00000207961","MIR496","14",101526910,101527011,101
"12898","ENSG00000207963","MIR569","3",170824453,170824548,95
"12899","ENSG00000207971","MIR125B1","11",121970465,121970552,87
"12900","ENSG00000207978","MIR154","14",101526092,101526175,83
"12901","ENSG00000207993","MIR134","14",101521008,101521110,102
"12902","ENSG00000207995","MIR325","X",76225829,76225926,97
"12903","ENSG00000208001","MIR431","14",101347344,101347457,113
"12904","ENSG00000208009","MIR130A","11",57408671,57408759,88
"12905","ENSG00000208018","MIR645","20",49202323,49202416,93
"12906","ENSG00000208027","MIR485","14",101521738,101521848,110
"12907","ENSG00000208028","MIR616","12",57912946,57913042,96
"12908","ENSG00000208308","","2",135894198,135894325,127
"12909","ENSG00000208772","SNORD94","2",86362993,86363129,136
"12910","ENSG00000208892","SNORA49","12",132515769,132515904,135
"12911","ENSG00000209042","SNORD12C","20",47895477,47895565,88
"12912","ENSG00000209082","MT-TL1","MT",3230,3304,74
"12913","ENSG00000209482","SNORD83A","22",39711218,39711312,94
"12914","ENSG00000210049","MT-TF","MT",577,647,70
"12915","ENSG00000210077","MT-TV","MT",1602,1670,68
"12916","ENSG00000210082","MT-RNR2","MT",1671,3229,1558
"12917","ENSG00000210107","MT-TQ","MT",4329,4400,71
"12918","ENSG00000210117","MT-TW","MT",5512,5579,67
"12919","ENSG00000210144","MT-TY","MT",5826,5891,65
"12920","ENSG00000210151","MT-TS1","MT",7446,7514,68
"12921","ENSG00000210195","MT-TT","MT",15888,15953,65
"12922","ENSG00000210196","MT-TP","MT",15956,16023,67
"12923","ENSG00000211445","GPX3","5",150400124,150408554,8430
"12924","ENSG00000211448","DIO2","14",80663873,80854100,190227
"12925","ENSG00000211450","C11orf31","11",57508825,57510986,2161
"12926","ENSG00000211454","AKR7L","1",19592476,19600688,8212
"12927","ENSG00000211455","STK38L","12",27396901,27478892,81991
"12928","ENSG00000211456","SACM1L","3",45730548,45786916,56368
"12929","ENSG00000211459","MT-RNR1","MT",648,1601,953
"12930","ENSG00000211460","TSN","2",122494679,122525429,30750
"12931","ENSG00000211514","MIR454","17",57215119,57215233,114
"12932","ENSG00000211544","","7",3458699,3458781,82
"12933","ENSG00000211553","","4",130242,130349,107
"12934","ENSG00000211574","MIR770","14",101318727,101318824,97
"12935","ENSG00000211577","","12",66251793,66251912,119
"12936","ENSG00000211584","SLC48A1","12",48147699,48176536,28837
"12937","ENSG00000211825","TRDJ1","14",22919081,22919131,50
"12938","ENSG00000211829","TRDC","14",22931924,22934779,2855
"12939","ENSG00000212027","MIR374B","X",73438382,73438453,71
"12940","ENSG00000212124","TAS2R19","12",11174218,11175219,1001
"12941","ENSG00000212125","TAS2R15","12",11117024,11117951,927
"12942","ENSG00000212126","TAS2R50","12",11138512,11139511,999
"12943","ENSG00000212127","TAS2R14","12",11090005,11324172,234167
"12944","ENSG00000212128","TAS2R13","12",11060525,11062161,1636
"12945","ENSG00000212195","","17",56709003,56709197,194
"12946","ENSG00000212232","SNORD17","20",17943353,17943589,236
"12947","ENSG00000212270","","14",26275854,26275918,64
"12948","ENSG00000212296","SNORD72","5",40832758,40832837,79
"12949","ENSG00000212304","SNORD12","20",47897220,47897309,89
"12950","ENSG00000212371","","14",77932627,77932779,152
"12951","ENSG00000212384","SNORD113-2","14",101393679,101393750,71
"12952","ENSG00000212402","SNORA74B","5",172447731,172447931,200
"12953","ENSG00000212443","SNORA53","12",98993413,98993661,248
"12954","ENSG00000212452","SNORD69","3",52726752,52726828,76
"12955","ENSG00000212456","RNVU1-13","1",147994146,147994313,167
"12956","ENSG00000212464","SNORA12","10",101996913,101997059,146
"12957","ENSG00000212493","SNORD19","3",52723264,52723331,67
"12958","ENSG00000212534","SNORD70","2",203141154,203141241,87
"12959","ENSG00000212552","SNORD91B","17",2232413,2232507,94
"12960","ENSG00000212588","SNORA26","4",53579416,53579537,121
"12961","ENSG00000212607","SNORA45","11",8706986,8707116,130
"12962","ENSG00000212615","","14",45557446,45557511,65
"12963","ENSG00000212670","","1",54569968,54571750,1782
"12964","ENSG00000212694","","12",122233173,122241812,8639
"12965","ENSG00000212719","C17orf51","17",21428051,21477722,49671
"12966","ENSG00000212747","FAM127C","X",134154543,134156559,2016
"12967","ENSG00000212802","RPL15P3","6",12514342,12515006,664
"12968","ENSG00000212907","MT-ND4L","MT",10470,10766,296
"12969","ENSG00000212916","MAP10","1",232940643,232946092,5449
"12970","ENSG00000212951","","9",46842616,46844326,1710
"12971","ENSG00000212978","","2",61368732,61372104,3372
"12972","ENSG00000213015","ZNF580","19",56146382,56154835,8453
"12973","ENSG00000213020","ZNF611","19",53206066,53238326,32260
"12974","ENSG00000213024","NUP62","19",50410082,50433020,22938
"12975","ENSG00000213047","DENND1B","1",197473878,197744826,270948
"12976","ENSG00000213057","C1orf220","1",178511887,178518024,6137
"12977","ENSG00000213058","","1",178380751,178381107,356
"12978","ENSG00000213062","","1",169455380,169456846,1466
"12979","ENSG00000213064","SFT2D2","1",168195176,168222263,27087
"12980","ENSG00000213066","FGFR1OP","6",167412670,167466201,53531
"12981","ENSG00000213071","LPAL2","6",160874460,160932156,57696
"12982","ENSG00000213073","","6",160514114,160517244,3130
"12983","ENSG00000213079","SCAF8","6",155054459,155155192,100733
"12984","ENSG00000213088","DARC","1",159173097,159176290,3193
"12985","ENSG00000213089","PDCL3P5","6",151148799,151149520,721
"12986","ENSG00000213090","","2",202275267,202278031,2764
"12987","ENSG00000213096","ZNF254","19",24216276,24312654,96378
"12988","ENSG00000213123","TCTEX1D2","3",196018090,196045170,27080
"12989","ENSG00000213131","YWHAZP4","6",127676901,127677934,1033
"12990","ENSG00000213132","","3",187896331,187898598,2267
"12991","ENSG00000213139","CRYGS","3",186256230,186264491,8261
"12992","ENSG00000213152","RPL7AP60","12",112739674,112740467,793
"12993","ENSG00000213160","KLHL23","2",170550998,170633499,82501
"12994","ENSG00000213186","TRIM59","3",160150233,160203561,53328
"12995","ENSG00000213189","BTF3L4P2","2",159860287,159861065,778
"12996","ENSG00000213190","MLLT11","1",151030234,151040970,10736
"12997","ENSG00000213197","","2",153246451,153247144,693
"12998","ENSG00000213204","C6orf165","6",88117730,88221352,103622
"12999","ENSG00000213240","NOTCH2NL","1",145209119,145291972,82853
"13000","ENSG00000213246","SUPT4H1","17",56422539,56430454,7915
"13001","ENSG00000213281","NRAS","1",115247090,115259515,12425
"13002","ENSG00000213337","ANKRD39","2",97502348,97523832,21484
"13003","ENSG00000213339","QTRT1","19",10812106,10824113,12007
"13004","ENSG00000213341","CHUK","10",101948055,101989376,41321
"13005","ENSG00000213347","MXD3","5",176728462,176739758,11296
"13006","ENSG00000213366","GSTM2","1",110210644,110252171,41527
"13007","ENSG00000213380","COG8","16",69354043,69373570,19527
"13008","ENSG00000213385","","7",102395593,102396386,793
"13009","ENSG00000213390","ARHGAP19","10",98978996,99052413,73417
"13010","ENSG00000213398","LCAT","16",67973653,67978034,4381
"13011","ENSG00000213411","RBM22P2","13",31113734,31117598,3864
"13012","ENSG00000213420","GPC2","7",99767229,99774995,7766
"13013","ENSG00000213442","RPL18AP3","12",104659056,104659669,613
"13014","ENSG00000213443","","12",9847980,9848823,843
"13015","ENSG00000213445","SIPA1","11",65405568,65418401,12833
"13016","ENSG00000213462","ERV3-1","7",64451187,64467121,15934
"13017","ENSG00000213463","SYNJ2BP","14",70838148,70883778,45630
"13018","ENSG00000213465","ARL2","11",64781585,64789656,8071
"13019","ENSG00000213468","","X",130836678,130964671,127993
"13020","ENSG00000213513","","10",79540095,79541634,1539
"13021","ENSG00000213516","RBMXL1","1",89445139,89458643,13504
"13022","ENSG00000213523","SRA1","5",139916925,139937895,20970
"13023","ENSG00000213533","TMEM110","3",52870235,52931612,61377
"13024","ENSG00000213540","","1",84551424,84551916,492
"13025","ENSG00000213551","DNAJC9","10",74943120,75008620,65500
"13026","ENSG00000213553","RPLP0P6","2",38708920,38710012,1092
"13027","ENSG00000213563","C8orf82","8",145751117,145754516,3399
"13028","ENSG00000213585","VDAC1","5",133307606,133340824,33218
"13029","ENSG00000213588","ZBTB9","6",33422356,33425325,2969
"13030","ENSG00000213593","TMX2","11",57480072,57508445,28373
"13031","ENSG00000213600","","3",50277054,50277416,362
"13032","ENSG00000213613","","10",89705259,89705781,522
"13033","ENSG00000213614","HEXA","15",72635775,72668817,33042
"13034","ENSG00000213619","NDUFS3","11",47586888,47606114,19226
"13035","ENSG00000213625","LEPROT","1",65886270,65901690,15420
"13036","ENSG00000213626","LBH","2",30454397,30546596,92199
"13037","ENSG00000213639","PPP1CB","2",28974506,29025806,51300
"13038","ENSG00000213654","GPSM3","6",32158543,32163300,4757
"13039","ENSG00000213672","NCKIPSD","3",48701364,48723797,22433
"13040","ENSG00000213676","ATF6B","6",32065953,32096030,30077
"13041","ENSG00000213689","TREX1","3",48506445,48509044,2599
"13042","ENSG00000213693","SEC14L1P1","11",43919006,43921186,2180
"13043","ENSG00000213694","S1PR3","9",91606362,91619925,13563
"13044","ENSG00000213699","SLC35F6","2",26987152,27004099,16947
"13045","ENSG00000213700","RPL17P50","10",74765591,74766353,762
"13046","ENSG00000213703","","1",63106793,63107338,545
"13047","ENSG00000213707","HMGB1P10","22",26956492,26957054,562
"13048","ENSG00000213719","CLIC1","6",31698358,31707540,9182
"13049","ENSG00000213722","DDAH2","6",31694815,31698394,3579
"13050","ENSG00000213741","RPS29","14",50043390,50065408,22018
"13051","ENSG00000213742","ZNF337-AS1","20",25604681,25658710,54029
"13052","ENSG00000213753","CENPBD1P1","19",59084870,59111168,26298
"13053","ENSG00000213760","ATP6V1G2","6",31512239,31516204,3965
"13054","ENSG00000213762","ZNF134","19",58125601,58134724,9123
"13055","ENSG00000213782","DDX47","12",12966250,12982915,16665
"13056","ENSG00000213793","ZNF888","19",53418449,53426723,8274
"13057","ENSG00000213799","ZNF845","19",53837002,53858122,21120
"13058","ENSG00000213842","SUGT1P2","3",32794402,32795393,991
"13059","ENSG00000213853","EMP2","16",10622279,10674555,52276
"13060","ENSG00000213859","KCTD11","17",7255208,7258258,3050
"13061","ENSG00000213865","C8orf44","8",67579850,67597799,17949
"13062","ENSG00000213866","YBX1P10","9",35971341,35972315,974
"13063","ENSG00000213888","","22",31742875,31744670,1795
"13064","ENSG00000213903","LTB4R","14",24780656,24787242,6586
"13065","ENSG00000213904","LIPE-AS1","19",42901280,43156507,255227
"13066","ENSG00000213918","DNASE1","16",3661729,3730144,68415
"13067","ENSG00000213923","CSNK1E","22",38686697,38794527,107830
"13068","ENSG00000213928","IRF9","14",24630262,24635774,5512
"13069","ENSG00000213930","GALT","9",34638130,34651032,12902
"13070","ENSG00000213949","ITGA1","5",52083730,52255040,171310
"13071","ENSG00000213963","","2",178148236,178257419,109183
"13072","ENSG00000213965","NUDT19","19",33182867,33204702,21835
"13073","ENSG00000213967","ZNF726","19",24097678,24127961,30283
"13074","ENSG00000213971","","19",23442708,23457053,14345
"13075","ENSG00000213976","","19",21565667,21569979,4312
"13076","ENSG00000213977","TAX1BP3","17",3566196,3571976,5780
"13077","ENSG00000213983","AP1G2","14",24028774,24037279,8505
"13078","ENSG00000213988","ZNF90","19",20188803,20237885,49082
"13079","ENSG00000213995","CARKD","13",111267881,111292340,24459
"13080","ENSG00000213996","TM6SF2","19",19375173,19384200,9027
"13081","ENSG00000214013","GANC","15",42565431,42645864,80433
"13082","ENSG00000214021","TTLL3","3",9849770,9896822,47052
"13083","ENSG00000214022","REPIN1","7",150065278,150071133,5855
"13084","ENSG00000214026","MRPL23","11",1968508,2005752,37244
"13085","ENSG00000214029","ZNF891","12",133694740,133707059,12319
"13086","ENSG00000214046","SMIM7","19",16741562,16771253,29691
"13087","ENSG00000214050","FBXO16","8",28205804,28347835,142031
"13088","ENSG00000214063","TSPAN4","11",842808,867116,24308
"13089","ENSG00000214067","","10",112016822,112017601,779
"13090","ENSG00000214076","CPSF1P1","22",32665368,32669097,3729
"13091","ENSG00000214078","CPNE1","20",34213953,34252878,38925
"13092","ENSG00000214087","ARL16","17",79648204,79650954,2750
"13093","ENSG00000214110","LDHAP4","9",14921335,14922332,997
"13094","ENSG00000214113","LYRM4","6",5102827,5261172,158345
"13095","ENSG00000214114","MYCBP","1",39328636,39347289,18653
"13096","ENSG00000214135","","3",197305084,197354777,49693
"13097","ENSG00000214160","ALG3","3",183960089,183967336,7247
"13098","ENSG00000214174","AMZ2P1","17",62962668,62971694,9026
"13099","ENSG00000214176","PLEKHM1P","17",62775377,62833272,57895
"13100","ENSG00000214182","PTMAP5","13",82264046,82265207,1161
"13101","ENSG00000214188","ST7-OT4","7",116593953,116738860,144907
"13102","ENSG00000214189","ZNF788","19",12203078,12248050,44972
"13103","ENSG00000214193","SH3D21","1",36771988,36790484,18496
"13104","ENSG00000214194","LINC00998","7",112756773,112758668,1895
"13105","ENSG00000214198","","12",104237527,104323989,86462
"13106","ENSG00000214223","HNRNPA1P10","19",11776884,11777845,961
"13107","ENSG00000214226","C17orf67","17",54869274,54916134,46860
"13108","ENSG00000214239","","6",159047471,159049322,1851
"13109","ENSG00000214248","","19",7963689,7968427,4738
"13110","ENSG00000214253","FIS1","7",100882739,100895597,12858
"13111","ENSG00000214279","","10",135267432,135337062,69630
"13112","ENSG00000214293","RSBN1L-AS1","7",77286977,77325582,38605
"13113","ENSG00000214331","","16",74366300,74402138,35838
"13114","ENSG00000214338","SOGA3","6",127759551,127840500,80949
"13115","ENSG00000214357","NEURL1B","5",172068269,172118543,50274
"13116","ENSG00000214367","HAUS3","4",2229191,2243891,14700
"13117","ENSG00000214381","LINC00488","3",108897012,108904104,7092
"13118","ENSG00000214389","RPS3AP26","7",98015113,98015896,783
"13119","ENSG00000214391","","11",90015728,90017340,1612
"13120","ENSG00000214401","KANSL1-AS1","17",44270942,44274089,3147
"13121","ENSG00000214413","BBIP1","10",112658488,112679032,20544
"13122","ENSG00000214425","LRRC37A4P","17",43578685,43627701,49016
"13123","ENSG00000214433","","15",90835194,90838915,3721
"13124","ENSG00000214439","FAM185BP","7",76713203,76751433,38230
"13125","ENSG00000214455","RCN1P2","13",45964486,45965402,916
"13126","ENSG00000214456","PLIN5","19",4522543,4535236,12693
"13127","ENSG00000214485","RPL7P1","5",149473860,149474619,759
"13128","ENSG00000214491","SEC14L6","22",30918786,30942669,23883
"13129","ENSG00000214517","PPME1","11",73882144,73965748,83604
"13130","ENSG00000214530","STARD10","11",72465774,72504726,38952
"13131","ENSG00000214548","MEG3","14",101245747,101327368,81621
"13132","ENSG00000214562","NUTM2D","10",89117425,89130452,13027
"13133","ENSG00000214595","EML6","2",54950636,55199157,248521
"13134","ENSG00000214654","","9",123555829,123561848,6019
"13135","ENSG00000214655","ZSWIM8","10",75545340,75561551,16211
"13136","ENSG00000214676","RPL9P16","4",169676967,169677533,566
"13137","ENSG00000214694","ARHGEF33","2",39117021,39202590,85569
"13138","ENSG00000214706","IFRD2","3",50325163,50330349,5186
"13139","ENSG00000214717","ZBED1","X",2404455,2419008,14553
"13140","ENSG00000214719","","17",28903482,28999807,96325
"13141","ENSG00000214753","HNRNPUL2","11",62480102,62494821,14719
"13142","ENSG00000214756","METTL12","11",62432781,62435968,3187
"13143","ENSG00000214765","SEPT7P2","7",45763379,45808617,45238
"13144","ENSG00000214770","","14",64796149,64805317,9168
"13145","ENSG00000214773","","3",47643205,47646167,2962
"13146","ENSG00000214776","","12",9620148,9728864,108716
"13147","ENSG00000214783","POLR2J4","7",43980494,44058774,78280
"13148","ENSG00000214796","","1",202820956,202830748,9792
"13149","ENSG00000214814","FER1L6","8",124864227,125132302,268075
"13150","ENSG00000214826","DDX12P","12",9570309,9600825,30516
"13151","ENSG00000214827","MTCP1","X",154289897,154376212,86315
"13152","ENSG00000214870","","7",26438213,26538594,100381
"13153","ENSG00000214919","","3",155459933,155461515,1582
"13154","ENSG00000214941","ZSWIM7","17",15879874,15903031,23157
"13155","ENSG00000214954","LRRC69","8",92114060,92231464,117404
"13156","ENSG00000214960","ISPD","7",16130817,16460947,330130
"13157","ENSG00000214982","PARGP1","10",51623417,51732824,109407
"13158","ENSG00000215012","C22orf29","22",19833661,19842419,8758
"13159","ENSG00000215018","COL28A1","7",7395834,7575484,179650
"13160","ENSG00000215021","PHB2","12",7074490,7079988,5498
"13161","ENSG00000215022","","6",13265093,13295818,30725
"13162","ENSG00000215030","RPL13P12","17",17286691,17287326,635
"13163","ENSG00000215039","CD27-AS1","12",6548167,6560733,12566
"13164","ENSG00000215041","NEURL4","17",7218947,7232712,13765
"13165","ENSG00000215067","","17",6779954,6915668,135714
"13166","ENSG00000215068","","5",43041677,43045492,3815
"13167","ENSG00000215089","KRT18P11","X",91714669,91715951,1282
"13168","ENSG00000215105","TTC3P1","X",74960541,74966749,6208
"13169","ENSG00000215114","UBXN2B","8",59323823,59364060,40237
"13170","ENSG00000215142","","9",40491622,40633282,141660
"13171","ENSG00000215146","","10",42827314,42863422,36108
"13172","ENSG00000215154","","16",2653351,2680495,27144
"13173","ENSG00000215158","","5",34164803,34244901,80098
"13174","ENSG00000215184","","10",34964563,34964969,406
"13175","ENSG00000215190","LINC00680","6",58272352,58287779,15427
"13176","ENSG00000215193","PEX26","22",18560689,18613905,53216
"13177","ENSG00000215196","","5",17130137,17217156,87019
"13178","ENSG00000215218","UBE2QL1","5",6448736,6495022,46286
"13179","ENSG00000215223","CYP51A1P3","6",148799829,148801899,2070
"13180","ENSG00000215251","FASTKD5","20",3127165,3140543,13378
"13181","ENSG00000215252","GOLGA8B","15",34817408,34880704,63296
"13182","ENSG00000215256","DHRS4-AS1","14",24407940,24458048,50108
"13183","ENSG00000215271","HOMEZ","14",23741666,23768656,26990
"13184","ENSG00000215301","DDX3X","X",41192651,41223725,31074
"13185","ENSG00000215302","","15",30762982,30799826,36844
"13186","ENSG00000215305","VPS16","20",2821349,2847378,26029
"13187","ENSG00000215346","","8",10983980,10987745,3765
"13188","ENSG00000215374","FAM66B","8",7159133,7212876,53743
"13189","ENSG00000215375","MYL5","4",667369,675822,8453
"13190","ENSG00000215386","LINC00478","21",17442842,17999716,556874
"13191","ENSG00000215388","ACTG1P3","20",1141228,1142341,1113
"13192","ENSG00000215417","MIR17HG","13",92000074,92006833,6759
"13193","ENSG00000215421","ZNF407","18",72265106,72777627,512521
"13194","ENSG00000215424","MCM3AP-AS1","21",47649131,47679304,30173
"13195","ENSG00000215440","NPEPL1","20",57264187,57294294,30107
"13196","ENSG00000215447","","21",46707967,46711653,3686
"13197","ENSG00000215452","ZNF663P","20",45042867,45087915,45048
"13198","ENSG00000215475","SIAH3","13",46354405,46425871,71466
"13199","ENSG00000215492","HNRNPA1P7","18",29991471,29993167,1696
"13200","ENSG00000215504","","11",85563600,85565986,2386
"13201","ENSG00000215513","PI4KAP1","22",20383524,20427835,44311
"13202","ENSG00000215515","IFIT1P1","13",32958797,32960245,1448
"13203","ENSG00000215548","","9",68427861,68455375,27514
"13204","ENSG00000215630","GUSBP9","5",70435716,70585611,149895
"13205","ENSG00000215712","TMEM242","6",157710418,157744633,34215
"13206","ENSG00000215717","TMEM167B","1",109632425,109639556,7131
"13207","ENSG00000215769","","17",62745781,62778117,32336
"13208","ENSG00000215784","FAM72D","1",143896452,143913143,16691
"13209","ENSG00000215788","TNFRSF25","1",6521211,6526255,5044
"13210","ENSG00000215790","SLC35E2","1",1656277,1677431,21154
"13211","ENSG00000215808","LINC01139","1",238643684,238649323,5639
"13212","ENSG00000215875","ST13P20","1",82187378,82188753,1375
"13213","ENSG00000215883","CYB5RL","1",54638009,54665709,27700
"13214","ENSG00000215908","CROCCP2","1",16944751,16971178,26427
"13215","ENSG00000215912","TTC34","1",2567415,2718286,150871
"13216","ENSG00000215957","MIR300","14",101507700,101507782,82
"13217","ENSG00000216116","","3",79633742,79633834,92
"13218","ENSG00000216775","","6",52529946,52533953,4007
"13219","ENSG00000216809","","6",118773632,118776155,2523
"13220","ENSG00000216895","","7",155403925,155437899,33974
"13221","ENSG00000216937","CCDC7","10",32735068,32863492,128424
"13222","ENSG00000216977","RPL21P65","6",107090338,107090803,465
"13223","ENSG00000217128","FNIP1","5",130977407,131132710,155303
"13224","ENSG00000217236","SP9","2",175199674,175203220,3546
"13225","ENSG00000217512","","6",79777409,79777855,446
"13226","ENSG00000217527","RPS16P5","6",53201741,53202144,403
"13227","ENSG00000217555","CKLF","16",66586466,66600154,13688
"13228","ENSG00000217648","","6",143663383,143664520,1137
"13229","ENSG00000217930","PAM16","16",4381550,4405608,24058
"13230","ENSG00000218283","MORF4L1P1","1",220426912,220427878,966
"13231","ENSG00000218336","TENM3","4",183065140,183724177,659037
"13232","ENSG00000218358","RAET1K","6",150319155,150326293,7138
"13233","ENSG00000218418","","6",80774003,80779916,5913
"13234","ENSG00000218422","","4",1741078,1743830,2752
"13235","ENSG00000218426","","6",153603422,153603868,446
"13236","ENSG00000218510","LINC00339","1",22351681,22357716,6035
"13237","ENSG00000218537","","22",24236613,24241117,4504
"13238","ENSG00000218596","","6",157297428,157298206,778
"13239","ENSG00000218739","CEBPZ-AS1","2",37423631,37443336,19705
"13240","ENSG00000218823","PAPOLB","7",4897364,4901625,4261
"13241","ENSG00000218891","ZNF579","19",56088899,56092211,3312
"13242","ENSG00000218996","","6",151256104,151256702,598
"13243","ENSG00000219085","NPM1P37","6",70415179,70416052,873
"13244","ENSG00000219133","","1",204315904,204316386,482
"13245","ENSG00000219200","RNASEK","17",6915736,6917851,2115
"13246","ENSG00000219395","HSPA8P15","6",151732394,151735080,2686
"13247","ENSG00000219438","FAM19A5","22",48885272,49246724,361452
"13248","ENSG00000219470","","6",43506559,43507440,881
"13249","ENSG00000219481","NBPF1","1",16888814,16940057,51243
"13250","ENSG00000219545","RPA3-AS1","7",7680342,8043689,363347
"13251","ENSG00000219626","FAM228B","2",24299396,24392509,93113
"13252","ENSG00000219665","","19",12098432,12157090,58658
"13253","ENSG00000219712","","6",669081,670307,1226
"13254","ENSG00000220161","","17",18314473,18317694,3221
"13255","ENSG00000220201","ZGLP1","19",10415479,10420556,5077
"13256","ENSG00000220205","VAMP2","17",8062467,8066864,4397
"13257","ENSG00000220517","ASS1P1","6",25023475,25024711,1236
"13258","ENSG00000220563","PKMP3","6",86369610,86370324,714
"13259","ENSG00000220685","","6",5066029,5067216,1187
"13260","ENSG00000220744","RPL5P18","6",127683658,127684548,890
"13261","ENSG00000220749","RPL21P28","1",212224829,212225371,542
"13262","ENSG00000220785","MTMR9LP","1",32697259,32707221,9962
"13263","ENSG00000220804","","2",243030784,243102304,71520
"13264","ENSG00000220842","","10",122114177,122114718,541
"13265","ENSG00000220848","RPS18P9","6",149915220,149915679,459
"13266","ENSG00000220867","HSPE1P26","6",158345434,158345708,274
"13267","ENSG00000221063","MIR1296","10",65132717,65132808,91
"13268","ENSG00000221066","SNORD111","16",70571908,70572001,93
"13269","ENSG00000221100","","13",37608814,37608929,115
"13270","ENSG00000221164","","10",74885838,74885965,127
"13271","ENSG00000221184","MIR1254-1","10",70519075,70519171,96
"13272","ENSG00000221203","MIR1262","1",68649201,68649293,92
"13273","ENSG00000221211","","3",122645843,122645968,125
"13274","ENSG00000221216","RNU6ATAC27P","1",28807874,28807992,118
"13275","ENSG00000221227","MIR1305","4",183090446,183090531,85
"13276","ENSG00000221291","","18",50463664,50463773,109
"13277","ENSG00000221319","","20",29637162,29637300,138
"13278","ENSG00000221479","MIR1251","12",97885678,97885761,83
"13279","ENSG00000221491","SNORA34","12",49048165,49048301,136
"13280","ENSG00000221500","SNORD100","6",133137941,133138016,75
"13281","ENSG00000221514","SNORD111B","16",70563412,70563491,79
"13282","ENSG00000221539","SNORD99","1",28905261,28905334,73
"13283","ENSG00000221614","MIR1185-2","14",101510535,101510620,85
"13284","ENSG00000221625","","12",98999652,98999738,86
"13285","ENSG00000221639","","4",74129677,74129801,124
"13286","ENSG00000221676","RNU6ATAC","9",137029561,137029686,125
"13287","ENSG00000221716","SNORA11","X",54840803,54840930,127
"13288","ENSG00000221782","MIR548F2","2",213290987,213291084,97
"13289","ENSG00000221817","","10",75255283,75279828,24545
"13290","ENSG00000221818","EBF2","8",25699246,25902913,203667
"13291","ENSG00000221823","PPP3R1","2",68405989,68483369,77380
"13292","ENSG00000221829","FANCG","9",35073832,35080013,6181
"13293","ENSG00000221838","AP4M1","7",99699172,99707968,8796
"13294","ENSG00000221866","PLXNA4","7",131808091,132333447,525356
"13295","ENSG00000221883","ARIH2OS","3",48955221,48956818,1597
"13296","ENSG00000221886","C5orf54","5",159820155,159827104,6949
"13297","ENSG00000221890","NPTXR","22",39214457,39239987,25530
"13298","ENSG00000221909","FAM200A","7",99143931,99156159,12228
"13299","ENSG00000221914","PPP2R2A","8",26149007,26230196,81189
"13300","ENSG00000221923","ZNF880","19",52873170,52889048,15878
"13301","ENSG00000221926","TRIM16","17",15531274,15587625,56351
"13302","ENSG00000221944","TIGD1","2",233412779,233415226,2447
"13303","ENSG00000221949","C12orf61","12",62995531,62997214,1683
"13304","ENSG00000221955","SLC12A8","3",124801480,124998021,196541
"13305","ENSG00000221963","APOL6","22",36044442,36064456,20014
"13306","ENSG00000221968","FADS3","11",61640991,61659523,18532
"13307","ENSG00000221978","CCNL2","1",1321091,1334708,13617
"13308","ENSG00000221983","UBA52","19",18682540,18688360,5820
"13309","ENSG00000221988","PPT2","6",32121218,32134011,12793
"13310","ENSG00000221990","C5orf55","5",441645,443258,1613
"13311","ENSG00000221994","ZNF630","X",47842756,47931025,88269
"13312","ENSG00000221995","TIAF1","17",27400537,27418537,18000
"13313","ENSG00000222000","","2",98947852,98972468,24616
"13314","ENSG00000222009","BTBD19","1",45274154,45281257,7103
"13315","ENSG00000222011","FAM185A","7",102389418,102449672,60254
"13316","ENSG00000222040","ADRA2B","2",96778707,96781984,3277
"13317","ENSG00000222041","LINC00152","2",87754887,87906324,151437
"13318","ENSG00000222068","RN7SKP154","2",134148681,134148970,289
"13319","ENSG00000222112","RN7SKP16","1",33802167,33802465,298
"13320","ENSG00000222185","","14",101464804,101464878,74
"13321","ENSG00000222345","","3",52725394,52725469,75
"13322","ENSG00000222365","SNORD12B","20",47896856,47896946,90
"13323","ENSG00000222414","RNU2-59P","10",103124602,103124792,190
"13324","ENSG00000222482","","7",99817650,99817743,93
"13325","ENSG00000222489","","14",20791338,20791485,147
"13326","ENSG00000222533","RNU6-705P","5",180728968,180729071,103
"13327","ENSG00000222724","RNU2-63P","2",88315873,88316066,193
"13328","ENSG00000222881","","17",38547484,38547590,106
"13329","ENSG00000222894","","6",30584006,30584082,76
"13330","ENSG00000222937","","5",137894659,137894728,69
"13331","ENSG00000223001","RNU2-61P","6",89773219,89773409,190
"13332","ENSG00000223006","RN7SKP137","4",121982327,121982633,306
"13333","ENSG00000223044","RNU6-130P","6",82920055,82920157,102
"13334","ENSG00000223224","SNORD71","16",71792305,71792390,85
"13335","ENSG00000223247","RNU2-64P","3",73160143,73160333,190
"13336","ENSG00000223305","RN7SKP30","4",56406669,56407002,333
"13337","ENSG00000223336","RNU2-6P","13",46948536,46948725,189
"13338","ENSG00000223345","HIST2H2BA","1",120906028,120915073,9045
"13339","ENSG00000223380","SEC22B","1",145096220,145116922,20702
"13340","ENSG00000223393","","1",231010592,231014761,4169
"13341","ENSG00000223403","MEG9","14",101536248,101539274,3026
"13342","ENSG00000223459","FAM115B","7",143295133,143305111,9978
"13343","ENSG00000223473","","7",65956083,65958553,2470
"13344","ENSG00000223478","","9",131486724,131495473,8749
"13345","ENSG00000223482","NUTM2A-AS1","10",88963632,89102369,138737
"13346","ENSG00000223496","EXOSC6","16",70284134,70285833,1699
"13347","ENSG00000223501","VPS52","6",33218049,33239824,21775
"13348","ENSG00000223508","RPL23AP53","8",163186,182231,19045
"13349","ENSG00000223509","","15",32812049,32829127,17078
"13350","ENSG00000223518","CSNK1A1P1","15",37090797,37110660,19863
"13351","ENSG00000223546","LINC00630","X",102024089,102140334,116245
"13352","ENSG00000223547","ZNF844","19",12175514,12192380,16866
"13353","ENSG00000223561","","7",25632971,25790614,157643
"13354","ENSG00000223573","TINCR","19",5558178,5568045,9867
"13355","ENSG00000223584","TVP23CP1","7",90261220,90261882,662
"13356","ENSG00000223599","","1",153824582,153825890,1308
"13357","ENSG00000223692","DIP2A-IT1","21",47882384,47889219,6835
"13358","ENSG00000223704","","22",27254597,27261749,7152
"13359","ENSG00000223705","NSUN5P1","7",75039605,75046066,6461
"13360","ENSG00000223745","","1",93727743,93811582,83839
"13361","ENSG00000223749","MIR503HG","X",133677367,133680741,3374
"13362","ENSG00000223756","TSSC2","11",3402191,3430208,28017
"13363","ENSG00000223760","MED15P9","2",130887194,130896990,9796
"13364","ENSG00000223764","","1",852245,856396,4151
"13365","ENSG00000223768","LINC00205","21",46713200,46717269,4069
"13366","ENSG00000223773","CD99P1","X",2527389,2575270,47881
"13367","ENSG00000223797","ENTPD3-AS1","3",40355293,40494820,139527
"13368","ENSG00000223802","CERS1","19",18979361,19007536,28175
"13369","ENSG00000223812","","3",191275113,191308145,33032
"13370","ENSG00000223813","","7",29553841,29603286,49445
"13371","ENSG00000223820","CFL1P1","10",89577685,89605369,27684
"13372","ENSG00000223865","HLA-DPB1","6",33043703,33054978,11275
"13373","ENSG00000223867","","7",16977849,16978181,332
"13374","ENSG00000223891","OSER1-AS1","20",42839600,42854667,15067
"13375","ENSG00000223922","ASS1P2","2",39037574,39038796,1222
"13376","ENSG00000223959","AFG3L1P","16",90038994,90068569,29575
"13377","ENSG00000223960","","2",179278666,179304970,26304
"13378","ENSG00000223969","","7",90219933,90226667,6734
"13379","ENSG00000224003","","22",26043228,26045199,1971
"13380","ENSG00000224005","","10",75473354,75473609,255
"13381","ENSG00000224016","","7",149588280,149606793,18513
"13382","ENSG00000224020","MIR181A2HG","9",127420746,127460910,40164
"13383","ENSG00000224023","","10",127389005,127408135,19130
"13384","ENSG00000224032","EPB41L4A-AS1","5",111496223,111499973,3750
"13385","ENSG00000224043","CCNT2-AS1","2",135493034,135676280,183246
"13386","ENSG00000224046","","7",86780739,86781736,997
"13387","ENSG00000224051","GLTPD1","1",1260136,1264277,4141
"13388","ENSG00000224066","","1",32670370,32672415,2045
"13389","ENSG00000224078","SNHG14","15",25223730,25664609,440879
"13390","ENSG00000224080","UBE2FP1","3",37185003,37185449,446
"13391","ENSG00000224081","LINC01057","1",95104017,95285837,181820
"13392","ENSG00000224086","","22",22292609,22297799,5190
"13393","ENSG00000224113","","17",33332107,33336762,4655
"13394","ENSG00000224152","","2",160471807,160473593,1786
"13395","ENSG00000224165","DNAJC27-AS1","2",25194259,25262563,68304
"13396","ENSG00000224216","","X",154564167,154581271,17104
"13397","ENSG00000224243","LINC00403","13",112761433,112762329,896
"13398","ENSG00000224281","SLC25A5-AS1","X",118599997,118603061,3064
"13399","ENSG00000224287","MSL3P1","2",234774083,234777090,3007
"13400","ENSG00000224294","","X",43036243,43085847,49604
"13401","ENSG00000224315","RPL7P7","1",8846270,8846972,702
"13402","ENSG00000224331","","2",165543797,165544106,309
"13403","ENSG00000224349","","6",71122531,71123653,1122
"13404","ENSG00000224356","","13",101187995,101232371,44376
"13405","ENSG00000224358","","1",165738166,165744413,6247
"13406","ENSG00000224382","LINC00703","10",4426438,4452804,26366
"13407","ENSG00000224388","BACE2-IT1","21",42552024,42552553,529
"13408","ENSG00000224418","STK24-AS1","13",99229498,99231084,1586
"13409","ENSG00000224420","ADM5","19",50191921,50193832,1911
"13410","ENSG00000224424","PRKAR2A-AS1","3",48885005,48889414,4409
"13411","ENSG00000224430","MKRN5P","X",73380897,73382363,1466
"13412","ENSG00000224451","ATP5F1P1","13",52172552,52173596,1044
"13413","ENSG00000224464","PGAM1P6","2",24095138,24095884,746
"13414","ENSG00000224470","ATXN1L","16",71879894,71919171,39277
"13415","ENSG00000224474","","10",99179228,99185831,6603
"13416","ENSG00000224494","HNRNPA3P14","1",81892141,81893290,1149
"13417","ENSG00000224505","","17",43227767,43238877,11110
"13418","ENSG00000224531","SMIM13","6",11094266,11138964,44698
"13419","ENSG00000224546","EIF4BP3","9",98908289,98910138,1849
"13420","ENSG00000224578","HNRNPA1P48","16",51679667,51681043,1376
"13421","ENSG00000224592","","1",38512986,38584697,71711
"13422","ENSG00000224593","","7",3377521,3378233,712
"13423","ENSG00000224597","PTCHD3P1","10",29698331,29776674,78343
"13424","ENSG00000224616","","1",100729565,100731676,2111
"13425","ENSG00000224631","","16",61089303,61089868,565
"13426","ENSG00000224635","","20",37034658,37045444,10786
"13427","ENSG00000224660","SH3BP5-AS1","3",15295691,15306000,10309
"13428","ENSG00000224687","RASAL2-AS1","1",178060643,178063119,2476
"13429","ENSG00000224699","LAMTOR5-AS1","1",110925441,110974982,49541
"13430","ENSG00000224707","E2F3-IT1","6",20438052,20440409,2357
"13431","ENSG00000224728","","3",15919554,15921078,1524
"13432","ENSG00000224738","","17",57183959,57195628,11669
"13433","ENSG00000224745","","10",89638449,89640184,1735
"13434","ENSG00000224765","","X",136638350,136646546,8196
"13435","ENSG00000224790","","21",38338812,38344128,5316
"13436","ENSG00000224818","","1",201433511,201434274,763
"13437","ENSG00000224822","THRB-IT1","3",24496627,24500925,4298
"13438","ENSG00000224842","","9",129351873,129375979,24106
"13439","ENSG00000224861","YBX1P1","14",66479548,66480507,959
"13440","ENSG00000224870","","1",1334902,1337426,2524
"13441","ENSG00000224877","C17orf89","17",79213039,79215081,2042
"13442","ENSG00000224885","TSSC1-IT1","2",3302112,3305236,3124
"13443","ENSG00000224886","BEND3P3","10",81444250,81444739,489
"13444","ENSG00000224892","RPS4XP16","13",52028300,52035451,7151
"13445","ENSG00000224895","VPS26BP1","3",48001817,48002571,754
"13446","ENSG00000224897","POT1-AS1","7",124569927,124819369,249442
"13447","ENSG00000224905","","21",15399742,15516789,117047
"13448","ENSG00000224914","LINC00863","10",89102493,89117639,15146
"13449","ENSG00000224934","","10",101190948,101197874,6926
"13450","ENSG00000224945","","9",91703519,91724849,21330
"13451","ENSG00000224950","","1",117035645,117041834,6189
"13452","ENSG00000224958","PGM5-AS1","9",70970105,70972768,2663
"13453","ENSG00000224959","","2",112249520,112252388,2868
"13454","ENSG00000224975","INE1","X",47064320,47065264,944
"13455","ENSG00000224986","PPP1R8P1","1",48790752,48791795,1043
"13456","ENSG00000224997","","14",104177607,104179149,1542
"13457","ENSG00000225015","SNX18P15","1",142660017,142660749,732
"13458","ENSG00000225031","EIF4BP7","X",110862905,110864717,1812
"13459","ENSG00000225032","","9",130578345,130584799,6454
"13460","ENSG00000225077","LINC00337","1",6296300,6299504,3204
"13461","ENSG00000225091","SNORA71A","20",37055952,37056085,133
"13462","ENSG00000225092","","6",7183316,7185520,2204
"13463","ENSG00000225113","","1",110138847,110140403,1556
"13464","ENSG00000225125","RANP4","X",135889382,135890036,654
"13465","ENSG00000225135","","6",147708800,147711601,2801
"13466","ENSG00000225138","","5",473351,480999,7648
"13467","ENSG00000225151","GOLGA2P7","15",84867600,84898888,31288
"13468","ENSG00000225177","","6",139013685,139018425,4740
"13469","ENSG00000225190","PLEKHM1","17",43513266,43568115,54849
"13470","ENSG00000225192","ZNF33BP1","10",38083204,38085037,1833
"13471","ENSG00000225206","MIR137HG","1",98453556,98515419,61863
"13472","ENSG00000225215","SMARCE1P1","11",107274130,107275315,1185
"13473","ENSG00000225218","","21",44251150,44256587,5437
"13474","ENSG00000225224","","7",156985062,156985526,464
"13475","ENSG00000225241","","1",144593363,144621656,28293
"13476","ENSG00000225264","ZNRF2P2","7",29638411,29724871,86460
"13477","ENSG00000225265","","1",222763167,222766374,3207
"13478","ENSG00000225345","SNX18P3","9",38566257,38568208,1951
"13479","ENSG00000225349","","12",31687649,31688181,532
"13480","ENSG00000225361","PPP1R26-AS1","9",138354573,138372623,18050
"13481","ENSG00000225377","","20",300957,328868,27911
"13482","ENSG00000225423","TNPO1P1","10",86150664,86151801,1137
"13483","ENSG00000225439","BOLA3-AS1","2",74375136,74377188,2052
"13484","ENSG00000225447","RPS15AP10","1",46111488,46111869,381
"13485","ENSG00000225465","RFPL1S","22",29832818,29874164,41346
"13486","ENSG00000225470","JPX","X",73164159,73290243,126084
"13487","ENSG00000225471","","X",71364034,71381600,17566
"13488","ENSG00000225479","PLCB1-IT1","20",8229351,8237564,8213
"13489","ENSG00000225484","","10",81563813,81586350,22537
"13490","ENSG00000225485","ARHGAP23","17",36584662,36668628,83966
"13491","ENSG00000225527","","10",18820778,18822265,1487
"13492","ENSG00000225568","","1",87511558,87512383,825
"13493","ENSG00000225569","CCT4P2","X",64490793,64492899,2106
"13494","ENSG00000225579","EDNRB-AS1","13",78402357,78408085,5728
"13495","ENSG00000225648","SBDSP1","7",72300004,72307909,7905
"13496","ENSG00000225649","","2",13106910,13147138,40228
"13497","ENSG00000225663","FAM195B","17",79780287,79791178,10891
"13498","ENSG00000225693","","9",33019680,33020163,483
"13499","ENSG00000225697","SLC26A6","3",48663156,48672926,9770
"13500","ENSG00000225706","","9",8858130,8862255,4125
"13501","ENSG00000225733","FGD5-AS1","3",14961854,14989931,28077
"13502","ENSG00000225746","","14",101403738,101426536,22798
"13503","ENSG00000225750","","1",29471006,29473506,2500
"13504","ENSG00000225761","","10",75764895,75787673,22778
"13505","ENSG00000225783","MIAT","22",27042392,27072438,30046
"13506","ENSG00000225784","","10",51287081,51371070,83989
"13507","ENSG00000225791","TRAM2-AS1","6",52442105,52448783,6678
"13508","ENSG00000225792","","7",26411764,26416321,4557
"13509","ENSG00000225793","","6",75994730,76006719,11989
"13510","ENSG00000225806","","20",57438583,57463864,25281
"13511","ENSG00000225822","UBXN7-AS1","3",196158235,196160242,2007
"13512","ENSG00000225828","FAM229A","1",32826871,32829879,3008
"13513","ENSG00000225830","ERCC6","10",50663414,50747584,84170
"13514","ENSG00000225840","","Y",10036113,10036711,598
"13515","ENSG00000225849","MKRN7P","20",45092541,45093763,1222
"13516","ENSG00000225855","RUSC1-AS1","1",155286654,155293967,7313
"13517","ENSG00000225880","LINC00115","1",761586,762902,1316
"13518","ENSG00000225882","","X",17988317,18122764,134447
"13519","ENSG00000225889","","2",64370373,64479993,109620
"13520","ENSG00000225891","","1",26789247,26793773,4526
"13521","ENSG00000225921","NOL7","6",13615559,13632971,17412
"13522","ENSG00000225930","","15",30488239,30506743,18504
"13523","ENSG00000225945","","6",37783553,37786994,3441
"13524","ENSG00000225968","ELFN1","7",1727755,1787590,59835
"13525","ENSG00000225973","","15",55609382,55611359,1977
"13526","ENSG00000225975","","19",37176342,37178351,2009
"13527","ENSG00000226002","","7",64544481,64560610,16129
"13528","ENSG00000226007","","9",46843638,46846025,2387
"13529","ENSG00000226029","","1",16787443,16794976,7533
"13530","ENSG00000226031","FGF13-AS1","X",137793614,137798779,5165
"13531","ENSG00000226049","TLK2P1","17",32363700,32366891,3191
"13532","ENSG00000226053","","1",98676303,98738214,61911
"13533","ENSG00000226084","","1",77594768,77595384,616
"13534","ENSG00000226121","AHCTF1P1","2",162357396,162364216,6820
"13535","ENSG00000226137","BAIAP2-AS1","17",79002933,79008501,5568
"13536","ENSG00000226174","TEX22","14",105864916,105916443,51527
"13537","ENSG00000226180","","16",87727144,87729753,2609
"13538","ENSG00000226200","","10",52384711,52401211,16500
"13539","ENSG00000226210","","12",73725,91218,17493
"13540","ENSG00000226237","","9",89563614,89616948,53334
"13541","ENSG00000226254","PTP4A1P3","7",90736689,90737108,419
"13542","ENSG00000226259","GTF2H2B","5",69711179,69743885,32706
"13543","ENSG00000226266","","2",160527219,160568946,41727
"13544","ENSG00000226314","ZNF192P1","6",28129559,28137372,7813
"13545","ENSG00000226318","","10",69720459,69721221,762
"13546","ENSG00000226328","","22",45528901,45559662,30761
"13547","ENSG00000226380","MIR29B1","7",130561495,130598069,36574
"13548","ENSG00000226380","MIR29A","7",130561495,130598069,36574
"13549","ENSG00000226381","","10",81422844,81526085,103241
"13550","ENSG00000226383","","2",156868129,156881125,12996
"13551","ENSG00000226396","RPS14P3","1",19934608,19935062,454
"13552","ENSG00000226403","","9",547317,549531,2214
"13553","ENSG00000226419","SLC16A1-AS1","1",113499037,113542118,43081
"13554","ENSG00000226435","ANKRD18DP","3",197780393,197807591,27198
"13555","ENSG00000226450","CYP2D8P","22",42545877,42551007,5130
"13556","ENSG00000226471","","22",29196671,29244547,47876
"13557","ENSG00000226472","","12",31149973,31158938,8965
"13558","ENSG00000226479","TMEM185B","2",120978854,120980984,2130
"13559","ENSG00000226496","LINC00323","21",42513427,42520060,6633
"13560","ENSG00000226498","","1",236982934,236983818,884
"13561","ENSG00000226508","","2",105760571,105761882,1311
"13562","ENSG00000226520","KIRREL-IT1","1",157995340,158000956,5616
"13563","ENSG00000226524","","6",88032323,88109459,77136
"13564","ENSG00000226530","","X",51139363,51208513,69150
"13565","ENSG00000226555","AGKP1","Y",16750976,16752238,1262
"13566","ENSG00000226578","","10",38064299,38073059,8760
"13567","ENSG00000226632","UBE2V1P1","20",3342527,3342971,444
"13568","ENSG00000226674","TEX41","2",145425534,145940216,514682
"13569","ENSG00000226686","","19",37742814,37756437,13623
"13570","ENSG00000226688","ENTPD1-AS1","10",97512963,97849995,337032
"13571","ENSG00000226696","LENG8-AS1","19",54955991,54960223,4232
"13572","ENSG00000226702","","2",56190326,56274461,84135
"13573","ENSG00000226711","FAM66C","12",8332805,8368747,35942
"13574","ENSG00000226721","EEF1DP2","9",95599108,95599950,842
"13575","ENSG00000226752","PSMD5-AS1","9",123587106,123616651,29545
"13576","ENSG00000226754","","1",53704282,53708455,4173
"13577","ENSG00000226761","TAS2R46","12",11213964,11214893,929
"13578","ENSG00000226765","","3",168384347,168385211,864
"13579","ENSG00000226766","FABP7P1","1",243787968,243788358,390
"13580","ENSG00000226824","","7",66119525,66134842,15317
"13581","ENSG00000226833","","2",28931819,28959071,27252
"13582","ENSG00000226852","","1",29194087,29197779,3692
"13583","ENSG00000226864","ATE1-AS1","10",123687827,123711480,23653
"13584","ENSG00000226887","ERVMER34-1","4",53588785,53617807,29022
"13585","ENSG00000226891","","1",65437908,65468159,30251
"13586","ENSG00000226913","BSN-AS2","3",49586739,49591799,5060
"13587","ENSG00000226920","","1",229576031,229576767,736
"13588","ENSG00000226937","CEP164P1","10",45497670,45642669,144999
"13589","ENSG00000226950","DANCR","4",53578597,53586518,7921
"13590","ENSG00000226958","","X",108297361,108297792,431
"13591","ENSG00000226965","","7",110072296,110174811,102515
"13592","ENSG00000227001","NBPF2P","1",21751118,21754460,3342
"13593","ENSG00000227028","SLC8A1-AS1","2",40013593,40482349,468756
"13594","ENSG00000227036","LINC00511","17",70319264,70636611,317347
"13595","ENSG00000227051","C14orf132","14",96505661,96560417,54756
"13596","ENSG00000227057","WDR46","6",33246885,33257304,10419
"13597","ENSG00000227063","RPL41P1","20",21735866,21736171,305
"13598","ENSG00000227081","","12",3320775,3321096,321
"13599","ENSG00000227082","","1",121138614,121204983,66369
"13600","ENSG00000227097","","11",82400571,82400944,373
"13601","ENSG00000227110","LMCD1-AS1","3",7994492,8653610,659118
"13602","ENSG00000227124","ZNF717","3",75758794,75834734,75940
"13603","ENSG00000227165","WDR11-AS1","10",122521324,122610721,89397
"13604","ENSG00000227184","EPPK1","8",144939497,144952632,13135
"13605","ENSG00000227195","MIR663A","20",26167556,26232162,64606
"13606","ENSG00000227199","ST7-AS1","7",116592500,116594388,1888
"13607","ENSG00000227200","","9",127025155,127028088,2933
"13608","ENSG00000227232","WASH7P","1",14363,29806,15443
"13609","ENSG00000227248","FAM155A-IT1","13",108440690,108487799,47109
"13610","ENSG00000227252","","2",237968077,237994460,26383
"13611","ENSG00000227268","KLLN","10",89618918,89623194,4276
"13612","ENSG00000227285","","X",119055224,119056803,1579
"13613","ENSG00000227288","","1",81967479,81969153,1674
"13614","ENSG00000227318","","9",66664325,66665950,1625
"13615","ENSG00000227331","","2",159404937,159405736,799
"13616","ENSG00000227345","PARG","10",51026325,51130715,104390
"13617","ENSG00000227354","RBM26-AS1","13",79980444,79998463,18019
"13618","ENSG00000227372","TP73-AS1","1",3652548,3663900,11352
"13619","ENSG00000227382","EIF4A2P2","10",74959584,74960983,1399
"13620","ENSG00000227388","","9",35772160,35790429,18269
"13621","ENSG00000227398","KIF9-AS1","3",47205987,47288091,82104
"13622","ENSG00000227436","FCF1P1","7",23658952,23662445,3493
"13623","ENSG00000227450","","17",36905613,36906969,1356
"13624","ENSG00000227456","LINC00310","21",35552978,35562220,9242
"13625","ENSG00000227470","","2",109494764,109494916,152
"13626","ENSG00000227496","","1",225888306,225939945,51639
"13627","ENSG00000227500","SCAMP4","19",1905213,1926016,20803
"13628","ENSG00000227533","SLC2A1-AS1","1",43424720,43449029,24309
"13629","ENSG00000227540","","10",75012549,75014107,1558
"13630","ENSG00000227542","","2",192093891,192110898,17007
"13631","ENSG00000227558","PGM5P2","9",69080240,69147854,67614
"13632","ENSG00000227560","","10",114747235,114747624,389
"13633","ENSG00000227583","","10",70434113,70434857,744
"13634","ENSG00000227598","","6",167383114,167412553,29439
"13635","ENSG00000227603","","9",96197614,96199403,1789
"13636","ENSG00000227627","","6",153304885,153310358,5473
"13637","ENSG00000227640","SOX21-AS1","13",95364970,95368500,3530
"13638","ENSG00000227671","MIR3916","1",247353153,247374158,21005
"13639","ENSG00000227698","","21",43294865,43297722,2857
"13640","ENSG00000227704","","6",170125600,170139088,13488
"13641","ENSG00000227740","","1",175873898,175889649,15751
"13642","ENSG00000227745","","2",132890429,132897002,6573
"13643","ENSG00000227781","GLUD1P2","10",48952491,48980269,27778
"13644","ENSG00000227811","FAM212B-AS1","1",112282463,112290420,7957
"13645","ENSG00000227825","SLC9A7P1","12",98847613,98850923,3310
"13646","ENSG00000227827","","16",16450081,16471364,21283
"13647","ENSG00000227885","","6",53605547,53611820,6273
"13648","ENSG00000227888","FAM66A","8",12219527,12268510,48983
"13649","ENSG00000227896","","10",88281702,88284858,3156
"13650","ENSG00000227911","","13",33907816,33909414,1598
"13651","ENSG00000227946","","2",206949329,206951288,1959
"13652","ENSG00000227953","","1",246939315,246955687,16372
"13653","ENSG00000227960","","1",81970784,81971981,1197
"13654","ENSG00000227963","","1",110828997,110881793,52796
"13655","ENSG00000227986","TRIM60P18","7",63815456,63816577,1121
"13656","ENSG00000227992","","2",111961541,111963792,2251
"13657","ENSG00000228043","","2",139175854,139259268,83414
"13658","ENSG00000228065","","10",67330096,67526299,196203
"13659","ENSG00000228106","","1",222988364,223010726,22362
"13660","ENSG00000228107","","21",37732928,37734338,1410
"13661","ENSG00000228109","MFI2-AS1","3",196726331,196731615,5284
"13662","ENSG00000228124","","6",90383188,90385502,2314
"13663","ENSG00000228137","","21",47666804,47667596,792
"13664","ENSG00000228158","TLE1P1","X",64627964,64628565,601
"13665","ENSG00000228175","GEMIN8P4","1",90459152,90459880,728
"13666","ENSG00000228192","","1",43300352,43312093,11741
"13667","ENSG00000228201","","16",698473,699200,727
"13668","ENSG00000228203","RNF144A-AS1","2",7052408,7058840,6432
"13669","ENSG00000228222","","2",168149681,168414843,265162
"13670","ENSG00000228223","HCG11","6",26522076,26526807,4731
"13671","ENSG00000228232","GAPDHP1","X",39646386,39647390,1004
"13672","ENSG00000228251","","2",113348373,113349516,1143
"13673","ENSG00000228252","COL6A4P2","3",129931666,129992649,60983
"13674","ENSG00000228253","MT-ATP8","MT",8366,8572,206
"13675","ENSG00000228265","","20",32570858,32582163,11305
"13676","ENSG00000228274","","22",39063590,39077825,14235
"13677","ENSG00000228300","C19orf24","19",1275026,1279248,4222
"13678","ENSG00000228327","","1",700237,714006,13769
"13679","ENSG00000228393","LINC01004","7",104590762,104653491,62729
"13680","ENSG00000228395","","9",131291180,131314689,23509
"13681","ENSG00000228409","CCT6P1","7",65216129,65228341,12212
"13682","ENSG00000228412","","6",19802395,19804983,2588
"13683","ENSG00000228423","","1",8865919,8867110,1191
"13684","ENSG00000228434","","7",44043645,44047465,3820
"13685","ENSG00000228436","","1",39325672,39385068,59396
"13686","ENSG00000228439","TSTD3","6",99968569,99979794,11225
"13687","ENSG00000228446","","2",225364104,225364817,713
"13688","ENSG00000228451","SDAD1P1","8",26236775,26240469,3694
"13689","ENSG00000228474","OST4","2",27293340,27294641,1301
"13690","ENSG00000228486","LINC01125","2",98280680,98319527,38847
"13691","ENSG00000228495","LINC01013","6",132453055,132490514,37459
"13692","ENSG00000228506","","6",99872798,99879249,6451
"13693","ENSG00000228526","","1",9242066,9262678,20612
"13694","ENSG00000228528","","2",105320216,105321967,1751
"13695","ENSG00000228544","CCDC183-AS1","9",139698379,139703300,4921
"13696","ENSG00000228549","","1",17197440,17200587,3147
"13697","ENSG00000228592","","21",24733426,24757182,23756
"13698","ENSG00000228594","C1orf233","1",1533392,1535476,2084
"13699","ENSG00000228614","","6",53655673,53659072,3399
"13700","ENSG00000228623","ZNF883","9",115759495,115774507,15012
"13701","ENSG00000228624","","6",114290865,114792869,502004
"13702","ENSG00000228638","FCF1P2","3",48332283,48332865,582
"13703","ENSG00000228649","","7",22893797,22901021,7224
"13704","ENSG00000228696","ARL17B","17",44352150,44439130,86980
"13705","ENSG00000228701","TNKS2-AS1","10",93542596,93558048,15452
"13706","ENSG00000228716","DHFR","5",79922047,79950802,28755
"13707","ENSG00000228721","","2",133668669,133668834,165
"13708","ENSG00000228741","","13",24553949,24609166,55217
"13709","ENSG00000228775","WEE2-AS1","7",141404138,141438146,34008
"13710","ENSG00000228782","MRPL45P2","17",45527934,45569858,41924
"13711","ENSG00000228784","LINC00954","2",20068621,20084808,16187
"13712","ENSG00000228794","LINC01128","1",762988,794826,31838
"13713","ENSG00000228798","","21",18003146,18013002,9856
"13714","ENSG00000228801","","8",52811885,52859733,47848
"13715","ENSG00000228817","BACH1-IT2","21",30742944,30746029,3085
"13716","ENSG00000228824","MIR4500HG","13",88079469,88323514,244045
"13717","ENSG00000228828","","10",38107534,38109910,2376
"13718","ENSG00000228878","","7",35791466,35840226,48760
"13719","ENSG00000228886","","13",45924458,45925485,1027
"13720","ENSG00000228889","UBAC2-AS1","13",99848631,99852964,4333
"13721","ENSG00000228903","RASA4CP","7",44066550,44081491,14941
"13722","ENSG00000228906","","X",73168808,73169393,585
"13723","ENSG00000228939","AKT3-IT1","1",243956507,243957702,1195
"13724","ENSG00000228972","","6",128752086,128753913,1827
"13725","ENSG00000228989","","2",242629829,242633704,3875
"13726","ENSG00000228998","","15",90818266,90820841,2575
"13727","ENSG00000229018","","7",72476064,72555749,79685
"13728","ENSG00000229019","","9",71041759,71044285,2526
"13729","ENSG00000229043","","7",1200010,1204903,4893
"13730","ENSG00000229117","RPL41","12",56510370,56511727,1357
"13731","ENSG00000229119","","5",165809310,165809604,294
"13732","ENSG00000229124","VIM-AS1","10",17256238,17271984,15746
"13733","ENSG00000229127","","2",210895457,210929080,33623
"13734","ENSG00000229152","ANKRD10-IT1","13",111547406,111551519,4113
"13735","ENSG00000229164","TRAC","14",23016447,23021097,4650
"13736","ENSG00000229180","","7",65991075,66007536,16461
"13737","ENSG00000229186","ADAM1A","12",112337067,112340042,2975
"13738","ENSG00000229191","","1",200993077,200997920,4843
"13739","ENSG00000229206","","10",11072297,11072831,534
"13740","ENSG00000229212","","15",85747141,85778026,30885
"13741","ENSG00000229214","LINC00242","6",170188886,170198921,10035
"13742","ENSG00000229222","KRT18P4","20",48573282,48574569,1287
"13743","ENSG00000229236","TTTY10","Y",22627554,22681114,53560
"13744","ENSG00000229267","","2",215674953,215827998,153045
"13745","ENSG00000229273","","9",41954580,41955037,457
"13746","ENSG00000229276","REV3L-IT1","6",111681844,111682810,966
"13747","ENSG00000229320","KRT8P12","3",160283235,160287036,3801
"13748","ENSG00000229325","ACAP2-IT1","3",195001452,195003470,2018
"13749","ENSG00000229358","DPY19L1P1","7",32620561,32801399,180838
"13750","ENSG00000229419","RALGAPA1P","9",108282409,108288640,6231
"13751","ENSG00000229427","ANKRD26P4","13",31885426,31887058,1632
"13752","ENSG00000229447","","1",31736092,31736528,436
"13753","ENSG00000229472","","20",32668955,32669754,799
"13754","ENSG00000229481","","19",38320191,38322797,2606
"13755","ENSG00000229492","","22",17897744,17898875,1131
"13756","ENSG00000229520","LINC00404","13",112760409,112761196,787
"13757","ENSG00000229521","MYCBP2-AS2","13",77654646,77655325,679
"13758","ENSG00000229539","","20",3868886,3869515,629
"13759","ENSG00000229559","","6",37511329,37515056,3727
"13760","ENSG00000229587","","9",77624744,77630952,6208
"13761","ENSG00000229589","ACVR2B-AS1","3",38492518,38496311,3793
"13762","ENSG00000229591","","7",151817086,151818802,1716
"13763","ENSG00000229619","MBNL1-AS1","3",151980405,151987344,6939
"13764","ENSG00000229638","RPL4P4","3",185135283,185136566,1283
"13765","ENSG00000229645","LINC00341","14",95873606,95876427,2821
"13766","ENSG00000229659","","10",75182017,75182454,437
"13767","ENSG00000229692","SOS1-IT1","2",39219420,39220998,1578
"13768","ENSG00000229727","","2",7561392,7590385,28993
"13769","ENSG00000229728","","20",1342266,1343229,963
"13770","ENSG00000229729","","3",88108424,88188123,79699
"13771","ENSG00000229743","LINC01159","2",105481955,105489053,7098
"13772","ENSG00000229789","","9",68726629,68745997,19368
"13773","ENSG00000229808","","1",161860623,161861986,1363
"13774","ENSG00000229809","ZNF688","16",30580667,30584055,3388
"13775","ENSG00000229816","DDX50P1","2",32426669,32429068,2399
"13776","ENSG00000229833","PET100","19",7694623,7696842,2219
"13777","ENSG00000229852","","6",73972938,74011124,38186
"13778","ENSG00000229874","","1",206135293,206137984,2691
"13779","ENSG00000229891","","22",42760406,42765242,4836
"13780","ENSG00000229944","","17",47500970,47502298,1328
"13781","ENSG00000229954","MTND2P2","X",102041741,102043315,1574
"13782","ENSG00000229955","","22",38783923,38784862,939
"13783","ENSG00000229956","ZRANB2-AS2","1",71547007,71955652,408645
"13784","ENSG00000229980","TOB1-AS1","17",48944040,48987098,43058
"13785","ENSG00000229989","MIR181A1HG","1",198776622,198906558,129936
"13786","ENSG00000229992","HMGB3P9","1",93112605,93113187,582
"13787","ENSG00000229994","RPL5P4","1",35816323,35817208,885
"13788","ENSG00000230001","","9",4070906,4071884,978
"13789","ENSG00000230002","ALMS1-IT1","2",73683891,73686611,2720
"13790","ENSG00000230042","AK3P3","7",23168797,23169460,663
"13791","ENSG00000230055","CISD3","17",36886488,36891297,4809
"13792","ENSG00000230068","CDC42-IT1","1",22385690,22390692,5002
"13793","ENSG00000230069","LRRC37A15P","4",103648431,103651878,3447
"13794","ENSG00000230071","RPL4P6","22",40982704,40984007,1303
"13795","ENSG00000230074","","9",34665662,34681295,15633
"13796","ENSG00000230091","TMEM254-AS1","10",81806616,81838668,32052
"13797","ENSG00000230124","","1",180238788,180245359,6571
"13798","ENSG00000230177","","6",111599135,111599945,810
"13799","ENSG00000230185","C9orf147","9",115196096,115249484,53388
"13800","ENSG00000230189","","7",65874130,65955046,80916
"13801","ENSG00000230202","","6",118320138,118320611,473
"13802","ENSG00000230269","","6",3182978,3195990,13012
"13803","ENSG00000230330","HMGN2P3","16",26043860,26044132,272
"13804","ENSG00000230359","TPI1P2","7",128696073,128696824,751
"13805","ENSG00000230373","GOLGA6L5P","15",85051116,85060045,8929
"13806","ENSG00000230393","","2",100721381,100723966,2585
"13807","ENSG00000230397","SPTLC1P1","10",31649884,31650144,260
"13808","ENSG00000230409","TCEA1P2","3",37317087,37318089,1002
"13809","ENSG00000230424","","1",19536995,19567198,30203
"13810","ENSG00000230445","LRRC37A6P","10",27535279,27548384,13105
"13811","ENSG00000230453","ANKRD18B","9",33524392,33573007,48615
"13812","ENSG00000230454","","3",50297735,50300790,3055
"13813","ENSG00000230461","PROX1-AS1","1",213991094,214160973,169879
"13814","ENSG00000230487","PSMG3-AS1","7",1609709,1629262,19553
"13815","ENSG00000230498","","1",77533605,77544167,10562
"13816","ENSG00000230510","PPP5D1","19",46984053,47104457,120404
"13817","ENSG00000230513","THAP7-AS1","22",21356175,21364631,8456
"13818","ENSG00000230530","LIMD1-AS1","3",45720535,45730626,10091
"13819","ENSG00000230532","","17",47009153,47014462,5309
"13820","ENSG00000230551","","5",148872949,148884233,11284
"13821","ENSG00000230561","","5",127039082,127277326,238244
"13822","ENSG00000230562","FAM133DP","2",158236236,158236926,690
"13823","ENSG00000230590","FTX","X",73183790,73513409,329619
"13824","ENSG00000230606","","2",98081083,98099107,18024
"13825","ENSG00000230629","RPS23P8","X",70182814,70183143,329
"13826","ENSG00000230658","KLHL7-AS1","7",23140847,23145322,4475
"13827","ENSG00000230673","PABPC1P3","X",73802923,73803381,458
"13828","ENSG00000230699","","1",846815,850328,3513
"13829","ENSG00000230701","FBXW4P1","22",23605323,23606541,1218
"13830","ENSG00000230707","","X",139173902,139174720,818
"13831","ENSG00000230715","","7",128292895,128293719,824
"13832","ENSG00000230724","LINC01001","11",127115,139612,12497
"13833","ENSG00000230730","","2",28856148,28887406,31258
"13834","ENSG00000230732","","3",196639821,196641450,1629
"13835","ENSG00000230772","VN1R108P","20",25714900,25715729,829
"13836","ENSG00000230844","ZNF674-AS1","X",46404928,46407843,2915
"13837","ENSG00000230847","","5",70370052,70389020,18968
"13838","ENSG00000230876","LINC00486","2",33050510,33151760,101250
"13839","ENSG00000230880","","1",142618769,142729975,111206
"13840","ENSG00000230896","","1",46160356,46162747,2391
"13841","ENSG00000230910","","6",69339854,69344919,5065
"13842","ENSG00000230922","","22",45396446,45399500,3054
"13843","ENSG00000230928","","10",100011780,100016332,4552
"13844","ENSG00000230989","HSBP1","16",83841448,83853342,11894
"13845","ENSG00000230992","FAM201B","2",133110240,133112412,2172
"13846","ENSG00000231007","CDC20P1","9",89626567,89628066,1499
"13847","ENSG00000231025","","10",98752207,98755716,3509
"13848","ENSG00000231028","LINC00271","6",135818489,136037193,218704
"13849","ENSG00000231050","","1",1822910,1824097,1187
"13850","ENSG00000231064","","1",155166659,155175286,8627
"13851","ENSG00000231066","NPM1P9","X",14852598,14853441,843
"13852","ENSG00000231074","HCG18","6",30255174,30294927,39753
"13853","ENSG00000231107","","9",93063184,93195787,132603
"13854","ENSG00000231113","","6",42908102,42916098,7996
"13855","ENSG00000231121","","12",77718421,77966055,247634
"13856","ENSG00000231125","","21",30430394,30432416,2022
"13857","ENSG00000231134","TCF7L1-IT1","2",85413532,85414376,844
"13858","ENSG00000231154","MORF4L2-AS1","X",102942212,102946700,4488
"13859","ENSG00000231160","","4",38614322,38666504,52182
"13860","ENSG00000231165","TRBV26OR9-2","9",33695765,33696057,292
"13861","ENSG00000231177","LINC00852","3",10326103,10327430,1327
"13862","ENSG00000231181","","1",9636485,9637043,558
"13863","ENSG00000231185","","5",141704858,142051566,346708
"13864","ENSG00000231187","","10",46951472,46966835,15363
"13865","ENSG00000231188","","10",102095320,102106147,10827
"13866","ENSG00000231205","ZNF826P","19",20451078,20607775,156697
"13867","ENSG00000231259","","2",87257800,87303536,45736
"13868","ENSG00000231305","","3",128580156,128590383,10227
"13869","ENSG00000231307","RPS3P2","20",37166401,37167101,700
"13870","ENSG00000231312","","2",39663778,39892483,228705
"13871","ENSG00000231335","","4",77558776,77565521,6745
"13872","ENSG00000231365","","1",119683019,119818596,135577
"13873","ENSG00000231389","HLA-DPA1","6",33032346,33048552,16206
"13874","ENSG00000231429","","1",121154579,121171134,16555
"13875","ENSG00000231459","LINC00032","9",27245682,27282791,37109
"13876","ENSG00000231466","","22",25745510,25746289,779
"13877","ENSG00000231473","LINC00441","13",48870649,48877797,7148
"13878","ENSG00000231500","RPS18","6",33239787,33244287,4500
"13879","ENSG00000231527","","9",45108392,45112532,4140
"13880","ENSG00000231563","","1",228595082,228597395,2313
"13881","ENSG00000231566","","X",45707328,45710920,3592
"13882","ENSG00000231584","FAHD2CP","2",96676299,96689128,12829
"13883","ENSG00000231587","SNORD62B","9",134365873,134365958,85
"13884","ENSG00000231595","","17",14113805,14121239,7434
"13885","ENSG00000231607","DLEU2","13",50601269,50699856,98587
"13886","ENSG00000231609","","2",63271057,63275775,4718
"13887","ENSG00000231611","","11",116645826,116646592,766
"13888","ENSG00000231632","","9",91624949,91625393,444
"13889","ENSG00000231663","","1",234508553,234509339,786
"13890","ENSG00000231672","DIRC3","2",218148742,218621316,472574
"13891","ENSG00000231697","NANOGP5","9",102937460,102938336,876
"13892","ENSG00000231713","","21",41099682,41102607,2925
"13893","ENSG00000231721","LINC-PINT","7",130626519,130794935,168416
"13894","ENSG00000231728","","X",103172005,103174131,2126
"13895","ENSG00000231729","ARHGEF9-IT1","X",62890076,62891382,1306
"13896","ENSG00000231738","TSPAN19","12",85408094,85430055,21961
"13897","ENSG00000231752","EMBP1","1",121261143,121310591,49448
"13898","ENSG00000231770","TMEM44-AS1","3",194304740,194310989,6249
"13899","ENSG00000231789","","1",9732484,9747613,15129
"13900","ENSG00000231795","ITCH-IT1","20",33038735,33042357,3622
"13901","ENSG00000231806","PCAT7","9",97317351,97330409,13058
"13902","ENSG00000231817","","13",47029270,47060641,31371
"13903","ENSG00000231827","","1",153767649,153774567,6918
"13904","ENSG00000231842","","6",126498339,126523385,25046
"13905","ENSG00000231865","SIK3-IT1","11",116756762,116761437,4675
"13906","ENSG00000231871","IPO9-AS1","1",201657387,201798687,141300
"13907","ENSG00000231888","MTND5P15","3",176728507,176728855,348
"13908","ENSG00000231889","TRAF3IP2-AS1","6",111804714,111919505,114791
"13909","ENSG00000231890","","2",136742746,136779888,37142
"13910","ENSG00000231925","TAPBP","6",33267471,33282164,14693
"13911","ENSG00000231952","DPY19L1P2","7",32852369,32878182,25813
"13912","ENSG00000231991","ANXA2P2","9",33624223,33625532,1309
"13913","ENSG00000231999","","1",90048800,90098453,49653
"13914","ENSG00000232000","","9",14987300,15146399,159099
"13915","ENSG00000232018","","14",101426846,101433377,6531
"13916","ENSG00000232031","","6",82434439,82446070,11631
"13917","ENSG00000232040","SCAND3","6",28539407,28583989,44582
"13918","ENSG00000232044","LINC01105","2",6072819,6141407,68588
"13919","ENSG00000232046","","2",66801162,66957289,156127
"13920","ENSG00000232070","TMEM253","14",21567096,21571883,4787
"13921","ENSG00000232081","LARGE-IT1","22",34119818,34120898,1080
"13922","ENSG00000232082","RPS6KA2-IT1","6",166874151,166878871,4720
"13923","ENSG00000232093","","1",155017667,155018594,927
"13924","ENSG00000232098","","19",58915605,58919851,4246
"13925","ENSG00000232104","","9",3526723,3671646,144923
"13926","ENSG00000232112","TMA7","3",48481667,48485616,3949
"13927","ENSG00000232119","MCTS1","X",119727865,119754929,27064
"13928","ENSG00000232160","RAP2C-AS1","X",131351175,131566890,215715
"13929","ENSG00000232184","","1",243866159,243904123,37964
"13930","ENSG00000232229","LINC00865","10",91589267,91600618,11351
"13931","ENSG00000232274","","1",143118704,143211070,92366
"13932","ENSG00000232295","","6",71931160,72037931,106771
"13933","ENSG00000232303","","9",32566146,32567124,978
"13934","ENSG00000232372","","1",224170456,224175856,5400
"13935","ENSG00000232388","LINC00493","20",18548064,18550207,2143
"13936","ENSG00000232412","","X",123093083,123095191,2108
"13937","ENSG00000232433","","9",42493617,42494809,1192
"13938","ENSG00000232442","","20",62258580,62260177,1597
"13939","ENSG00000232445","","7",100951627,100954266,2639
"13940","ENSG00000232450","","1",114241506,114242253,747
"13941","ENSG00000232454","","9",37836041,37836391,350
"13942","ENSG00000232466","","9",26880176,26880547,371
"13943","ENSG00000232474","NCKAP5-IT1","2",134189237,134191468,2231
"13944","ENSG00000232479","","2",203789332,203790627,1295
"13945","ENSG00000232485","","2",217343753,217363484,19731
"13946","ENSG00000232486","","9",108520445,108523036,2591
"13947","ENSG00000232489","MFAP1P1","13",31115780,31117034,1254
"13948","ENSG00000232527","","1",148928322,148951595,23273
"13949","ENSG00000232533","","7",143076785,143077588,803
"13950","ENSG00000232545","","22",24497652,24499317,1665
"13951","ENSG00000232546","","7",66313483,66323123,9640
"13952","ENSG00000232559","","7",66010634,66057373,46739
"13953","ENSG00000232561","GTF2IP1","7",74602783,74653438,50655
"13954","ENSG00000232573","RPL3P4","14",99439216,99439638,422
"13955","ENSG00000232586","","1",180918835,180924023,5188
"13956","ENSG00000232587","EEF1A1P3","13",28788650,28790034,1384
"13957","ENSG00000232593","LINC01155","X",53123327,53196196,72869
"13958","ENSG00000232611","","X",135923090,135929956,6866
"13959","ENSG00000232637","","1",146032648,146253110,220462
"13960","ENSG00000232648","","4",184416091,184425647,9556
"13961","ENSG00000232677","LINC00665","19",36803969,36822620,18651
"13962","ENSG00000232686","ARID4B-IT1","1",235333435,235334206,771
"13963","ENSG00000232693","","2",65600834,65607819,6985
"13964","ENSG00000232732","","2",200732119,200775882,43763
"13965","ENSG00000232795","SCAND3P1","13",35759431,35760816,1385
"13966","ENSG00000232818","RPS2P32","7",23530092,23530983,891
"13967","ENSG00000232833","FAM27E3","9",67784944,67786624,1680
"13968","ENSG00000232838","PET117","20",18118517,18123813,5296
"13969","ENSG00000232859","LYRM9","17",26205340,26221778,16438
"13970","ENSG00000232882","PHKA1P1","1",91358549,91359169,620
"13971","ENSG00000232891","","6",150921970,150926986,5016
"13972","ENSG00000232906","","7",64820847,64822089,1242
"13973","ENSG00000232931","LINC00342","2",96472866,96481963,9097
"13974","ENSG00000232940","HCG25","6",33217311,33222766,5455
"13975","ENSG00000232953","HSPA8P18","3",19981761,19984802,3041
"13976","ENSG00000232956","SNHG15","7",45022622,45026560,3938
"13977","ENSG00000232995","","1",163214295,163291684,77389
"13978","ENSG00000233006","","5",131646978,131705608,58630
"13979","ENSG00000233012","HDAC1P2","1",220799082,220801398,2316
"13980","ENSG00000233016","SNHG7","9",139615818,139622636,6818
"13981","ENSG00000233058","LINC00884","3",194208183,194239008,30825
"13982","ENSG00000233061","TTLL7-IT1","1",84444801,84449983,5182
"13983","ENSG00000233072","RPS15AP6","1",21330043,21330427,384
"13984","ENSG00000233073","","7",86413542,86415986,2444
"13985","ENSG00000233098","","17",20771746,20905589,133843
"13986","ENSG00000233137","","9",37079893,37090398,10505
"13987","ENSG00000233170","","8",37604854,37605522,668
"13988","ENSG00000233184","","1",101491434,101552821,61387
"13989","ENSG00000233218","SNX18P16","1",142688379,142688925,546
"13990","ENSG00000233223","","17",7485282,7487390,2108
"13991","ENSG00000233224","HIST1H2AM","6",27860477,27860963,486
"13992","ENSG00000233230","","2",48132817,48134949,2132
"13993","ENSG00000233237","LINC00472","6",72054047,72130472,76425
"13994","ENSG00000233264","","7",8019943,8021859,1916
"13995","ENSG00000233276","GPX1","3",49394609,49396033,1424
"13996","ENSG00000233280","","3",97540884,97594132,53248
"13997","ENSG00000233325","MIPEPP3","13",21872278,21880512,8234
"13998","ENSG00000233369","","7",72569033,72619657,50624
"13999","ENSG00000233382","NKAPP1","X",119254863,119379122,124259
"14000","ENSG00000233396","","1",145373054,145382434,9380
"14001","ENSG00000233429","HOTAIRM1","7",27135266,27139884,4618
"14002","ENSG00000233461","","1",231658134,231664302,6168
"14003","ENSG00000233476","EEF1A1P6","7",22550231,22551618,1387
"14004","ENSG00000233527","","19",37063972,37085610,21638
"14005","ENSG00000233557","NFU1P2","1",98542556,98543024,468
"14006","ENSG00000233560","KRT8P39","12",69099414,69100846,1432
"14007","ENSG00000233593","","1",91248543,91317207,68664
"14008","ENSG00000233602","ERI3-IT1","1",44709080,44709945,865
"14009","ENSG00000233611","","2",237076090,237203570,127480
"14010","ENSG00000233631","","6",26634611,26637008,2397
"14011","ENSG00000233639","LINC01158","2",105424030,105469641,45611
"14012","ENSG00000233684","","2",317912,342118,24206
"14013","ENSG00000233718","MYCNOS","2",16061159,16082371,21212
"14014","ENSG00000233723","LINC01122","2",58654934,59290901,635967
"14015","ENSG00000233757","","2",95873283,95881351,8068
"14016","ENSG00000233799","","4",758275,758862,587
"14017","ENSG00000233822","HIST1H2BN","6",27806323,27823487,17164
"14018","ENSG00000233836","","19",23945746,24016116,70370
"14019","ENSG00000233864","TTTY15","Y",14774265,14804162,29897
"14020","ENSG00000233871","DLG5-AS1","10",79687130,79689582,2452
"14021","ENSG00000233875","","1",154551541,154552139,598
"14022","ENSG00000233892","PAIP1P1","6",30154575,30156391,1816
"14023","ENSG00000233895","","20",19738352,19790319,51967
"14024","ENSG00000233901","","9",132094579,132121817,27238
"14025","ENSG00000233906","","9",23671786,23672397,611
"14026","ENSG00000233924","","14",55471531,55472405,874
"14027","ENSG00000233927","RPS28","19",8386042,8388224,2182
"14028","ENSG00000233930","KRTAP5-AS1","11",1592583,1620414,27831
"14029","ENSG00000233932","CTXN2","15",48483736,48495953,12217
"14030","ENSG00000233937","","5",180673523,180699168,25645
"14031","ENSG00000233954","","1",16133679,16134194,515
"14032","ENSG00000233956","BTF3P6","21",34890917,34891415,498
"14033","ENSG00000233961","","9",69065655,69084989,19334
"14034","ENSG00000233967","","6",81153061,81175644,22583
"14035","ENSG00000234028","","2",88927057,88931339,4282
"14036","ENSG00000234031","RPS3AP44","13",27151023,27151812,789
"14037","ENSG00000234043","","10",92912362,92913106,744
"14038","ENSG00000234062","","X",135991554,136103789,112235
"14039","ENSG00000234072","","2",27579113,27590489,11376
"14040","ENSG00000234086","","1",235472935,235473313,378
"14041","ENSG00000234127","TRIM26","6",30152232,30181204,28972
"14042","ENSG00000234129","","X",10865996,11129261,263265
"14043","ENSG00000234160","","9",37509147,37510296,1149
"14044","ENSG00000234161","PABPC5-AS1","X",90669877,90689998,20121
"14045","ENSG00000234171","RNASEH1-AS1","2",3606082,3609324,3242
"14046","ENSG00000234177","LINC01114","2",105363096,105374177,11081
"14047","ENSG00000234183","","7",44888015,44889167,1152
"14048","ENSG00000234188","","6",116442320,116443093,773
"14049","ENSG00000234203","","17",4876146,4877976,1830
"14050","ENSG00000234210","","7",157258925,157292410,33485
"14051","ENSG00000234219","","1",207935929,207936608,679
"14052","ENSG00000234231","","2",88000503,88038766,38263
"14053","ENSG00000234257","SOD2P1","1",103565699,103566260,561
"14054","ENSG00000234284","ZNF879","5",178450753,178462065,11312
"14055","ENSG00000234323","","9",109040673,109367076,326403
"14056","ENSG00000234327","","17",5014763,5017674,2911
"14057","ENSG00000234329","","1",46116711,46117498,787
"14058","ENSG00000234345","","X",103165225,103166272,1047
"14059","ENSG00000234377","RNF219-AS1","13",78493824,79191463,697639
"14060","ENSG00000234380","","21",36118054,36157183,39129
"14061","ENSG00000234383","CTBP2P8","1",68627444,68628773,1329
"14062","ENSG00000234390","USP27X-AS1","X",49641327,49643844,2517
"14063","ENSG00000234405","","X",102752451,102755245,2794
"14064","ENSG00000234409","","22",20135950,20138399,2449
"14065","ENSG00000234420","ZNF37BP","10",43008958,43048270,39312
"14066","ENSG00000234444","ZNF736","7",63767837,63815238,47401
"14067","ENSG00000234449","","X",3771051,3800358,29307
"14068","ENSG00000234456","MAGI2-AS3","7",79082198,79100524,18326
"14069","ENSG00000234465","PINLYP","19",44080952,44088116,7164
"14070","ENSG00000234492","RPL34-AS1","4",109459346,109541616,82270
"14071","ENSG00000234523","NDUFB1P2","1",223119067,223119242,175
"14072","ENSG00000234545","FAM133B","7",92190107,92219708,29601
"14073","ENSG00000234546","","1",9242263,9252148,9885
"14074","ENSG00000234585","CCT6P3","7",64498732,64535091,36359
"14075","ENSG00000234608","MAPKAPK5-AS1","12",112277571,112280706,3135
"14076","ENSG00000234616","JRK","8",143738874,143763386,24512
"14077","ENSG00000234663","","2",181966659,182264286,297627
"14078","ENSG00000234664","HMGN2P5","15",30022917,30023189,272
"14079","ENSG00000234684","SDCBP2-AS1","20",1306049,1359378,53329
"14080","ENSG00000234685","NUS1P2","13",23489790,23490662,872
"14081","ENSG00000234690","","2",47419544,47572213,152669
"14082","ENSG00000234694","","1",43820355,43824329,3974
"14083","ENSG00000234740","","9",13274509,13279186,4677
"14084","ENSG00000234741","GAS5","1",173833038,173838020,4982
"14085","ENSG00000234745","HLA-B","6",31321649,31324965,3316
"14086","ENSG00000234769","WASH4P","16",64043,69452,5409
"14087","ENSG00000234771","","9",130873450,130881013,7563
"14088","ENSG00000234773","","19",12305830,12348582,42752
"14089","ENSG00000234788","HSPA8P3","10",27003551,27004761,1210
"14090","ENSG00000234797","RPS3AP6","15",60060543,60061347,804
"14091","ENSG00000234816","","6",26044217,26044585,368
"14092","ENSG00000234835","PHBP13","13",35825207,35825966,759
"14093","ENSG00000234841","","4",113747463,113748763,1300
"14094","ENSG00000234851","","3",161146915,161147398,483
"14095","ENSG00000234882","EIF3EP1","6",74001685,74003000,1315
"14096","ENSG00000234886","MTND5P26","X",102057969,102061066,3097
"14097","ENSG00000234911","TEX21P","14",64812889,64841384,28495
"14098","ENSG00000234912","LINC00338","17",75082798,75091068,8270
"14099","ENSG00000234936","","2",43456712,43460533,3821
"14100","ENSG00000234946","SDHCP3","2",24166716,24167221,505
"14101","ENSG00000234972","TBC1D3C","17",34580902,34757050,176148
"14102","ENSG00000235008","","6",167114582,167116327,1745
"14103","ENSG00000235070","","2",227044760,227050087,5327
"14104","ENSG00000235088","","20",40087994,40090584,2590
"14105","ENSG00000235090","RPL7L1P3","7",75552073,75552761,688
"14106","ENSG00000235092","","2",8806766,8821993,15227
"14107","ENSG00000235100","","10",91426938,91459428,32490
"14108","ENSG00000235106","LINC00094","9",136890561,136899788,9227
"14109","ENSG00000235109","ZSCAN31","6",28292470,28324048,31578
"14110","ENSG00000235128","","2",127437198,127437996,798
"14111","ENSG00000235145","","1",179937821,179938641,820
"14112","ENSG00000235162","C12orf75","12",105629068,105789875,160807
"14113","ENSG00000235173","FAM203A","8",145192672,145195746,3074
"14114","ENSG00000235174","RPL39P3","6",74082831,74082986,155
"14115","ENSG00000235183","","17",47872705,47873031,326
"14116","ENSG00000235194","PPP1R3E","14",23764852,23772057,7205
"14117","ENSG00000235205","TATDN2P3","13",23817659,23821323,3664
"14118","ENSG00000235217","TSPY26P","20",30774280,30778330,4050
"14119","ENSG00000235231","","22",24373117,24374043,926
"14120","ENSG00000235244","","X",115033604,115085422,51818
"14121","ENSG00000235245","","10",135108691,135109481,790
"14122","ENSG00000235257","","3",37786923,37903271,116348
"14123","ENSG00000235284","SNORD62A","9",134361052,134361137,85
"14124","ENSG00000235313","HM13-IT1","20",30150969,30151879,910
"14125","ENSG00000235316","DUSP8P5","10",75491582,75493396,1814
"14126","ENSG00000235326","","9",3674546,3691814,17268
"14127","ENSG00000235330","","9",477750,478423,673
"14128","ENSG00000235363","SNRPGP10","1",205320375,205320599,224
"14129","ENSG00000235370","DNM1P51","15",84953014,84966399,13385
"14130","ENSG00000235373","","1",677193,685396,8203
"14131","ENSG00000235381","","6",155574273,155577858,3585
"14132","ENSG00000235389","","9",8700595,8701552,957
"14133","ENSG00000235408","SNORA71B","20",37053843,37053979,136
"14134","ENSG00000235423","","12",123736577,123746030,9453
"14135","ENSG00000235436","DPY19L2P4","7",89748714,89754914,6200
"14136","ENSG00000235437","","X",62563106,62780951,217845
"14137","ENSG00000235447","","X",75875899,75876960,1061
"14138","ENSG00000235449","","1",202736357,202736546,189
"14139","ENSG00000235453","TOPORS-AS1","9",32551142,32567003,15861
"14140","ENSG00000235475","","7",66800963,66805011,4048
"14141","ENSG00000235477","","1",161337812,161341754,3942
"14142","ENSG00000235481","","9",33785948,33818793,32845
"14143","ENSG00000235499","","2",74212259,74213470,1211
"14144","ENSG00000235501","","1",95393122,95428826,35704
"14145","ENSG00000235513","","22",41605126,41613631,8505
"14146","ENSG00000235529","AGAP1-IT1","2",236414395,236416210,1815
"14147","ENSG00000235530","","17",21117644,21133348,15704
"14148","ENSG00000235545","","1",63154153,63176365,22212
"14149","ENSG00000235552","RPL6P27","18",6462143,6463014,871
"14150","ENSG00000235560","","16",30546073,30548465,2392
"14151","ENSG00000235568","NFAM1","22",42776416,42828401,51985
"14152","ENSG00000235590","GNAS-AS1","20",57393974,57425958,31984
"14153","ENSG00000235597","LINC01102","2",105049725,105137290,87565
"14154","ENSG00000235609","","21",16191164,16254296,63132
"14155","ENSG00000235613","NSRP1P1","1",78312795,78314487,1692
"14156","ENSG00000235651","","2",136268116,136269513,1397
"14157","ENSG00000235652","","6",146136048,146207721,71673
"14158","ENSG00000235655","H3F3AP4","2",175584505,175585526,1021
"14159","ENSG00000235664","","7",22928990,22980809,51819
"14160","ENSG00000235672","","17",18811592,18812178,586
"14161","ENSG00000235701","PCBP2P1","21",40543056,40544032,976
"14162","ENSG00000235703","LINC00894","X",149106846,149392815,285969
"14163","ENSG00000235706","DICER1-AS1","14",95623982,95646263,22281
"14164","ENSG00000235748","","1",197107878,197108437,559
"14165","ENSG00000235750","KIAA0040","1",175126123,175162135,36012
"14166","ENSG00000235770","LINC00607","2",216476286,216708445,232159
"14167","ENSG00000235786","ZNRF3-IT1","22",29388709,29414608,25899
"14168","ENSG00000235823","LINC00263","10",102133372,102143125,9753
"14169","ENSG00000235833","","2",98140412,98141439,1027
"14170","ENSG00000235859","","7",30410987,30412357,1370
"14171","ENSG00000235863","B3GALT4","6",33244917,33252609,7692
"14172","ENSG00000235875","ARHGEF7-AS2","13",111766159,111768025,1866
"14173","ENSG00000235878","","21",47612391,47613673,1282
"14174","ENSG00000235903","CPB2-AS1","13",46626941,46687467,60526
"14175","ENSG00000235919","ASH1L-AS1","1",155531821,155533775,1954
"14176","ENSG00000235920","","7",11859943,11860920,977
"14177","ENSG00000235944","ZNF815P","7",5862791,5894066,31275
"14178","ENSG00000235954","TTC28-AS1","22",28315364,28404569,89205
"14179","ENSG00000235999","","1",149287451,149291743,4292
"14180","ENSG00000236017","ASMTL-AS1","X",1520662,1532921,12259
"14181","ENSG00000236047","","2",203385124,203385712,588
"14182","ENSG00000236088","COX10-AS1","17",13659795,13972812,313017
"14183","ENSG00000236104","ZBTB22","6",33282183,33285719,3536
"14184","ENSG00000236106","","2",5866581,5870474,3893
"14185","ENSG00000236144","","19",36031640,36036931,5291
"14186","ENSG00000236166","","6",132406224,132420419,14195
"14187","ENSG00000236184","TCEA1P4","9",32979558,32980401,843
"14188","ENSG00000236194","","17",40422535,40424701,2166
"14189","ENSG00000236200","KDM4A-AS1","1",44165436,44173809,8373
"14190","ENSG00000236204","","2",19167729,19546509,378780
"14191","ENSG00000236255","","2",118591513,118599234,7721
"14192","ENSG00000236269","ENO1-IT1","1",8935847,8938066,2219
"14193","ENSG00000236287","ZBED5","11",10833621,10880343,46722
"14194","ENSG00000236333","TRHDE-AS1","12",72647288,72668687,21399
"14195","ENSG00000236337","FMR1-IT1","X",147028461,147029103,642
"14196","ENSG00000236352","","20",52556699,52559047,2348
"14197","ENSG00000236397","DDX11L2","2",114356606,114359144,2538
"14198","ENSG00000236404","","9",2422702,2641395,218693
"14199","ENSG00000236423","LINC01134","1",3816936,3833789,16853
"14200","ENSG00000236432","","2",228085768,228189917,104149
"14201","ENSG00000236519","","21",46222492,46224632,2140
"14202","ENSG00000236520","GPC6-AS1","13",94806447,94840245,33798
"14203","ENSG00000236535","RC3H1-IT1","1",173978405,173985344,6939
"14204","ENSG00000236537","","6",158703295,158733390,30095
"14205","ENSG00000236552","RPL13AP5","10",98510045,98510675,630
"14206","ENSG00000236576","","X",51600064,51601162,1098
"14207","ENSG00000236603","RANP1","6",30453717,30454367,650
"14208","ENSG00000236609","ZNF853","7",6655248,6663921,8673
"14209","ENSG00000236618","PITPNA-AS1","17",1420225,1421390,1165
"14210","ENSG00000236624","CCDC163P","1",45959538,45965751,6213
"14211","ENSG00000236662","","10",102740264,102745371,5107
"14212","ENSG00000236670","KRT18P5","22",20837102,20838392,1290
"14213","ENSG00000236682","","2",128146706,128158156,11450
"14214","ENSG00000236708","","7",3303664,3342084,38420
"14215","ENSG00000236709","DAPK1-IT1","9",90168369,90169374,1005
"14216","ENSG00000236723","","1",53676128,53679447,3319
"14217","ENSG00000236744","","10",57007515,57356993,349478
"14218","ENSG00000236753","MKLN1-AS","7",130994503,131012981,18478
"14219","ENSG00000236772","","20",31037558,31041410,3852
"14220","ENSG00000236778","INTS6-AS1","13",52026503,52126500,99997
"14221","ENSG00000236810","","1",24086872,24104777,17905
"14222","ENSG00000236816","ANKRD20A7P","9",44076368,44118444,42076
"14223","ENSG00000236824","BCYRN1","2",47558199,47571656,13457
"14224","ENSG00000236850","BMS1P20","22",22657589,22677203,19614
"14225","ENSG00000236859","NIFK-AS1","2",122407226,122485784,78558
"14226","ENSG00000236901","MIR600HG","9",125871773,125877756,5983
"14227","ENSG00000236914","","15",38361682,38365160,3478
"14228","ENSG00000236924","","9",6645956,6670635,24679
"14229","ENSG00000236993","GAPDHP21","10",57427101,57428110,1009
"14230","ENSG00000237021","","6",116575370,116577906,2536
"14231","ENSG00000237036","ZEB1-AS1","10",31495207,31609376,114169
"14232","ENSG00000237037","NDUFA6-AS1","22",42486935,42535286,48351
"14233","ENSG00000237076","","1",84255963,84267148,11185
"14234","ENSG00000237082","COX5BP6","13",101276129,101276683,554
"14235","ENSG00000237096","","1",166864948,166877317,12369
"14236","ENSG00000237161","","15",21936560,21938111,1551
"14237","ENSG00000237172","B3GNT9","16",67182008,67185117,3109
"14238","ENSG00000237187","NR2F1-AS1","5",92745065,92921354,176289
"14239","ENSG00000237188","","1",146644350,146683136,38786
"14240","ENSG00000237190","CDKN2AIPNL","5",133737778,133747589,9811
"14241","ENSG00000237200","ZBTB40-IT1","1",22843967,22846201,2234
"14242","ENSG00000237238","BMS1P10","9",67327775,67334983,7208
"14243","ENSG00000237280","","10",88873711,88875280,1569
"14244","ENSG00000237296","SMG1P1","16",22448329,22503541,55212
"14245","ENSG00000237298","TTN-AS1","2",179385910,179639402,253492
"14246","ENSG00000237310","","7",65958693,65960461,1768
"14247","ENSG00000237356","","14",53635772,54153976,518204
"14248","ENSG00000237357","","9",44401766,44404440,2674
"14249","ENSG00000237373","BRWD1-IT1","21",40589019,40591731,2712
"14250","ENSG00000237406","NDUFA9P1","22",36293318,36294452,1134
"14251","ENSG00000237436","","1",6843952,6844903,951
"14252","ENSG00000237440","ZNF737","19",20718631,20748615,29984
"14253","ENSG00000237441","RGL2","6",33259431,33267101,7670
"14254","ENSG00000237457","","1",190447681,190449865,2184
"14255","ENSG00000237461","","9",102348068,102582171,234103
"14256","ENSG00000237489","LINC00959","10",131864638,131909081,44443
"14257","ENSG00000237491","","1",714150,745440,31290
"14258","ENSG00000237517","DGCR5","22",18958027,19018755,60728
"14259","ENSG00000237594","","21",32931558,32932800,1242
"14260","ENSG00000237645","","3",173362021,173362501,480
"14261","ENSG00000237649","KIFC1","6",33359313,33377701,18388
"14262","ENSG00000237731","RNGTTP1","21",27015801,27016528,727
"14263","ENSG00000237732","","2",223182994,223217708,34714
"14264","ENSG00000237753","","2",113399409,113403267,3858
"14265","ENSG00000237757","EEF1A1P30","X",119344309,119346528,2219
"14266","ENSG00000237765","FAM200B","4",15683285,15707188,23903
"14267","ENSG00000237781","","1",150521040,150530200,9160
"14268","ENSG00000237788","","20",48445662,48447622,1960
"14269","ENSG00000237807","","8",54427731,54436491,8760
"14270","ENSG00000237819","","7",92465797,92546501,80704
"14271","ENSG00000237854","LINC00674","17",66098049,66111659,13610
"14272","ENSG00000237877","","2",186897618,186947960,50342
"14273","ENSG00000237887","RPL23AP32","2",54756480,54756938,458
"14274","ENSG00000237892","KLF7-IT1","2",207985608,207986768,1160
"14275","ENSG00000237943","PRKCQ-AS1","10",6622381,6658414,36033
"14276","ENSG00000237945","LINC00649","21",35287838,35349992,62154
"14277","ENSG00000237954","","1",95821785,95846556,24771
"14278","ENSG00000237973","","1",566454,567996,1542
"14279","ENSG00000237976","","1",151319443,151320503,1060
"14280","ENSG00000237978","","3",178244293,178578193,333900
"14281","ENSG00000237984","PTENP1","9",33673502,33677497,3995
"14282","ENSG00000238035","","5",180733503,180755068,21565
"14283","ENSG00000238039","","X",148593039,148607803,14764
"14284","ENSG00000238057","ZEB2-AS1","2",145275664,145279058,3394
"14285","ENSG00000238058","","9",138799658,138805359,5701
"14286","ENSG00000238072","","7",129049954,129050211,257
"14287","ENSG00000238083","LRRC37A2","17",44588877,44633016,44139
"14288","ENSG00000238105","GOLGA2P5","12",100550135,100567437,17302
"14289","ENSG00000238113","","9",66457285,66469310,12025
"14290","ENSG00000238141","BRWD1-AS1","21",40687633,40695144,7511
"14291","ENSG00000238197","PAXBP1-AS1","21",34100426,34115433,15007
"14292","ENSG00000238227","C9orf69","9",139006427,139010731,4304
"14293","ENSG00000238228","OR7E7P","7",97576299,97577310,1011
"14294","ENSG00000238230","LINC00391","13",95351948,95355116,3168
"14295","ENSG00000238261","","1",143377281,143401533,24252
"14296","ENSG00000238286","SLC35E1P1","13",21181407,21182270,863
"14297","ENSG00000238317","SNORD11","2",203157772,203157859,87
"14298","ENSG00000238339","","2",179990263,179990364,101
"14299","ENSG00000238363","SNORA13","5",111497182,111497314,132
"14300","ENSG00000238390","","21",33036619,33036795,176
"14301","ENSG00000238408","","13",40021252,40021353,101
"14302","ENSG00000238437","","11",93530379,93530479,100
"14303","ENSG00000238465","","2",70139827,70139931,104
"14304","ENSG00000238533","","8",103400754,103400863,109
"14305","ENSG00000238544","","16",50386100,50386203,103
"14306","ENSG00000238578","SNORD4A","17",27049600,27049671,71
"14307","ENSG00000238638","","9",66858537,66858612,75
"14308","ENSG00000238648","TRNAI6","6",27599188,27599311,123
"14309","ENSG00000238713","","4",146070689,146070801,112
"14310","ENSG00000238723","","17",44292436,44292537,101
"14311","ENSG00000238741","SCARNA7","3",160232695,160233024,329
"14312","ENSG00000238774","","16",11442584,11442653,69
"14313","ENSG00000238834","","16",47154830,47154932,102
"14314","ENSG00000238835","SCARNA18","5",82360023,82360156,133
"14315","ENSG00000238924","RNU7-163P","10",1088233,1088295,62
"14316","ENSG00000238961","SNORA47","5",76376259,76376396,137
"14317","ENSG00000238966","","8",41901022,41901093,71
"14318","ENSG00000238975","","1",113195210,113195310,100
"14319","ENSG00000239002","SCARNA10","12",6619388,6619717,329
"14320","ENSG00000239014","SNORD108","15",25232072,25232142,70
"14321","ENSG00000239024","","17",2558973,2559076,103
"14322","ENSG00000239039","SNORD13","8",33370993,33371096,103
"14323","ENSG00000239100","","15",58892331,58892434,103
"14324","ENSG00000239119","RNU7-119P","3",73643091,73643153,62
"14325","ENSG00000239125","","10",112336118,112336219,101
"14326","ENSG00000239127","SNORD125","22",29729152,29729247,95
"14327","ENSG00000239183","SNORA84","9",95054743,95054875,132
"14328","ENSG00000239213","","3",136560568,136580896,20328
"14329","ENSG00000239218","RPS20P22","8",38291865,38293182,1317
"14330","ENSG00000239264","TXNDC5","6",7881483,8026646,145163
"14331","ENSG00000239268","","3",117391001,117716439,325438
"14332","ENSG00000239272","RPL21P10","14",78149545,78150332,787
"14333","ENSG00000239280","","3",113459670,113460101,431
"14334","ENSG00000239291","","17",45236557,45237359,802
"14335","ENSG00000239305","RNF103","2",86830516,86850989,20473
"14336","ENSG00000239306","RBM14","11",66384053,66394818,10765
"14337","ENSG00000239351","NPM1P29","3",149656784,149657586,802
"14338","ENSG00000239373","RN7SL425P","1",171461550,171461858,308
"14339","ENSG00000239382","ALKBH6","19",36500022,36505141,5119
"14340","ENSG00000239389","PCDHA13","5",140261793,140391929,130136
"14341","ENSG00000239407","","X",102139342,102161086,21744
"14342","ENSG00000239415","","21",47671463,47674047,2584
"14343","ENSG00000239419","RN7SL535P","7",142987708,142988004,296
"14344","ENSG00000239521","","7",99798276,99869837,71561
"14345","ENSG00000239523","MYLK-AS1","3",123304389,123363415,59026
"14346","ENSG00000239556","","7",44024593,44029806,5213
"14347","ENSG00000239569","KMT2E-AS1","7",104653872,104654768,896
"14348","ENSG00000239581","","17",35497536,35498349,813
"14349","ENSG00000239594","MIR18B","X",133304064,133304146,82
"14350","ENSG00000239627","","4",41391132,41391610,478
"14351","ENSG00000239650","GUSBP4","6",58246051,58256569,10518
"14352","ENSG00000239653","PSMD6-AS2","3",63989698,63997824,8126
"14353","ENSG00000239665","","10",13652047,13710299,58252
"14354","ENSG00000239672","NME1","17",49230897,49239789,8892
"14355","ENSG00000239704","CDRT4","17",15339332,15406922,67590
"14356","ENSG00000239763","","16",74346507,74347288,781
"14357","ENSG00000239776","","12",127650616,127650672,56
"14358","ENSG00000239779","WBP1","2",74685456,74688018,2562
"14359","ENSG00000239789","MRPS17","7",56019512,56024192,4680
"14360","ENSG00000239791","","16",30583571,30595181,11610
"14361","ENSG00000239815","","7",128506633,128508898,2265
"14362","ENSG00000239857","GET4","7",916189,936073,19884
"14363","ENSG00000239881","RPS27P25","12",120807243,120809491,2248
"14364","ENSG00000239883","","10",46349541,46411619,62078
"14365","ENSG00000239884","RN7SL608P","17",2584242,2584528,286
"14366","ENSG00000239887","C1orf226","1",162336698,162356600,19902
"14367","ENSG00000239899","RN7SL674P","2",11724899,11725176,277
"14368","ENSG00000239900","ADSL","22",40742507,40786467,43960
"14369","ENSG00000239922","","3",147657791,147724542,66751
"14370","ENSG00000239969","","7",102004609,102021080,16471
"14371","ENSG00000240024","LINC00888","3",183165396,183173801,8405
"14372","ENSG00000240038","AMY2B","1",104096437,104122156,25719
"14373","ENSG00000240053","LY6G5B","6",31637944,31641553,3609
"14374","ENSG00000240086","","3",135074909,135158730,83821
"14375","ENSG00000240137","","3",150421351,150437933,16582
"14376","ENSG00000240184","PCDHGC3","5",140855580,140892542,36962
"14377","ENSG00000240207","","3",158450052,158501859,51807
"14378","ENSG00000240225","ZNF542","19",56879468,56891197,11729
"14379","ENSG00000240230","COX19","7",938415,1015235,76820
"14380","ENSG00000240288","GHRLOS","3",10327438,10335133,7695
"14381","ENSG00000240291","","10",18802044,18834580,32536
"14382","ENSG00000240303","ACAD11","3",132276982,132379567,102585
"14383","ENSG00000240322","RN7SL481P","7",142995609,142995905,296
"14384","ENSG00000240328","","12",19661838,19662179,341
"14385","ENSG00000240342","RPS2P5","12",118683877,118684807,930
"14386","ENSG00000240344","PPIL3","2",201735630,201754026,18396
"14387","ENSG00000240356","RPL23AP7","2",114368079,114384667,16588
"14388","ENSG00000240370","RPL13P5","12",6982553,6993905,11352
"14389","ENSG00000240393","","3",117393189,117393991,802
"14390","ENSG00000240399","","12",48448596,48449374,778
"14391","ENSG00000240429","LRRFIP1P1","3",178976816,178979061,2245
"14392","ENSG00000240445","FOXO3B","17",18574259,18576186,1927
"14393","ENSG00000240489","SETP14","3",155705093,155705965,872
"14394","ENSG00000240498","CDKN2B-AS1","9",21994777,22121096,126319
"14395","ENSG00000240563","L1TD1","1",62660503,62678000,17497
"14396","ENSG00000240616","","19",13004947,13005694,747
"14397","ENSG00000240682","ISY1","3",128846258,128880136,33878
"14398","ENSG00000240694","PNMA2","8",26362202,26371608,9406
"14399","ENSG00000240695","","3",136455342,136456071,729
"14400","ENSG00000240729","","5",176691767,176692242,475
"14401","ENSG00000240731","","1",1252961,1254069,1108
"14402","ENSG00000240764","PCDHGC5","5",140868808,140892546,23738
"14403","ENSG00000240771","ARHGEF25","12",58003963,58013162,9199
"14404","ENSG00000240775","","4",123761498,123761845,347
"14405","ENSG00000240808","","11",17159523,17159812,289
"14406","ENSG00000240849","TMEM189","20",48697663,48770335,72672
"14407","ENSG00000240857","RDH14","2",18735989,18741946,5957
"14408","ENSG00000240869","RN7SL128P","6",20421812,20422118,306
"14409","ENSG00000240875","LINC00886","3",156465135,156534851,69716
"14410","ENSG00000240891","PLCXD2","3",111393523,111565294,171771
"14411","ENSG00000240935","PLGLA","2",106998562,107010027,11465
"14412","ENSG00000240964","RN7SL751P","3",78987155,78987442,287
"14413","ENSG00000240972","MIF","22",24236191,24237414,1223
"14414","ENSG00000240996","","10",91454052,91457685,3633
"14415","ENSG00000241014","","1",35439957,35450914,10957
"14416","ENSG00000241015","TPM3P9","19",53935237,53947923,12686
"14417","ENSG00000241030","RPL29P24","12",120960467,120961246,779
"14418","ENSG00000241043","GVQW1","9",32566787,32568619,1832
"14419","ENSG00000241058","NSUN6","10",18834490,18940551,106061
"14420","ENSG00000241112","RPL29P14","5",148924946,148925373,427
"14421","ENSG00000241120","HMGN1P8","3",167412143,167412430,287
"14422","ENSG00000241127","YAE1D1","7",39605975,39649919,43944
"14423","ENSG00000241163","LINC00877","3",72084451,72291716,207265
"14424","ENSG00000241170","","11",74587331,74631067,43736
"14425","ENSG00000241213","","3",117397540,117409779,12239
"14426","ENSG00000241217","RN7SL809P","12",57064236,57064530,294
"14427","ENSG00000241258","CRCP","7",65579591,65619555,39964
"14428","ENSG00000241261","RPL17P19","4",62077370,62077921,551
"14429","ENSG00000241288","","3",125546081,125607918,61837
"14430","ENSG00000241313","WWTR1-AS1","3",149374807,149379151,4344
"14431","ENSG00000241316","","3",67705121,67998137,293016
"14432","ENSG00000241343","RPL36A","X",100645812,100651105,5293
"14433","ENSG00000241357","","7",100032880,100034133,1253
"14434","ENSG00000241370","RPP21","6",30312908,30314661,1753
"14435","ENSG00000241399","CD302","2",160625364,160654753,29389
"14436","ENSG00000241468","ATP5J2","7",99046098,99063954,17856
"14437","ENSG00000241472","PTPRG-AS1","3",62246540,62355005,108465
"14438","ENSG00000241489","","X",148564074,148615470,51396
"14439","ENSG00000241506","PSMC1P1","3",68684856,68686175,1319
"14440","ENSG00000241528","","22",30770930,30773862,2932
"14441","ENSG00000241535","CBX5P1","3",88144558,88145118,560
"14442","ENSG00000241547","","1",27651820,27652287,467
"14443","ENSG00000241549","GUSBP2","6",26839263,26924333,85070
"14444","ENSG00000241553","ARPC4","3",9834179,9849410,15231
"14445","ENSG00000241597","","5",98290098,98290676,578
"14446","ENSG00000241634","","3",108262214,108262722,508
"14447","ENSG00000241684","ADAMTS9-AS2","3",64670585,64997143,326558
"14448","ENSG00000241685","ARPC1A","7",98923521,98985787,62266
"14449","ENSG00000241708","RN7SL129P","17",8450235,8450526,291
"14450","ENSG00000241732","","3",152557179,152559228,2049
"14451","ENSG00000241764","","7",107383262,107385026,1764
"14452","ENSG00000241769","LINC00893","X",148609130,148622504,13374
"14453","ENSG00000241781","","9",79186731,79186787,56
"14454","ENSG00000241785","RN7SL390P","12",54649415,54649694,279
"14455","ENSG00000241787","MTND4P16","3",106613199,106614565,1366
"14456","ENSG00000241837","ATP5O","21",35275757,35288284,12527
"14457","ENSG00000241839","PLEKHO2","15",65134088,65160206,26118
"14458","ENSG00000241852","C8orf58","8",22457114,22461663,4549
"14459","ENSG00000241859","KALP","Y",15863536,16027704,164168
"14460","ENSG00000241868","RN7SL434P","3",196124382,196124649,267
"14461","ENSG00000241878","PISD","22",32014477,32058418,43941
"14462","ENSG00000241882","","3",168006341,168009016,2675
"14463","ENSG00000241945","PWP2","21",45527171,45551063,23892
"14464","ENSG00000241956","","5",163723702,164598649,874947
"14465","ENSG00000241962","C2orf15","2",99757948,99939204,181256
"14466","ENSG00000241973","PI4KA","22",21061979,21213705,151726
"14467","ENSG00000241975","TCEB1P19","1",89294785,89295102,317
"14468","ENSG00000241978","AKAP2","9",112542769,112934792,392023
"14469","ENSG00000241985","WWTR1-IT1","3",149366784,149367971,1187
"14470","ENSG00000242013","USP27X","X",49644470,49647166,2696
"14471","ENSG00000242028","HYPK","15",44088340,44095241,6901
"14472","ENSG00000242071","RPL7AP6","14",70352057,70352869,812
"14473","ENSG00000242085","RPS20P33","14",105840955,105841308,353
"14474","ENSG00000242086","LINC00969","3",195384933,195460422,75489
"14475","ENSG00000242094","FOXP1-IT1","3",71619406,71623608,4202
"14476","ENSG00000242110","AMACR","5",33986283,34008220,21937
"14477","ENSG00000242125","SNHG3","1",28832492,28837404,4912
"14478","ENSG00000242152","","3",155149018,155151187,2169
"14479","ENSG00000242193","","1",177975271,178007085,31814
"14480","ENSG00000242220","TCP10L","21",33948862,33959683,10821
"14481","ENSG00000242242","PVRL3-AS1","3",110612555,110790400,177845
"14482","ENSG00000242247","ARFGAP3","22",43192508,43254112,61604
"14483","ENSG00000242259","C22orf39","22",19338891,19435755,96864
"14484","ENSG00000242265","PEG10","7",94285637,94299007,13370
"14485","ENSG00000242268","","3",168621154,168639784,18630
"14486","ENSG00000242282","","2",3579403,3584463,5060
"14487","ENSG00000242294","STAG3L5P","7",99933702,99949523,15821
"14488","ENSG00000242337","TFP1","3",133380842,133473420,92578
"14489","ENSG00000242338","BMS1P4","10",75475601,75490227,14626
"14490","ENSG00000242349","NPPA-AS1","1",11901074,11908136,7062
"14491","ENSG00000242372","EIF6","20",33866714,33872788,6074
"14492","ENSG00000242375","","9",99957633,99959969,2336
"14493","ENSG00000242398","RN7SL800P","17",60083100,60083348,248
"14494","ENSG00000242419","PCDHGC4","5",140864741,140892546,27805
"14495","ENSG00000242474","","7",135853,149466,13613
"14496","ENSG00000242485","MRPL20","1",1337288,1342693,5405
"14497","ENSG00000242498","C15orf38","15",90443159,90456188,13029
"14498","ENSG00000242539","","3",179114749,179116979,2230
"14499","ENSG00000242540","","2",5836352,5848227,11875
"14500","ENSG00000242588","","7",128171752,128269512,97760
"14501","ENSG00000242600","MBL1P","10",81664654,81710092,45438
"14502","ENSG00000242607","RPS3AP34","8",12427859,12428639,780
"14503","ENSG00000242612","DECR2","16",451826,462487,10661
"14504","ENSG00000242615","","19",12252621,12254137,1516
"14505","ENSG00000242622","","3",119813742,119855630,41888
"14506","ENSG00000242687","","7",98610788,98645863,35075
"14507","ENSG00000242689","CNTF","11",58390146,58393198,3052
"14508","ENSG00000242715","CCDC169","13",36801182,36871977,70795
"14509","ENSG00000242732","RGAG4","X",71346958,71351758,4800
"14510","ENSG00000242737","","15",50758935,50759293,358
"14511","ENSG00000242759","LINC00882","3",106555658,106959488,403830
"14512","ENSG00000242779","ZNF702P","19",53471504,53541151,69647
"14513","ENSG00000242791","","3",149694542,149697142,2600
"14514","ENSG00000242797","GLYCTK-AS1","3",52322599,52333083,10484
"14515","ENSG00000242798","","7",99712837,99724762,11925
"14516","ENSG00000242802","AP5Z1","7",4815253,4833943,18690
"14517","ENSG00000242808","SOX2-OT","3",180707558,181554668,847110
"14518","ENSG00000242852","ZNF709","19",12571998,12624668,52670
"14519","ENSG00000242876","RN7SL812P","22",20836224,20836497,273
"14520","ENSG00000242889","RN7SL449P","17",55695469,55695759,290
"14521","ENSG00000242931","RPL7P49","17",74426499,74427206,707
"14522","ENSG00000242976","RN7SL177P","5",153134942,153135238,296
"14523","ENSG00000242999","RN7SL239P","11",74556955,74557251,296
"14524","ENSG00000243005","RN7SL16P","4",24564818,24565084,266
"14525","ENSG00000243015","RN7SL737P","12",93903263,93903544,281
"14526","ENSG00000243107","","7",91829328,91836171,6843
"14527","ENSG00000243147","MRPL33","2",27994584,28210954,216370
"14528","ENSG00000243155","","1",180913178,180945618,32440
"14529","ENSG00000243156","MICAL3","22",18270415,18507325,236910
"14530","ENSG00000243176","","3",156893012,157099054,206042
"14531","ENSG00000243199","","4",66439177,66440046,869
"14532","ENSG00000243232","PCDHAC2","5",140345820,140391936,46116
"14533","ENSG00000243244","STON1","2",48756522,48826025,69503
"14534","ENSG00000243279","PRAF2","X",48928813,48931730,2917
"14535","ENSG00000243302","","7",128291239,128292388,1149
"14536","ENSG00000243317","C7orf73","7",135347244,135378166,30922
"14537","ENSG00000243319","FGF14-IT1","13",102944677,103046869,102192
"14538","ENSG00000243335","KCTD7","7",66093868,66276446,182578
"14539","ENSG00000243364","EFNA4","1",155036207,155042029,5822
"14540","ENSG00000243398","RN7SL141P","3",171955116,171955384,268
"14541","ENSG00000243406","MRPS31P5","13",52741844,52768600,26756
"14542","ENSG00000243444","PALM2","9",112403068,112713755,310687
"14543","ENSG00000243449","C4orf48","4",2043689,2045697,2008
"14544","ENSG00000243452","NBPF15","1",148555979,148596267,40288
"14545","ENSG00000243477","NAT6","3",50333833,50336852,3019
"14546","ENSG00000243554","","7",97598317,97601566,3249
"14547","ENSG00000243587","C6orf183","6",109487036,109592217,105181
"14548","ENSG00000243609","RPS2P44","16",48611435,48612280,845
"14549","ENSG00000243620","","3",146627472,147088443,460971
"14550","ENSG00000243646","IL10RB","21",34638663,34669539,30876
"14551","ENSG00000243660","ZNF487","10",43932282,43991517,59235
"14552","ENSG00000243667","WDR92","2",68350068,68384692,34624
"14553","ENSG00000243678","NME1-NME2","17",49230920,49249108,18188
"14554","ENSG00000243679","","7",128294023,128294776,753
"14555","ENSG00000243696","","3",52847298,52869745,22447
"14556","ENSG00000243701","LINC00883","3",106959539,107045811,86272
"14557","ENSG00000243710","WDR65","1",43637820,43720029,82209
"14558","ENSG00000243716","NPIPB5","16",22490442,22547842,57400
"14559","ENSG00000243721","","11",43740226,43740696,470
"14560","ENSG00000243725","TTC4","1",55181495,55208330,26835
"14561","ENSG00000243745","RN7SL844P","19",16509477,16509770,293
"14562","ENSG00000243753","HLA-L","6",30227361,30260791,33430
"14563","ENSG00000243789","JMJD7","15",42120283,42129779,9496
"14564","ENSG00000243854","RN7SL67P","12",19456414,19456710,296
"14565","ENSG00000243915","PRKRIRP2","3",86061711,86064270,2559
"14566","ENSG00000243927","MRPS6","21",35445524,35515334,69810
"14567","ENSG00000243943","ZNF512","2",27805897,27858041,52144
"14568","ENSG00000243955","GSTA1","6",52656462,52668708,12246
"14569","ENSG00000243960","","1",111981260,111983986,2726
"14570","ENSG00000243970","PPIEL","1",39997510,40024379,26869
"14571","ENSG00000243978","RGAG1","X",109602044,109699562,97518
"14572","ENSG00000243989","ACY1","3",52009066,52023213,14147
"14573","ENSG00000244005","NFS1","20",34255977,34287281,31304
"14574","ENSG00000244026","FAM86DP","3",75470703,75484261,13558
"14575","ENSG00000244038","DDOST","1",20978270,20988000,9730
"14576","ENSG00000244041","LINC01011","6",2988201,2991407,3206
"14577","ENSG00000244045","TMEM199","17",26684604,26708716,24112
"14578","ENSG00000244055","","7",92086878,92120924,34046
"14579","ENSG00000244119","PDCL3P4","3",101431316,101432035,719
"14580","ENSG00000244165","P2RY11","19",10222214,10226048,3834
"14581","ENSG00000244187","TMEM141","9",139685807,139687709,1902
"14582","ENSG00000244218","RN7SL81P","7",128401391,128401625,234
"14583","ENSG00000244227","","3",167613736,167641799,28063
"14584","ENSG00000244291","C7orf13","7",156431057,156433348,2291
"14585","ENSG00000244313","","11",46450163,46450700,537
"14586","ENSG00000244332","","10",96337196,96370995,33799
"14587","ENSG00000244346","","3",182668571,182674095,5524
"14588","ENSG00000244398","","11",16996240,16996560,320
"14589","ENSG00000244405","ETV5","3",185764097,185828107,64010
"14590","ENSG00000244462","RBM12","20",34236847,34252878,16031
"14591","ENSG00000244486","SCARF2","22",20778874,20792146,13272
"14592","ENSG00000244509","APOBEC3C","22",39410088,39416357,6269
"14593","ENSG00000244560","","7",148982372,148994403,12031
"14594","ENSG00000244567","","2",208686014,208687493,1479
"14595","ENSG00000244617","ASPRV1","2",70187226,70189397,2171
"14596","ENSG00000244618","RN7SL334P","6",25031243,25031510,267
"14597","ENSG00000244625","","22",27068730,27176170,107440
"14598","ENSG00000244627","","22",38731767,38794934,63167
"14599","ENSG00000244687","UBE2V1","20",48697661,48732496,34835
"14600","ENSG00000244694","PTCHD4","6",47845764,48036425,190661
"14601","ENSG00000244701","","7",141352181,141356610,4429
"14602","ENSG00000244716","","1",109534878,109535489,611
"14603","ENSG00000244754","N4BP2L2","13",33006554,33112970,106416
"14604","ENSG00000244879","GABPB1-AS1","15",50647525,50659636,12111
"14605","ENSG00000244968","LIFR-AS1","5",38556888,38671318,114430
"14606","ENSG00000245017","","12",98879322,98897633,18311
"14607","ENSG00000245025","","8",22842109,22876848,34739
"14608","ENSG00000245060","LINC00847","5",180257957,180262726,4769
"14609","ENSG00000245105","A2M-AS1","12",9217773,9220651,2878
"14610","ENSG00000245149","RNF139-AS1","8",125474726,125486817,12091
"14611","ENSG00000245213","","4",174053079,174090803,37724
"14612","ENSG00000245275","SAP30L-AS1","5",153708997,153825410,116413
"14613","ENSG00000245281","","8",17942377,17953903,11526
"14614","ENSG00000245317","","5",179286013,179288283,2270
"14615","ENSG00000245498","","11",124670346,124704383,34037
"14616","ENSG00000245526","LINC00461","5",87803363,87986858,183495
"14617","ENSG00000245532","NEAT1","11",65190245,65213011,22766
"14618","ENSG00000245534","","15",60771377,60922836,151459
"14619","ENSG00000245552","","11",94883703,94967268,83565
"14620","ENSG00000245556","","5",77638189,77656331,18142
"14621","ENSG00000245571","","11",58897606,58910488,12882
"14622","ENSG00000245573","BDNF-AS","11",27528385,27719721,191336
"14623","ENSG00000245614","DDX11-AS1","12",31173697,31226781,53084
"14624","ENSG00000245680","ZNF585B","19",37672481,37709055,36574
"14625","ENSG00000245685","","4",190701490,190861426,159936
"14626","ENSG00000245694","CRNDE","16",54952775,54963101,10326
"14627","ENSG00000245812","","5",158527491,158544486,16995
"14628","ENSG00000245849","RAD51-AS1","15",40978922,40987305,8383
"14629","ENSG00000245857","","8",6693076,6742798,49722
"14630","ENSG00000245888","","16",27279526,27301813,22287
"14631","ENSG00000245904","","12",92539349,92583436,44087
"14632","ENSG00000245910","SNHG6","8",67833919,67838633,4714
"14633","ENSG00000245937","","5",127276118,127418864,142746
"14634","ENSG00000245958","","4",120375946,120473180,97234
"14635","ENSG00000246067","RAB30-AS1","11",82783108,82817761,34653
"14636","ENSG00000246089","","8",6261072,6264663,3591
"14637","ENSG00000246090","","4",100010008,100222513,212505
"14638","ENSG00000246130","","8",22925742,22941132,15390
"14639","ENSG00000246174","KCTD21-AS1","11",77850817,77886369,35552
"14640","ENSG00000246263","","8",103251622,103265561,13939
"14641","ENSG00000246273","SBF2-AS1","11",9779839,9832866,53027
"14642","ENSG00000246283","","15",43031316,43035400,4084
"14643","ENSG00000246308","","11",10830844,10844478,13634
"14644","ENSG00000246339","EXTL3-AS1","8",28553718,28558981,5263
"14645","ENSG00000246350","","6",28555155,28559524,4369
"14646","ENSG00000246465","","16",28296206,28303385,7179
"14647","ENSG00000246560","","4",103749212,103765232,16020
"14648","ENSG00000246596","","5",177046060,177099210,53150
"14649","ENSG00000246662","LINC00535","8",94225531,94712661,487130
"14650","ENSG00000246695","RASSF8-AS1","12",26092262,26112698,20436
"14651","ENSG00000246705","H2AFJ","12",14927270,14930936,3666
"14652","ENSG00000246731","","17",72206119,72209481,3362
"14653","ENSG00000246777","","16",66785655,66788643,2988
"14654","ENSG00000246792","","8",91658669,91668826,10157
"14655","ENSG00000246859","STARD4-AS1","5",110847924,111075423,227499
"14656","ENSG00000246889","","11",70218352,70244594,26242
"14657","ENSG00000246898","LINC00920","16",66442427,66446038,3611
"14658","ENSG00000246922","UBAP1L","15",65385338,65407535,22197
"14659","ENSG00000246985","SOCS2-AS1","12",93936239,93965544,29305
"14660","ENSG00000247077","PGAM5","12",133287405,133299228,11823
"14661","ENSG00000247081","","8",104169218,104311000,141782
"14662","ENSG00000247092","SNHG10","14",95998634,96001209,2575
"14663","ENSG00000247095","MIR210HG","11",565660,568457,2797
"14664","ENSG00000247121","","5",96149731,96271513,121782
"14665","ENSG00000247134","","8",32853696,32902373,48677
"14666","ENSG00000247137","","11",82895533,82904836,9303
"14667","ENSG00000247199","","5",147647870,147763346,115476
"14668","ENSG00000247240","UBL7-AS1","15",74753606,74773643,20037
"14669","ENSG00000247271","ZBED5-AS1","11",10879806,10928349,48543
"14670","ENSG00000247373","","12",124066767,124069662,2895
"14671","ENSG00000247400","DNAJC3-AS1","13",96300987,96329179,28192
"14672","ENSG00000247516","MIR4458HG","5",8450856,8463208,12352
"14673","ENSG00000247556","OIP5-AS1","15",41576188,41601901,25713
"14674","ENSG00000247572","CKMT2-AS1","5",80499903,80597379,97476
"14675","ENSG00000247595","SPTY2D1-AS1","11",18621334,18631802,10468
"14676","ENSG00000247596","TWF2","3",52262626,52273276,10650
"14677","ENSG00000247626","MARS2","2",198570087,198573113,3026
"14678","ENSG00000247679","","5",177038254,177046755,8501
"14679","ENSG00000247708","STX18-AS1","4",4543858,4712665,168807
"14680","ENSG00000247728","","15",30909201,30917976,8775
"14681","ENSG00000247735","","16",29938157,29940254,2097
"14682","ENSG00000247746","USP51","X",55511049,55515635,4586
"14683","ENSG00000247765","","15",21941147,21968151,27004
"14684","ENSG00000247796","","5",52405672,52410956,5284
"14685","ENSG00000247809","NR2F2-AS1","15",96670598,96870590,199992
"14686","ENSG00000247828","TMEM161B-AS1","5",87564712,87732502,167790
"14687","ENSG00000247877","","5",99785458,99870966,85508
"14688","ENSG00000247950","SEC24B-AS1","4",110268631,110354973,86342
"14689","ENSG00000247982","LINC00926","15",57592563,57599959,7396
"14690","ENSG00000248008","DYNLL1-AS1","12",120928131,120933743,5612
"14691","ENSG00000248015","","19",1392169,1396466,4297
"14692","ENSG00000248019","FAM13A-AS1","4",89630940,89651254,20314
"14693","ENSG00000248049","UBA6-AS1","4",68566998,68946670,379672
"14694","ENSG00000248092","NNT-AS1","5",43571696,43603332,31636
"14695","ENSG00000248103","","5",180708376,180710653,2277
"14696","ENSG00000248121","SMURF2P1","17",28927814,28942998,15184
"14697","ENSG00000248124","RRN3P1","16",21807951,21831731,23780
"14698","ENSG00000248161","","4",103339759,103371167,31408
"14699","ENSG00000248175","","5",114539713,114541943,2230
"14700","ENSG00000248202","","5",97217124,97258399,41275
"14701","ENSG00000248206","","4",184908831,184909903,1072
"14702","ENSG00000248221","STX18-IT1","4",4477848,4483427,5579
"14703","ENSG00000248228","SLIT2-IT1","4",20393812,20396479,2667
"14704","ENSG00000248231","KRT8P4","8",90424850,90427300,2450
"14705","ENSG00000248266","","4",183066005,183111535,45530
"14706","ENSG00000248275","TRIM52-AS1","5",180688213,180699308,11095
"14707","ENSG00000248280","","4",120361716,120371312,9596
"14708","ENSG00000248309","MEF2C-AS1","5",88179145,88762215,583070
"14709","ENSG00000248323","LUCAT1","5",90598846,90610219,11373
"14710","ENSG00000248333","CDK11B","1",1570603,1590473,19870
"14711","ENSG00000248334","WHAMMP2","15",28982729,29002537,19808
"14712","ENSG00000248383","PCDHAC1","5",140306302,140391929,85627
"14713","ENSG00000248445","","5",115783243,115843972,60729
"14714","ENSG00000248449","PCDHGB8P","5",140805853,140808219,2366
"14715","ENSG00000248464","FGF10-AS1","5",44388834,44414091,25257
"14716","ENSG00000248476","BACH1-IT1","21",30723955,30734215,10260
"14717","ENSG00000248479","","4",66567920,66571271,3351
"14718","ENSG00000248483","POU5F2","5",93070508,93077343,6835
"14719","ENSG00000248487","ABHD14A","3",52005442,52015212,9770
"14720","ENSG00000248489","","5",98264875,98330717,65842
"14721","ENSG00000248508","SRP14-AS1","15",40331512,40359491,27979
"14722","ENSG00000248527","MTATP6P1","1",569076,569756,680
"14723","ENSG00000248540","","15",74418256,74421619,3363
"14724","ENSG00000248593","DSTNP2","12",6993846,6994950,1104
"14725","ENSG00000248599","","8",102064282,102088479,24197
"14726","ENSG00000248632","","4",165889739,165891154,1415
"14727","ENSG00000248671","","11",71505409,71529284,23875
"14728","ENSG00000248712","CCDC153","11",119060347,119067479,7132
"14729","ENSG00000248731","","8",25798739,25801385,2646
"14730","ENSG00000248734","","5",96120481,96121703,1222
"14731","ENSG00000248773","","3",140691586,140692097,511
"14732","ENSG00000248774","","4",174243357,174250845,7488
"14733","ENSG00000248794","","5",80538149,80538418,269
"14734","ENSG00000248835","","1",54635333,54637997,2664
"14735","ENSG00000248866","USP46-AS1","4",53525573,53527835,2262
"14736","ENSG00000248890","HHIP-AS1","4",145564074,145582509,18435
"14737","ENSG00000248905","FMN1","15",33057747,33486897,429150
"14738","ENSG00000248909","HMGB1P21","5",77940088,77940668,580
"14739","ENSG00000248925","","5",269973,271631,1658
"14740","ENSG00000248927","","5",120116913,120126473,9560
"14741","ENSG00000248932","","3",139108657,139302161,193504
"14742","ENSG00000248971","KRT8P46","4",103649903,103651328,1425
"14743","ENSG00000249020","SNORA58","3",131197941,131198077,136
"14744","ENSG00000249034","","5",140240341,140243224,2883
"14745","ENSG00000249042","","5",79778112,79783882,5770
"14746","ENSG00000249087","C1orf213","1",23695490,23698332,2842
"14747","ENSG00000249096","","4",185286336,185303460,17124
"14748","ENSG00000249115","HAUS5","19",36103646,36116251,12605
"14749","ENSG00000249140","PRDX2P3","5",178999157,178999742,585
"14750","ENSG00000249158","PCDHA11","5",140248689,140391929,143240
"14751","ENSG00000249212","ATP1B1P1","4",42031226,42032140,914
"14752","ENSG00000249241","","4",40318502,40332436,13934
"14753","ENSG00000249242","TMEM150C","4",83404323,83483510,79187
"14754","ENSG00000249258","","8",16988690,17007298,18608
"14755","ENSG00000249286","","5",43587020,43588325,1305
"14756","ENSG00000249307","LINC01088","4",79892902,80229952,337050
"14757","ENSG00000249348","UGDH-AS1","4",39529639,39596327,66688
"14758","ENSG00000249353","NPM1P27","5",93018544,93019373,829
"14759","ENSG00000249395","CASC9","8",76135639,76236976,101337
"14760","ENSG00000249421","ADAMTS19-AS1","5",128795252,128796382,1130
"14761","ENSG00000249430","","5",92266,139978,47712
"14762","ENSG00000249437","NAIP","5",70264310,70320941,56631
"14763","ENSG00000249459","ZNF286B","17",18561742,18585575,23833
"14764","ENSG00000249464","LINC01091","4",124571422,124851561,280139
"14765","ENSG00000249471","ZNF324B","19",58962971,58969200,6229
"14766","ENSG00000249476","","5",108572821,108662070,89249
"14767","ENSG00000249504","PCDHA14","5",140240860,140243104,2244
"14768","ENSG00000249572","","5",33424131,33440725,16594
"14769","ENSG00000249577","","5",126801514,126801810,296
"14770","ENSG00000249592","","4",756175,775637,19462
"14771","ENSG00000249637","","5",139750476,139780952,30476
"14772","ENSG00000249655","","5",79926132,79927409,1277
"14773","ENSG00000249661","TNRC18P1","4",141562994,141566643,3649
"14774","ENSG00000249669","MIR143HG","5",148786252,148808241,21989
"14775","ENSG00000249673","NOP14-AS1","4",2936626,2963465,26839
"14776","ENSG00000249709","ZNF564","19",12636184,12662356,26172
"14777","ENSG00000249715","FER1L5","2",97308474,97370624,62150
"14778","ENSG00000249776","","5",91745963,91996570,250607
"14779","ENSG00000249784","SCARNA22","4",1976363,1976487,124
"14780","ENSG00000249790","","12",8940853,8948385,7532
"14781","ENSG00000249803","","5",135802366,135855987,53621
"14782","ENSG00000249846","","3",129831393,129839422,8029
"14783","ENSG00000249850","KRT18P31","5",36885308,36886599,1291
"14784","ENSG00000249853","HS3ST5","6",114376750,114664209,287459
"14785","ENSG00000249855","EEF1A1P19","5",43495175,43496556,1381
"14786","ENSG00000249859","PVT1","8",128806779,129113499,306720
"14787","ENSG00000249863","","4",37869913,37871599,1686
"14788","ENSG00000249876","","5",179366457,179367132,675
"14789","ENSG00000249898","","8",6475996,6565730,89734
"14790","ENSG00000249915","PDCD6","5",271736,353971,82235
"14791","ENSG00000249992","TMEM158","3",45265958,45267770,1812
"14792","ENSG00000250001","","5",9519965,9523290,3325
"14793","ENSG00000250067","YJEFN3","19",19627036,19648390,21354
"14794","ENSG00000250081","","5",64782271,64782875,604
"14795","ENSG00000250091","DNAH10OS","12",124410971,124419531,8560
"14796","ENSG00000250120","PCDHA10","5",140235595,140391929,156334
"14797","ENSG00000250130","","15",44646889,44647890,1001
"14798","ENSG00000250131","","4",178366133,178598280,232147
"14799","ENSG00000250132","","12",1083299,1100356,17057
"14800","ENSG00000250170","RASA2-IT1","3",141243975,141244963,988
"14801","ENSG00000250220","","4",74124926,74183670,58744
"14802","ENSG00000250241","","4",133996466,134070271,73805
"14803","ENSG00000250251","PKD1P6","16",15219099,15248421,29322
"14804","ENSG00000250280","","12",65675437,65680508,5071
"14805","ENSG00000250284","","5",136070616,136090375,19759
"14806","ENSG00000250303","","11",112141472,112233257,91785
"14807","ENSG00000250305","KIAA1456","8",12803151,12889012,85861
"14808","ENSG00000250312","ZNF718","4",124386,157779,33393
"14809","ENSG00000250317","SMIM20","4",25863452,25931435,67983
"14810","ENSG00000250326","","4",143854348,144106014,251666
"14811","ENSG00000250329","KDELC1P1","5",127445178,127446686,1508
"14812","ENSG00000250331","","5",96840400,97006750,166350
"14813","ENSG00000250337","LINC01021","5",27472399,27496508,24109
"14814","ENSG00000250366","LINC00617","14",96342729,96391908,49179
"14815","ENSG00000250371","","4",12860725,12866585,5860
"14816","ENSG00000250404","","11",3837982,3843130,5148
"14817","ENSG00000250461","","5",60670939,60671682,743
"14818","ENSG00000250462","LRRC37BP1","17",28956698,28964482,7784
"14819","ENSG00000250479","CHCHD10","22",24108021,24110630,2609
"14820","ENSG00000250486","FAM218A","4",165878100,165880273,2173
"14821","ENSG00000250510","GPR162","12",6930711,6939136,8425
"14822","ENSG00000250539","KRT8P33","5",122736616,122738038,1422
"14823","ENSG00000250565","ATP6V1E2","2",46717889,46769696,51807
"14824","ENSG00000250568","","4",39974748,39975062,314
"14825","ENSG00000250569","NTAN1P2","8",87493983,87495231,1248
"14826","ENSG00000250571","GLI4","8",144349603,144359101,9498
"14827","ENSG00000250608","","3",131043936,131100319,56383
"14828","ENSG00000250616","","16",30107751,30115437,7686
"14829","ENSG00000250686","","6",62340138,62390954,50816
"14830","ENSG00000250722","SEPP1","5",42799982,42887494,87512
"14831","ENSG00000250731","TPM3P6","19",53982604,53983345,741
"14832","ENSG00000250764","","5",32103551,32122047,18496
"14833","ENSG00000250786","SNHG18","5",9546312,9550721,4409
"14834","ENSG00000250802","ZBED3-AS1","5",76382565,76462734,80169
"14835","ENSG00000250838","","17",47072628,47074854,2226
"14836","ENSG00000250846","","4",66535679,66563747,28068
"14837","ENSG00000250853","RNF138P1","5",54825984,54826529,545
"14838","ENSG00000250899","","12",3150603,3154116,3513
"14839","ENSG00000250903","GMDS-AS1","6",2245982,2482256,236274
"14840","ENSG00000250933","GAPDHP66","18",3977649,3978615,966
"14841","ENSG00000250938","","4",120988113,121337921,349808
"14842","ENSG00000250950","","4",120377505,120378432,927
"14843","ENSG00000250959","GLUD1P3","10",75490320,75497069,6749
"14844","ENSG00000250988","","15",83419316,83425958,6642
"14845","ENSG00000250993","","4",180310288,180386459,76171
"14846","ENSG00000251002","","14",22849083,22951948,102865
"14847","ENSG00000251003","","8",106792474,107072752,280278
"14848","ENSG00000251022","THAP9-AS1","4",83814162,83822113,7951
"14849","ENSG00000251023","","5",93196375,93199531,3156
"14850","ENSG00000251046","ZNF969P","4",111337054,111339660,2606
"14851","ENSG00000251050","","5",79315432,79315743,311
"14852","ENSG00000251072","","5",126087655,126112178,24523
"14853","ENSG00000251095","","4",90472507,90647654,175147
"14854","ENSG00000251136","","8",90621638,90769955,148317
"14855","ENSG00000251138","","12",74526946,74796315,269369
"14856","ENSG00000251141","","5",44745002,44808879,63877
"14857","ENSG00000251143","","11",71725337,71731956,6619
"14858","ENSG00000251161","","15",41199009,41201540,2531
"14859","ENSG00000251188","","4",262771,263320,549
"14860","ENSG00000251192","ZNF674","X",46357162,46404892,47730
"14861","ENSG00000251247","ZNF345","19",37341263,37403931,62668
"14862","ENSG00000251287","ALG1L2","3",129800674,129832070,31396
"14863","ENSG00000251322","SHANK3","22",51112843,51171726,58883
"14864","ENSG00000251323","","11",78135028,78140882,5854
"14865","ENSG00000251348","HSPD1P11","5",95104703,95106404,1701
"14866","ENSG00000251363","","14",41424103,41445082,20979
"14867","ENSG00000251369","ZNF550","19",58046625,58071231,24606
"14868","ENSG00000251432","","4",129213906,129440549,226643
"14869","ENSG00000251456","","5",124070311,124070868,557
"14870","ENSG00000251468","","8",12815896,12819709,3813
"14871","ENSG00000251474","RPL32P3","3",129101765,129118498,16733
"14872","ENSG00000251485","","2",233207826,233208613,787
"14873","ENSG00000251550","","17",47114484,47114791,307
"14874","ENSG00000251562","MALAT1","11",65265233,65273940,8707
"14875","ENSG00000251580","","4",6672452,6675557,3105
"14876","ENSG00000251595","ABCA11P","4",419224,467918,48694
"14877","ENSG00000251602","","14",105883221,105886076,2855
"14878","ENSG00000251609","SETP12","4",121816649,121818238,1589
"14879","ENSG00000251615","","4",8356817,8360065,3248
"14880","ENSG00000251634","","5",70398725,70424580,25855
"14881","ENSG00000251661","","11",318640,325631,6991
"14882","ENSG00000251664","PCDHA12","5",140255058,140391929,136871
"14883","ENSG00000251666","ZNF346-IT1","5",176478715,176479964,1249
"14884","ENSG00000251667","","5",175735066,175736016,950
"14885","ENSG00000251669","FAM86EP","4",3943487,3957146,13659
"14886","ENSG00000251682","","5",60642953,60643543,590
"14887","ENSG00000251689","","4",263655,263964,309
"14888","ENSG00000251703","RNU6-998P","4",57868858,57868958,100
"14889","ENSG00000251705","RNA5-8SP6","Y",10037764,10037915,151
"14890","ENSG00000251769","","14",101382173,101382230,57
"14891","ENSG00000251791","SCARNA6","2",234197322,234197586,264
"14892","ENSG00000251795","","1",93303575,93303627,52
"14893","ENSG00000251815","SNORD116-26","15",25344646,25344741,95
"14894","ENSG00000251867","","8",81396796,81397854,1058
"14895","ENSG00000251896","SNORD116-27","15",25346722,25346813,91
"14896","ENSG00000251949","","14",101392317,101392388,71
"14897","ENSG00000251969","","6",79671213,79671289,76
"14898","ENSG00000251988","RNU4ATAC18P","6",160141447,160141572,125
"14899","ENSG00000251992","SCARNA17","18",47340503,47340646,143
"14900","ENSG00000252010","SCARNA5","2",234184373,234184648,275
"14901","ENSG00000252071","","19",47451546,47451631,85
"14902","ENSG00000252124","","22",40924061,40924137,76
"14903","ENSG00000252139","","18",47340731,47340813,82
"14904","ENSG00000252150","","4",461317,461425,108
"14905","ENSG00000252192","","12",122976660,122976788,128
"14906","ENSG00000252212","RNU2-58P","17",57206637,57206819,182
"14907","ENSG00000252213","","5",138611869,138612009,140
"14908","ENSG00000252234","","18",14118593,14118701,108
"14909","ENSG00000252246","RNA5SP92","2",33557965,33558074,109
"14910","ENSG00000252277","SNORD116-30","15",25353415,25353499,84
"14911","ENSG00000252295","","5",122131820,122131922,102
"14912","ENSG00000252310","RNY5","7",148638580,148638658,78
"14913","ENSG00000252316","RNY4","7",148660407,148660502,95
"14914","ENSG00000252326","SNORD116-25","15",25342810,25342901,91
"14915","ENSG00000252343","RNU2-34P","4",183469812,183469932,120
"14916","ENSG00000252473","","2",39510798,39510932,134
"14917","ENSG00000252481","SCARNA13","14",95999692,95999966,274
"14918","ENSG00000252498","RNU6-1016P","6",76353800,76353893,93
"14919","ENSG00000252549","RNU6-759P","20",34235250,34235352,102
"14920","ENSG00000252602","","15",30935128,30935255,127
"14921","ENSG00000252690","SCARNA15","15",83421636,83425960,4324
"14922","ENSG00000252757","RN7SKP96","4",87257471,87257767,296
"14923","ENSG00000252759","","2",201727875,201727970,95
"14924","ENSG00000252782","RNU6-341P","14",58759011,58759106,95
"14925","ENSG00000252808","SCARNA4","1",155895749,155895877,128
"14926","ENSG00000252817","","1",154226921,154226997,76
"14927","ENSG00000252835","SCARNA21","17",7809440,7809578,138
"14928","ENSG00000252873","","14",101383915,101383982,67
"14929","ENSG00000252906","SCARNA3","1",175937534,175937676,142
"14930","ENSG00000252922","RNU6-365P","11",41144457,41144562,105
"14931","ENSG00000252947","SCARNA1","1",28160912,28161077,165
"14932","ENSG00000252949","","6",20422549,20422632,83
"14933","ENSG00000252982","RN7SKP234","3",173775431,173775654,223
"14934","ENSG00000253007","","22",34100772,34100906,134
"14935","ENSG00000253008","MIR2355","2",207974711,207974797,86
"14936","ENSG00000253051","","13",45910449,45910582,133
"14937","ENSG00000253057","RN7SKP57","5",111055466,111055758,292
"14938","ENSG00000253106","","8",125500751,125503884,3133
"14939","ENSG00000253159","PCDHGA12","5",140810185,140892546,82361
"14940","ENSG00000253180","","8",100015635,100016070,435
"14941","ENSG00000253190","","8",67024902,67027440,2538
"14942","ENSG00000253200","","8",22471421,22474170,2749
"14943","ENSG00000253203","GUSBP3","5",68790040,69006341,216301
"14944","ENSG00000253208","","8",26405185,26405979,794
"14945","ENSG00000253218","KLF3P1","5",171681422,171682443,1021
"14946","ENSG00000253230","LINC00599","8",9757574,9762876,5302
"14947","ENSG00000253250","C8orf88","8",91970865,91997485,26620
"14948","ENSG00000253251","","5",64920592,64926718,6126
"14949","ENSG00000253263","","8",103904104,103905836,1732
"14950","ENSG00000253276","CCDC71L","7",106297211,106301442,4231
"14951","ENSG00000253284","","12",19300008,19307593,7585
"14952","ENSG00000253304","TMEM200B","1",29445940,29450447,4507
"14953","ENSG00000253305","PCDHGB6","5",140787770,140892546,104776
"14954","ENSG00000253320","","8",103876528,103990104,113576
"14955","ENSG00000253347","","17",45486688,45500892,14204
"14956","ENSG00000253352","TUG1","22",31366663,31375381,8718
"14957","ENSG00000253357","","5",167148368,167156129,7761
"14958","ENSG00000253368","TRNP1","1",27320198,27327389,7191
"14959","ENSG00000253372","","8",123819985,123828756,8771
"14960","ENSG00000253379","","8",72315675,72504260,188585
"14961","ENSG00000253390","","8",23316114,23342484,26370
"14962","ENSG00000253457","SMIM18","8",30496117,30503581,7464
"14963","ENSG00000253475","","8",52808517,52808934,417
"14964","ENSG00000253476","","8",25283037,25284096,1059
"14965","ENSG00000253477","","8",104495626,104513904,18278
"14966","ENSG00000253485","PCDHGA5","5",140743898,140892546,148648
"14967","ENSG00000253516","HMGB1P41","8",81724377,81724816,439
"14968","ENSG00000253537","PCDHGA7","5",140762467,140892546,130079
"14969","ENSG00000253540","FAM86HP","3",129817935,129830315,12380
"14970","ENSG00000253549","","8",86354080,86377144,23064
"14971","ENSG00000253553","","8",89339065,89749363,410298
"14972","ENSG00000253554","","8",64599737,65281115,681378
"14973","ENSG00000253558","","5",77337703,77339962,2259
"14974","ENSG00000253559","OSGEPL1-AS1","2",190627430,190630282,2852
"14975","ENSG00000253586","","8",38657161,38659814,2653
"14976","ENSG00000253598","SLC10A5","8",82605842,82608409,2567
"14977","ENSG00000253636","","8",73964413,73975296,10883
"14978","ENSG00000253641","","8",10332075,10339484,7409
"14979","ENSG00000253660","","5",167364722,167380474,15752
"14980","ENSG00000253661","ZFHX4-AS1","8",77403435,77595513,192078
"14981","ENSG00000253693","","5",164776036,165205694,429658
"14982","ENSG00000253704","","8",95565950,95581973,16023
"14983","ENSG00000253710","ALG11","13",52586534,52603800,17266
"14984","ENSG00000253716","","8",144362331,144363860,1529
"14985","ENSG00000253719","ATXN7L3B","12",74931551,74935223,3672
"14986","ENSG00000253729","PRKDC","8",48685669,48872743,187074
"14987","ENSG00000253731","PCDHGA6","5",140753651,140892546,138895
"14988","ENSG00000253738","","8",92072137,92082417,10280
"14989","ENSG00000253767","PCDHGA8","5",140772381,140892546,120165
"14990","ENSG00000253771","TPTE2P1","13",25498815,25542625,43810
"14991","ENSG00000253797","UTP14C","13",52598827,52607736,8909
"14992","ENSG00000253816","","5",69515745,69580686,64941
"14993","ENSG00000253846","PCDHGA10","5",140792743,140892546,99803
"14994","ENSG00000253854","","8",94731802,94733395,1593
"14995","ENSG00000253864","","5",148786526,148793660,7134
"14996","ENSG00000253873","PCDHGA11","5",140800762,140891835,91073
"14997","ENSG00000253878","","8",95962265,95963624,1359
"14998","ENSG00000253910","PCDHGB2","5",140739703,140892546,152843
"14999","ENSG00000253948","","8",100008991,100025272,16281
"15000","ENSG00000253953","PCDHGB4","5",140767452,140892546,125094
"15001","ENSG00000253966","","5",170323933,170331465,7532
"15002","ENSG00000253982","","8",1710156,1712668,2512
"15003","ENSG00000254004","ZNF260","19",37001597,37019562,17965
"15004","ENSG00000254048","","8",59904279,59905497,1218
"15005","ENSG00000254087","LYN","8",56792372,56923940,131568
"15006","ENSG00000254090","MTND2P32","8",32872779,32874561,1782
"15007","ENSG00000254093","PINX1","8",10622473,10697394,74921
"15008","ENSG00000254122","PCDHGB7","5",140797427,140892546,95119
"15009","ENSG00000254141","","8",106682219,106691259,9040
"15010","ENSG00000254165","","8",42392672,42393447,775
"15011","ENSG00000254180","","8",91546839,91632298,85459
"15012","ENSG00000254184","TYW1B","7",72023729,72298777,275048
"15013","ENSG00000254206","NPIPB11","16",29392675,29415350,22675
"15014","ENSG00000254221","PCDHGB1","5",140729828,140892546,162718
"15015","ENSG00000254226","","5",151329132,151650009,320877
"15016","ENSG00000254245","PCDHGA3","5",140723601,140892546,168945
"15017","ENSG00000254319","","8",2523591,2585991,62400
"15018","ENSG00000254330","","8",65616331,65647016,30685
"15019","ENSG00000254346","MTND1P6","8",32871599,32872544,945
"15020","ENSG00000254353","","5",70328995,70330227,1232
"15021","ENSG00000254370","","8",28273041,28277572,4531
"15022","ENSG00000254377","LINC00966","8",65285885,65296344,10459
"15023","ENSG00000254389","RHPN1-AS1","8",144448801,144450718,1917
"15024","ENSG00000254402","LRRC24","8",145747761,145752416,4655
"15025","ENSG00000254409","","11",43942609,44022707,80098
"15026","ENSG00000254416","","11",110225855,110277124,51269
"15027","ENSG00000254427","","11",45376922,45387672,10750
"15028","ENSG00000254454","RCC2P6","11",62138618,62140640,2022
"15029","ENSG00000254463","","11",43487942,43488421,479
"15030","ENSG00000254469","","11",71576555,71639700,63145
"15031","ENSG00000254470","AP5B1","11",65543364,65548273,4909
"15032","ENSG00000254473","","9",86322509,86328293,5784
"15033","ENSG00000254505","CHMP4A","14",24678789,24683075,4286
"15034","ENSG00000254510","","11",66176629,66184608,7979
"15035","ENSG00000254512","","11",43755309,43756114,805
"15036","ENSG00000254531","","4",102268937,102270040,1103
"15037","ENSG00000254535","PABPC4L","4",135117488,135122903,5415
"15038","ENSG00000254556","","8",10994408,10996117,1709
"15039","ENSG00000254577","","11",43411833,43417045,5212
"15040","ENSG00000254579","","11",40466854,40468691,1837
"15041","ENSG00000254595","","11",6509416,6510607,1191
"15042","ENSG00000254598","CSNK2A3","11",11373489,11374904,1415
"15043","ENSG00000254602","","11",57405497,57420263,14766
"15044","ENSG00000254612","","11",127810808,127811549,741
"15045","ENSG00000254615","","8",107282372,107285127,2755
"15046","ENSG00000254634","","16",29437121,29465435,28314
"15047","ENSG00000254635","WAC-AS1","10",28811581,28821672,10091
"15048","ENSG00000254665","","11",8714904,8718154,3250
"15049","ENSG00000254676","","11",82891186,82895562,4376
"15050","ENSG00000254682","","11",71159720,71163203,3483
"15051","ENSG00000254685","FPGT","1",74663896,74699770,35874
"15052","ENSG00000254694","","11",126078506,126078922,416
"15053","ENSG00000254701","","5",69435402,69503572,68170
"15054","ENSG00000254708","","11",34356665,34357550,885
"15055","ENSG00000254726","MEX3A","1",156041804,156051789,9985
"15056","ENSG00000254732","","11",57509635,57560715,51080
"15057","ENSG00000254768","","11",22305276,22359791,54515
"15058","ENSG00000254783","","11",85994969,85995710,741
"15059","ENSG00000254790","","11",125810391,125811088,697
"15060","ENSG00000254791","FAR1-IT1","11",13690874,13691696,822
"15061","ENSG00000254837","","11",74204411,74209578,5167
"15062","ENSG00000254838","GVINP1","11",6734767,6767670,32903
"15063","ENSG00000254858","MPV17L2","19",18303992,18307758,3766
"15064","ENSG00000254860","TMEM9B-AS1","11",8986222,8999074,12852
"15065","ENSG00000254876","","9",100000731,100059596,58865
"15066","ENSG00000254884","","11",9332831,9333236,405
"15067","ENSG00000254901","MEF2BNB","19",19287712,19303400,15688
"15068","ENSG00000254905","","11",126162817,126164149,1332
"15069","ENSG00000254910","","11",310139,311141,1002
"15070","ENSG00000254911","SCARNA9","11",93454679,93455032,353
"15071","ENSG00000254912","","15",32786204,32792547,6343
"15072","ENSG00000254936","","8",10980891,10983574,2683
"15073","ENSG00000254981","","8",38258054,38259201,1147
"15074","ENSG00000254982","HMGB1P24","17",35500531,35501387,856
"15075","ENSG00000254985","RSF1-IT2","11",77428757,77429456,699
"15076","ENSG00000254986","DPP3","11",66247484,66277130,29646
"15077","ENSG00000254995","STX16-NPEPL1","20",57226490,57290466,63976
"15078","ENSG00000254996","ANKHD1-EIF4EBP3","5",139781493,139929154,147661
"15079","ENSG00000254999","BRK1","3",10157276,10168874,11598
"15080","ENSG00000255027","","11",125773142,125808811,35669
"15081","ENSG00000255028","","11",109225812,109454633,228821
"15082","ENSG00000255046","","8",11655437,11660077,4640
"15083","ENSG00000255052","FAM66D","8",11973291,12008698,35407
"15084","ENSG00000255062","","11",126164193,126174213,10020
"15085","ENSG00000255097","","11",9263995,9267056,3061
"15086","ENSG00000255103","KIAA0754","1",39876151,39882154,6003
"15087","ENSG00000255112","CHMP1B","18",11851395,11854448,3053
"15088","ENSG00000255121","","11",118865534,118868714,3180
"15089","ENSG00000255135","","11",76152382,76155700,3318
"15090","ENSG00000255142","","11",781645,782105,460
"15091","ENSG00000255150","EID3","12",104697517,104698980,1463
"15092","ENSG00000255176","","11",118507338,118508815,1477
"15093","ENSG00000255198","SNHG9","16",2014960,2015510,550
"15094","ENSG00000255224","","8",145132905,145134168,1263
"15095","ENSG00000255248","","11",121899063,121987031,87968
"15096","ENSG00000255270","NAV2-IT1","11",19402031,19406561,4530
"15097","ENSG00000255282","WTAPP1","11",102617699,102707497,89798
"15098","ENSG00000255284","","11",777578,784297,6719
"15099","ENSG00000255302","EID1","15",49170083,49172380,2297
"15100","ENSG00000255306","","11",67792277,67797928,5651
"15101","ENSG00000255310","","8",10965298,10967236,1938
"15102","ENSG00000255374","TAS2R43","12",11243886,11244912,1026
"15103","ENSG00000255389","","6",111921078,111923498,2420
"15104","ENSG00000255403","","11",105577025,105578663,1638
"15105","ENSG00000255408","PCDHA3","5",140180783,140391929,211146
"15106","ENSG00000255423","EBLN2","3",73110810,73112488,1678
"15107","ENSG00000255434","","11",75307189,75308315,1126
"15108","ENSG00000255435","","11",118382626,118401809,19183
"15109","ENSG00000255455","","11",130736149,130740142,3993
"15110","ENSG00000255458","","4",39640760,39668264,27504
"15111","ENSG00000255468","","11",66115421,66132275,16854
"15112","ENSG00000255517","","11",66240961,66247704,6743
"15113","ENSG00000255529","POLR2M","15",57884231,58074960,190729
"15114","ENSG00000255545","","11",134306367,134375555,69188
"15115","ENSG00000255559","ZNF252P-AS1","8",146228197,146231432,3235
"15116","ENSG00000255561","FDXACB1","11",111744780,111751967,7187
"15117","ENSG00000255571","LINC00925","15",89904810,89939471,34661
"15118","ENSG00000255624","","10",124639246,124658230,18984
"15119","ENSG00000255647","","5",89705817,89706485,668
"15120","ENSG00000255651","","11",63534816,63536113,1297
"15121","ENSG00000255655","","12",109883215,109885302,2087
"15122","ENSG00000255710","","11",113691578,113692607,1029
"15123","ENSG00000255717","SNHG1","11",62619460,62623386,3926
"15124","ENSG00000255794","RMST","12",97825431,97958813,133382
"15125","ENSG00000255823","MTRNR2L8","11",10529434,10530723,1289
"15126","ENSG00000255837","TAS2R20","12",11149094,11150474,1380
"15127","ENSG00000255857","PXN-AS1","12",120639094,120650941,11847
"15128","ENSG00000255864","","12",24366190,24715524,349334
"15129","ENSG00000255893","","11",94206074,94206736,662
"15130","ENSG00000255983","","12",5497755,5515817,18062
"15131","ENSG00000255989","","2",74213653,74220867,7214
"15132","ENSG00000255994","CCDC177","14",70037483,70038032,549
"15133","ENSG00000256018","HIST1H3G","6",26271146,26271612,466
"15134","ENSG00000256019","TAS2R63P","12",11200931,11201855,924
"15135","ENSG00000256031","","12",119438581,119439647,1066
"15136","ENSG00000256043","CTSO","4",156845270,156875069,29799
"15137","ENSG00000256053","APOPT1","14",104029299,104073860,44561
"15138","ENSG00000256060","TRAPPC2P1","19",57874879,57876721,1842
"15139","ENSG00000256061","DYX1C1","15",55702723,55800432,97709
"15140","ENSG00000256073","C21orf119","21",33765439,33766254,815
"15141","ENSG00000256087","ZNF432","19",52534632,52598991,64359
"15142","ENSG00000256092","","12",123848415,123850660,2245
"15143","ENSG00000256139","","12",109549023,109563399,14376
"15144","ENSG00000256146","","12",5425127,5428513,3386
"15145","ENSG00000256188","TAS2R30","12",11285557,11287243,1686
"15146","ENSG00000256223","ZNF10","12",133707161,133736051,28890
"15147","ENSG00000256229","ZNF486","19",20278037,20311299,33262
"15148","ENSG00000256248","","12",67285656,67462942,177286
"15149","ENSG00000256269","HMBS","11",118955576,118964259,8683
"15150","ENSG00000256274","TAS2R64P","12",11229368,11231770,2402
"15151","ENSG00000256294","ZNF225","19",44616334,44637027,20693
"15152","ENSG00000256299","","12",131295366,131297167,1801
"15153","ENSG00000256304","","12",122806669,122808883,2214
"15154","ENSG00000256316","HIST1H3F","6",26250370,26250835,465
"15155","ENSG00000256325","","12",69221898,69222333,435
"15156","ENSG00000256361","","11",18532590,18533022,432
"15157","ENSG00000256383","","19",35166998,35168486,1488
"15158","ENSG00000256393","","12",93477374,93477451,77
"15159","ENSG00000256417","","12",5399646,5492819,93173
"15160","ENSG00000256436","TAS2R31","12",11182986,11184006,1020
"15161","ENSG00000256453","DND1","5",140050379,140053171,2792
"15162","ENSG00000256464","","11",18511790,18512502,712
"15163","ENSG00000256525","POLG2","17",62473902,62493154,19252
"15164","ENSG00000256537","","12",11323963,11324164,201
"15165","ENSG00000256546","","12",122501212,122506522,5310
"15166","ENSG00000256571","","12",64272567,64273254,687
"15167","ENSG00000256588","","11",18529155,18530367,1212
"15168","ENSG00000256594","","12",9787188,9811008,23820
"15169","ENSG00000256628","ZBTB11-AS1","3",101395274,101398061,2787
"15170","ENSG00000256651","","12",10983673,10984615,942
"15171","ENSG00000256663","","12",20704524,20705946,1422
"15172","ENSG00000256667","KLRAP1","12",10741077,10752434,11357
"15173","ENSG00000256673","","12",9550951,9567447,16496
"15174","ENSG00000256682","","12",11047542,11048481,939
"15175","ENSG00000256683","ZNF350","19",52467596,52490109,22513
"15176","ENSG00000256690","","11",62599706,62601515,1809
"15177","ENSG00000256712","","12",11318689,11323952,5263
"15178","ENSG00000256742","","12",122018697,122031409,12712
"15179","ENSG00000256771","ZNF253","19",19976695,20005483,28788
"15180","ENSG00000256845","","2",36816784,36818696,1912
"15181","ENSG00000256885","","11",95556681,95557336,655
"15182","ENSG00000256905","","8",41818758,41820184,1426
"15183","ENSG00000256940","","11",64013436,64015689,2253
"15184","ENSG00000256973","","12",22613453,22616848,3395
"15185","ENSG00000256981","TAS2R18","12",11311384,11312293,909
"15186","ENSG00000257027","","12",9811163,9814681,3518
"15187","ENSG00000257060","","15",93855786,94112712,256926
"15188","ENSG00000257083","","12",67429288,67490186,60898
"15189","ENSG00000257093","KIAA1147","7",141356528,141401953,45425
"15190","ENSG00000257103","LSM14A","19",34663409,34720420,57011
"15191","ENSG00000257110","","13",20247071,20247197,126
"15192","ENSG00000257122","RRN3P3","16",22430090,22449036,18946
"15193","ENSG00000257135","","2",10588820,10591453,2633
"15194","ENSG00000257151","PWAR6","15",25277020,25281637,4617
"15195","ENSG00000257167","TMPO-AS1","12",98906751,98910200,3449
"15196","ENSG00000257169","","12",96780596,96780972,376
"15197","ENSG00000257176","","12",29433351,29470781,37430
"15198","ENSG00000257207","","2",111160511,111230652,70141
"15199","ENSG00000257218","GATC","12",120884241,120899389,15148
"15200","ENSG00000257242","C12orf79","12",92378756,92536690,157934
"15201","ENSG00000257246","","12",51518411,51519164,753
"15202","ENSG00000257261","","12",46777462,46850051,72589
"15203","ENSG00000257267","ZNF271","18",32870246,32890730,20484
"15204","ENSG00000257298","","12",50579363,50585146,5783
"15205","ENSG00000257315","ZBED6","1",203765437,203769686,4249
"15206","ENSG00000257335","MGAM","7",141607613,141806547,198934
"15207","ENSG00000257337","","12",53408380,53448222,39842
"15208","ENSG00000257354","","12",62996532,63007855,11323
"15209","ENSG00000257365","FNTB","14",65381203,65529368,148165
"15210","ENSG00000257390","","12",56151059,56221330,70271
"15211","ENSG00000257433","","12",48099868,48136077,36209
"15212","ENSG00000257446","ZNF878","19",12154620,12167127,12507
"15213","ENSG00000257475","","12",53405888,53407705,1817
"15214","ENSG00000257499","","12",58117544,58119448,1904
"15215","ENSG00000257501","","12",98107190,98155637,48447
"15216","ENSG00000257509","","12",56155334,56156412,1078
"15217","ENSG00000257511","","12",32879317,32880321,1004
"15218","ENSG00000257557","","12",80328681,80334448,5767
"15219","ENSG00000257591","ZNF625","19",12251032,12267546,16514
"15220","ENSG00000257621","","14",58732083,58764852,32769
"15221","ENSG00000257681","","12",104140093,104162636,22543
"15222","ENSG00000257698","","12",58325311,58329958,4647
"15223","ENSG00000257704","PRR24","19",47778142,47778979,837
"15224","ENSG00000257727","CNPY2","12",56703626,56710120,6494
"15225","ENSG00000257742","","12",44112796,44117803,5007
"15226","ENSG00000257800","FNBP1P1","2",74347807,74350345,2538
"15227","ENSG00000257803","","12",100972522,100973975,1453
"15228","ENSG00000257815","","12",70297813,70637140,339327
"15229","ENSG00000257818","","12",69678177,69679265,1088
"15230","ENSG00000257835","","12",77773600,77784644,11044
"15231","ENSG00000257838","","16",22557019,22588186,31167
"15232","ENSG00000257839","","12",76426438,76427677,1239
"15233","ENSG00000257875","","12",82862235,82862727,492
"15234","ENSG00000257890","","12",106444739,106452032,7293
"15235","ENSG00000257923","CUX1","7",101458959,101927249,468290
"15236","ENSG00000257954","","12",49783299,49783945,646
"15237","ENSG00000257986","","14",26305064,26612511,307447
"15238","ENSG00000258056","","12",56122888,56124467,1579
"15239","ENSG00000258057","BCDIN3D-AS1","12",50222325,50234926,12601
"15240","ENSG00000258199","","12",56556143,56584068,27925
"15241","ENSG00000258289","CHURC1","14",65381079,65411309,30230
"15242","ENSG00000258297","","11",66433507,66435845,2338
"15243","ENSG00000258301","","14",77248083,77253067,4984
"15244","ENSG00000258311","","12",56109820,56118487,8667
"15245","ENSG00000258312","","12",98506792,98686223,179431
"15246","ENSG00000258315","C17orf49","17",6917814,6920844,3030
"15247","ENSG00000258325","","12",2906043,2922068,16025
"15248","ENSG00000258337","","12",116612307,116619100,6793
"15249","ENSG00000258359","PCNPP1","12",112107656,112108166,510
"15250","ENSG00000258365","","12",94671534,94676620,5086
"15251","ENSG00000258366","RTEL1","20",62289163,62328416,39253
"15252","ENSG00000258385","","14",41765489,41767937,2448
"15253","ENSG00000258399","MEG8","14",101361107,101402336,41229
"15254","ENSG00000258405","ZNF578","19",52956829,53015407,58578
"15255","ENSG00000258422","","14",70653840,70696904,43064
"15256","ENSG00000258441","LINC00641","14",21668238,21675059,6821
"15257","ENSG00000258445","","14",61246696,61247313,617
"15258","ENSG00000258457","","14",23451907,23468287,16380
"15259","ENSG00000258458","","14",23171820,23235771,63951
"15260","ENSG00000258472","","17",26782770,26941215,158445
"15261","ENSG00000258476","","15",94406338,94421585,15247
"15262","ENSG00000258486","RN7SL1","14",50053297,50053596,299
"15263","ENSG00000258498","DIO3OS","14",102018558,102026768,8210
"15264","ENSG00000258525","","14",31345385,31359014,13629
"15265","ENSG00000258526","","14",39944044,39982984,38940
"15266","ENSG00000258539","","10",126305649,126480296,174647
"15267","ENSG00000258551","","15",91951938,92148441,196503
"15268","ENSG00000258559","","14",74755830,74761128,5298
"15269","ENSG00000258561","","14",66679528,66976112,296584
"15270","ENSG00000258568","RHOQP1","14",50066712,50067290,578
"15271","ENSG00000258584","FAM181A-AS1","14",94371076,94393412,22336
"15272","ENSG00000258590","NBEAP1","15",20862967,20893737,30770
"15273","ENSG00000258592","","14",57532978,57579378,46400
"15274","ENSG00000258611","","15",93608815,93609835,1020
"15275","ENSG00000258631","","15",94133096,94304028,170932
"15276","ENSG00000258634","","1",110600962,110605177,4215
"15277","ENSG00000258643","BCL2L2-PABPN1","14",23776044,23794578,18534
"15278","ENSG00000258655","ARHGAP5-AS1","14",32544625,32545999,1374
"15279","ENSG00000258682","","14",58731380,58736399,5019
"15280","ENSG00000258701","LINC00638","14",105287538,105290055,2517
"15281","ENSG00000258704","","14",35390064,35451738,61674
"15282","ENSG00000258708","SLC25A21-AS1","14",37641093,37643016,1923
"15283","ENSG00000258727","","14",24030306,24037282,6976
"15284","ENSG00000258738","","14",35343549,35345665,2116
"15285","ENSG00000258739","ENO1P2","15",92964090,92965965,1875
"15286","ENSG00000258743","","14",83108964,83173169,64205
"15287","ENSG00000258754","","15",94261771,94614049,352278
"15288","ENSG00000258759","","14",68265721,68266326,605
"15289","ENSG00000258768","","14",20728639,20732467,3828
"15290","ENSG00000258790","","14",35591755,35786680,194925
"15291","ENSG00000258815","","12",85711838,85736690,24852
"15292","ENSG00000258824","","14",64889653,64915275,25622
"15293","ENSG00000258839","MC1R","16",89978527,89987385,8858
"15294","ENSG00000258861","MIR381HG","14",101511494,101518132,6638
"15295","ENSG00000258890","CEP95","17",62502706,62538579,35873
"15296","ENSG00000258900","HNRNPCP1","14",58987941,58988706,765
"15297","ENSG00000258904","","14",100730118,100731742,1624
"15298","ENSG00000258920","FOXN3-AS1","14",89883698,89886137,2439
"15299","ENSG00000258922","","15",93349000,93351797,2797
"15300","ENSG00000258944","","14",73738890,73740789,1899
"15301","ENSG00000258947","","16",89987800,90005169,17369
"15302","ENSG00000258982","","14",100673744,100704892,31148
"15303","ENSG00000259001","RPPH1","14",20811207,20811844,637
"15304","ENSG00000259030","FPGT-TNNI3K","1",74663919,75009666,345747
"15305","ENSG00000259049","","14",53241955,53244458,2503
"15306","ENSG00000259081","","14",77240627,77247861,7234
"15307","ENSG00000259088","","14",102262892,102276658,13766
"15308","ENSG00000259129","LINC00648","14",48234157,48264295,30138
"15309","ENSG00000259151","CAP2P1","14",89756549,89757938,1389
"15310","ENSG00000259153","","14",71276922,71282120,5198
"15311","ENSG00000259158","ADAM20P1","14",70935598,70950473,14875
"15312","ENSG00000259172","","15",101835624,101845942,10318
"15313","ENSG00000259232","","15",65767656,65767952,296
"15314","ENSG00000259248","USP3-AS1","15",63836446,63893788,57342
"15315","ENSG00000259279","","15",39885781,39886432,651
"15316","ENSG00000259280","","15",37168580,37179236,10656
"15317","ENSG00000259287","","15",34150918,34157026,6108
"15318","ENSG00000259290","","11",125058011,125061300,3289
"15319","ENSG00000259291","","15",90617747,90625439,7692
"15320","ENSG00000259295","CSPG4P12","15",85734669,85757136,22467
"15321","ENSG00000259315","","15",83394625,83407656,13031
"15322","ENSG00000259316","","15",64472547,64665980,193433
"15323","ENSG00000259318","","14",55861658,55861951,293
"15324","ENSG00000259326","","15",38795054,38797182,2128
"15325","ENSG00000259330","LINC00984","15",40617417,40618916,1499
"15326","ENSG00000259336","","15",35391223,35461899,70676
"15327","ENSG00000259349","","17",58603654,58628159,24505
"15328","ENSG00000259363","","15",100347228,100417353,70125
"15329","ENSG00000259366","","8",28913452,28914202,750
"15330","ENSG00000259378","DCAF13P3","15",51236860,51238193,1333
"15331","ENSG00000259404","EFTUD1P1","15",84748920,84795356,46436
"15332","ENSG00000259407","","15",86287340,86293512,6172
"15333","ENSG00000259408","","15",34147101,34149010,1909
"15334","ENSG00000259416","","15",86298172,86299468,1296
"15335","ENSG00000259417","","15",80487826,80544555,56729
"15336","ENSG00000259431","THTPA","14",24025216,24029480,4264
"15337","ENSG00000259436","","19",42656721,42661675,4954
"15338","ENSG00000259445","","15",82245644,82288007,42363
"15339","ENSG00000259453","","15",86244340,86246002,1662
"15340","ENSG00000259456","","20",49547521,49561671,14150
"15341","ENSG00000259488","","15",48604550,48624053,19503
"15342","ENSG00000259494","MRPL46","15",89002707,89010650,7943
"15343","ENSG00000259495","","15",80637195,80695917,58722
"15344","ENSG00000259529","","14",24620427,24636611,16184
"15345","ENSG00000259562","","15",78582869,78583563,694
"15346","ENSG00000259581","TYRO3P","15",76551327,76554031,2704
"15347","ENSG00000259606","","14",75310727,75322378,11651
"15348","ENSG00000259610","","15",81926228,81934531,8303
"15349","ENSG00000259623","","17",40004770,40007699,2929
"15350","ENSG00000259630","","15",85958459,85958864,405
"15351","ENSG00000259644","","15",30020390,30021735,1345
"15352","ENSG00000259658","","15",102277302,102285913,8611
"15353","ENSG00000259659","","15",44850027,44851386,1359
"15354","ENSG00000259660","DNM1P47","15",102291235,102334505,43270
"15355","ENSG00000259673","IQCH-AS1","15",67695957,67814182,118225
"15356","ENSG00000259682","","15",64762452,64763563,1111
"15357","ENSG00000259683","","15",84944427,84950601,6174
"15358","ENSG00000259692","","15",81952823,82163466,210643
"15359","ENSG00000259706","HSP90B2P","15",99797837,99800220,2383
"15360","ENSG00000259726","CSPG4P11","15",84855504,84866136,10632
"15361","ENSG00000259727","","15",63188011,63191742,3731
"15362","ENSG00000259732","","15",59413233,59425449,12216
"15363","ENSG00000259736","","15",91163239,91260372,97133
"15364","ENSG00000259751","","15",35141338,35142596,1258
"15365","ENSG00000259758","CASC7","8",141530255,141539600,9345
"15366","ENSG00000259762","","15",86293567,86296132,2565
"15367","ENSG00000259767","","15",83690988,83693088,2100
"15368","ENSG00000259768","","16",72699069,72821143,122074
"15369","ENSG00000259775","","14",103798011,103798704,693
"15370","ENSG00000259781","","15",71457109,71457754,645
"15371","ENSG00000259797","","16",68350704,68352939,2235
"15372","ENSG00000259802","","5",10352813,10353713,900
"15373","ENSG00000259804","","16",67595314,67596212,898
"15374","ENSG00000259806","","16",23683453,23686820,3367
"15375","ENSG00000259820","","8",135804263,135810515,6252
"15376","ENSG00000259826","","7",39987121,39989354,2233
"15377","ENSG00000259834","","1",111196182,111199662,3480
"15378","ENSG00000259845","HERC2P10","15",31107474,31136356,28882
"15379","ENSG00000259865","","1",247350583,247351828,1245
"15380","ENSG00000259867","","16",80188950,80597032,408082
"15381","ENSG00000259877","","16",89281638,89284061,2423
"15382","ENSG00000259887","","12",52242007,52246513,4506
"15383","ENSG00000259891","","8",141515912,141518142,2230
"15384","ENSG00000259901","","16",72823142,72825522,2380
"15385","ENSG00000259905","PWRN1","15",24738284,24897277,158993
"15386","ENSG00000259915","","2",187219299,187221500,2201
"15387","ENSG00000259921","","15",99697436,99701345,3909
"15388","ENSG00000259932","","15",45490715,45491337,622
"15389","ENSG00000259935","","15",52940831,52942063,1232
"15390","ENSG00000259943","","1",40722099,40723639,1540
"15391","ENSG00000259946","","1",98432561,98434370,1809
"15392","ENSG00000259953","","9",114794835,114800010,5175
"15393","ENSG00000259959","","4",47842139,47846356,4217
"15394","ENSG00000259969","","14",58460263,58461243,980
"15395","ENSG00000259972","","16",74339100,74369244,30144
"15396","ENSG00000259976","","3",114033348,114035026,1678
"15397","ENSG00000259985","","18",29265618,29266786,1168
"15398","ENSG00000259994","","10",30591755,30594995,3240
"15399","ENSG00000260000","","6",101329347,101330863,1516
"15400","ENSG00000260006","","2",201689396,201692061,2665
"15401","ENSG00000260023","","16",70610204,70611571,1367
"15402","ENSG00000260025","","2",36581892,36582257,365
"15403","ENSG00000260032","LINC00657","20",34633544,34638882,5338
"15404","ENSG00000260035","","15",45492523,45492830,307
"15405","ENSG00000260038","","16",57281262,57282404,1142
"15406","ENSG00000260054","","7",6694495,6696063,1568
"15407","ENSG00000260060","","16",31207452,31208284,832
"15408","ENSG00000260063","","1",27018623,27020622,1999
"15409","ENSG00000260065","","22",26917949,26921002,3053
"15410","ENSG00000260083","MIR4519","16",30886543,30906541,19998
"15411","ENSG00000260089","ADAM3B","16",49551673,49552512,839
"15412","ENSG00000260093","","8",9907995,9911764,3769
"15413","ENSG00000260101","","2",64749321,64751227,1906
"15414","ENSG00000260114","","16",29930957,29933226,2269
"15415","ENSG00000260122","","12",52203489,52204384,895
"15416","ENSG00000260136","","16",23464079,23468927,4848
"15417","ENSG00000260142","","2",194763091,194764118,1027
"15418","ENSG00000260160","","19",52561743,52566956,5213
"15419","ENSG00000260196","","11",17402196,17405078,2882
"15420","ENSG00000260197","","Y",21853827,21856492,2665
"15421","ENSG00000260211","","15",32605327,32607855,2528
"15422","ENSG00000260219","","16",30366762,30367848,1086
"15423","ENSG00000260230","FRRS1L","9",111892573,111929571,36998
"15424","ENSG00000260231","JHDM1D-AS1","7",139877061,139879440,2379
"15425","ENSG00000260232","PWRN4","15",24220319,24248582,28263
"15426","ENSG00000260236","","3",47420579,47422489,1910
"15427","ENSG00000260248","","17",71171622,71172772,1150
"15428","ENSG00000260249","","16",50700122,50705550,5428
"15429","ENSG00000260257","","20",31444848,31446557,1709
"15430","ENSG00000260260","","16",2204798,2205359,561
"15431","ENSG00000260261","","3",195676059,195679566,3507
"15432","ENSG00000260265","","4",76006912,76009927,3015
"15433","ENSG00000260267","","16",31468032,31471057,3025
"15434","ENSG00000260269","","15",75819491,75893546,74055
"15435","ENSG00000260274","","15",75660496,75661925,1429
"15436","ENSG00000260276","","16",8941962,8954274,12312
"15437","ENSG00000260285","","14",103991347,103995409,4062
"15438","ENSG00000260293","","16",2526559,2527062,503
"15439","ENSG00000260296","","4",40168295,40169451,1156
"15440","ENSG00000260306","","16",21805416,21807080,1664
"15441","ENSG00000260317","","8",81453535,81455339,1804
"15442","ENSG00000260318","COX6CP1","16",11997780,11997994,214
"15443","ENSG00000260329","","12",107347807,107349275,1468
"15444","ENSG00000260336","","7",100737328,100741248,3920
"15445","ENSG00000260339","HEXA-AS1","15",72668454,72671129,2675
"15446","ENSG00000260343","LINC01043","13",112967781,112976072,8291
"15447","ENSG00000260350","","16",8941507,8942581,1074
"15448","ENSG00000260361","","15",93322987,93324722,1735
"15449","ENSG00000260368","","8",101925475,101926616,1141
"15450","ENSG00000260372","AQP4-AS1","18",24235706,24770662,534956
"15451","ENSG00000260388","LINC00562","13",48504290,48506757,2467
"15452","ENSG00000260396","","2",20877569,20879005,1436
"15453","ENSG00000260398","","8",79518187,79521940,3753
"15454","ENSG00000260400","","10",70458257,70460551,2294
"15455","ENSG00000260404","","4",119512928,119554884,41956
"15456","ENSG00000260409","","15",20935076,20961512,26436
"15457","ENSG00000260412","","9",27937615,27944495,6880
"15458","ENSG00000260417","","16",85625872,85629326,3454
"15459","ENSG00000260422","","6",164505055,164506693,1638
"15460","ENSG00000260442","","16",28890278,28891241,963
"15461","ENSG00000260450","","16",47999583,48005598,6015
"15462","ENSG00000260456","C16orf95","16",87117168,87351022,233854
"15463","ENSG00000260461","","10",105637132,105639519,2387
"15464","ENSG00000260482","","16",23681332,23684448,3116
"15465","ENSG00000260493","","8",86084312,86089297,4985
"15466","ENSG00000260495","","16",81344336,81347028,2692
"15467","ENSG00000260526","","4",113150717,113152752,2035
"15468","ENSG00000260534","","15",72882032,72884186,2154
"15469","ENSG00000260539","","16",74481325,74483790,2465
"15470","ENSG00000260565","ERVK13-1","16",2710350,2723445,13095
"15471","ENSG00000260572","","3",160471216,160472930,1714
"15472","ENSG00000260578","","18",65149028,65152203,3175
"15473","ENSG00000260579","","15",83782369,83783318,949
"15474","ENSG00000260583","LINC00515","21",26955082,26955638,556
"15475","ENSG00000260589","","10",17683283,17685877,2594
"15476","ENSG00000260600","","16",61725660,61727654,1994
"15477","ENSG00000260604","","6",3905144,3912213,7069
"15478","ENSG00000260630","SNAI3-AS1","16",88729706,88753594,23888
"15479","ENSG00000260633","","3",134066130,134068075,1945
"15480","ENSG00000260641","","4",99580055,99585701,5646
"15481","ENSG00000260645","","6",81176675,81178797,2122
"15482","ENSG00000260648","","15",40524283,40528308,4025
"15483","ENSG00000260655","","22",42318027,42319104,1077
"15484","ENSG00000260686","","5",122168051,122170228,2177
"15485","ENSG00000260708","","22",47157791,47158460,669
"15486","ENSG00000260735","","16",15188268,15203054,14786
"15487","ENSG00000260742","","2",182752578,182756390,3812
"15488","ENSG00000260751","","16",23579994,23581017,1023
"15489","ENSG00000260766","","1",159994743,159996584,1841
"15490","ENSG00000260774","","5",214013,217394,3381
"15491","ENSG00000260778","MIR940","16",2318156,2323419,5263
"15492","ENSG00000260787","","15",77334178,77335533,1355
"15493","ENSG00000260793","","17",42298769,42301078,2309
"15494","ENSG00000260796","","16",28831891,28833354,1463
"15495","ENSG00000260799","KRT8P50","15",43093166,43094603,1437
"15496","ENSG00000260804","","2",217081768,217084915,3147
"15497","ENSG00000260806","","14",96967147,96968658,1511
"15498","ENSG00000260822","","X",24563633,24568583,4950
"15499","ENSG00000260824","","15",75192333,75193030,697
"15500","ENSG00000260831","","X",103197629,103202112,4483
"15501","ENSG00000260833","","17",36606638,36608688,2050
"15502","ENSG00000260837","","2",8861264,8862816,1552
"15503","ENSG00000260841","","5",180211782,180214869,3087
"15504","ENSG00000260852","FBXL19-AS1","16",30930640,30934590,3950
"15505","ENSG00000260855","","1",246935603,246939074,3471
"15506","ENSG00000260872","","16",15111963,15114345,2382
"15507","ENSG00000260874","","16",2506253,2509980,3727
"15508","ENSG00000260879","","1",108742548,108744113,1565
"15509","ENSG00000260903","XKR7","20",30555805,30591190,35385
"15510","ENSG00000260910","LINC00565","13",114629487,114631817,2330
"15511","ENSG00000260912","","9",19453207,19455171,1964
"15512","ENSG00000260916","CCPG1","15",55632230,55700708,68478
"15513","ENSG00000260917","","10",114583249,114587485,4236
"15514","ENSG00000260919","","15",74905535,74907937,2402
"15515","ENSG00000260920","","1",40929991,40932436,2445
"15516","ENSG00000260924","","22",19158908,19160352,1444
"15517","ENSG00000260931","","2",179265561,179267618,2057
"15518","ENSG00000260936","FTO-IT1","16",54073305,54074638,1333
"15519","ENSG00000260938","","1",178449742,178450341,599
"15520","ENSG00000260942","CAPN10-AS1","2",241522117,241526116,3999
"15521","ENSG00000260947","","9",33697457,33700984,3527
"15522","ENSG00000260948","","1",111973668,111975690,2022
"15523","ENSG00000260949","","8",37920399,37921309,910
"15524","ENSG00000260955","","8",54955549,54958189,2640
"15525","ENSG00000260966","","11",102921416,102926528,5112
"15526","ENSG00000260978","","15",23812411,23814804,2393
"15527","ENSG00000261003","","6",170723227,170728413,5186
"15528","ENSG00000261005","","17",36858705,36861000,2295
"15529","ENSG00000261008","","16",72459384,72698908,239524
"15530","ENSG00000261015","","6",3025025,3027659,2634
"15531","ENSG00000261056","","16",53332136,53333704,1568
"15532","ENSG00000261061","","16",81064375,81065090,715
"15533","ENSG00000261069","SNORD116-21","15",25332808,25334043,1235
"15534","ENSG00000261069","SNORD116-20","15",25332808,25334043,1235
"15535","ENSG00000261072","","15",56484551,56485460,909
"15536","ENSG00000261079","","16",74401360,74403724,2364
"15537","ENSG00000261087","","8",102179033,102181857,2824
"15538","ENSG00000261088","","16",66923072,66924996,1924
"15539","ENSG00000261094","","9",125699902,125702612,2710
"15540","ENSG00000261096","","2",232674556,232677062,2506
"15541","ENSG00000261098","","11",107182858,107186997,4139
"15542","ENSG00000261101","","X",100882858,100883508,650
"15543","ENSG00000261115","TMEM178B","7",140774032,141180180,406148
"15544","ENSG00000261126","RBFADN","18",77806900,77853362,46462
"15545","ENSG00000261135","","1",16841140,16842249,1109
"15546","ENSG00000261136","","15",40074772,40077818,3046
"15547","ENSG00000261167","","3",131173970,131177442,3472
"15548","ENSG00000261185","","1",182610951,182612442,1491
"15549","ENSG00000261188","","22",26908503,26910534,2031
"15550","ENSG00000261221","ZNF865","19",56116771,56128635,11864
"15551","ENSG00000261251","","22",44208336,44213274,4938
"15552","ENSG00000261254","","1",100496122,100501188,5066
"15553","ENSG00000261280","","19",12456763,12458752,1989
"15554","ENSG00000261286","","16",84492865,84500967,8102
"15555","ENSG00000261291","","16",53202434,53203362,928
"15556","ENSG00000261308","","12",52214243,52216199,1956
"15557","ENSG00000261315","LARP4P","15",36909290,36911466,2176
"15558","ENSG00000261324","","12",14915438,14920865,5427
"15559","ENSG00000261326","","1",23607802,23613245,5443
"15560","ENSG00000261330","","16",77926319,77926812,493
"15561","ENSG00000261335","","17",74668024,74669740,1716
"15562","ENSG00000261338","","2",219120042,219122087,2045
"15563","ENSG00000261342","","19",2727741,2729325,1584
"15564","ENSG00000261349","","1",25592593,25593627,1034
"15565","ENSG00000261351","","15",66782086,66784447,2361
"15566","ENSG00000261355","","11",35835882,35839557,3675
"15567","ENSG00000261360","","5",14661917,14664713,2796
"15568","ENSG00000261366","MANEA-AS1","6",96023059,96025326,2267
"15569","ENSG00000261373","VPS9D1-AS1","16",89778264,89784573,6309
"15570","ENSG00000261379","","2",227668752,227669777,1025
"15571","ENSG00000261409","","X",107963179,107968174,4995
"15572","ENSG00000261420","","6",166796677,166798312,1635
"15573","ENSG00000261423","","15",72700119,72767509,67390
"15574","ENSG00000261426","","15",27607456,27611544,4088
"15575","ENSG00000261428","","2",223431624,223434438,2814
"15576","ENSG00000261438","","10",90775593,90776816,1223
"15577","ENSG00000261451","","8",10291182,10295822,4640
"15578","ENSG00000261452","","2",25380063,25382006,1943
"15579","ENSG00000261455","LINC01003","7",152160871,152162634,1763
"15580","ENSG00000261474","","16",31460856,31464814,3958
"15581","ENSG00000261476","","16",75492150,75493915,1765
"15582","ENSG00000261485","PAN3-AS1","13",28710980,28712330,1350
"15583","ENSG00000261488","","3",111852270,111854206,1936
"15584","ENSG00000261490","","4",10069713,10074643,4930
"15585","ENSG00000261496","","4",86933449,86935027,1578
"15586","ENSG00000261504","","1",182584389,182585764,1375
"15587","ENSG00000261512","","16",46656773,46658363,1590
"15588","ENSG00000261526","","19",1874881,1876168,1287
"15589","ENSG00000261529","","15",25590780,25592382,1602
"15590","ENSG00000261533","","3",99898411,99900574,2163
"15591","ENSG00000261534","","9",124577953,124581731,3778
"15592","ENSG00000261542","","8",64128539,64130592,2053
"15593","ENSG00000261553","","13",76123909,76381256,257347
"15594","ENSG00000261556","","16",70253477,70279519,26042
"15595","ENSG00000261560","","16",11974932,11976426,1494
"15596","ENSG00000261574","","16",89458783,89478972,20189
"15597","ENSG00000261578","","11",76511408,76515599,4191
"15598","ENSG00000261584","","6",26686469,26688192,1723
"15599","ENSG00000261589","","17",53246184,53250993,4809
"15600","ENSG00000261596","","16",21638063,21638723,660
"15601","ENSG00000261597","","15",49944336,49948429,4093
"15602","ENSG00000261609","GAN","16",81348557,81424489,75932
"15603","ENSG00000261622","","15",24157556,24186863,29307
"15604","ENSG00000261635","","15",36905675,36906399,724
"15605","ENSG00000261643","","4",3505324,3506184,860
"15606","ENSG00000261652","C15orf65","15",55700746,55710962,10216
"15607","ENSG00000261654","","1",111478991,111484975,5984
"15608","ENSG00000261659","","16",739001,742554,3553
"15609","ENSG00000261662","","1",120451878,120453236,1358
"15610","ENSG00000261668","","4",128761353,128765195,3842
"15611","ENSG00000261685","","16",50679720,50683160,3440
"15612","ENSG00000261705","","16",66921918,66922834,916
"15613","ENSG00000261712","","15",79705700,79706228,528
"15614","ENSG00000261716","","1",149816065,149820591,4526
"15615","ENSG00000261732","","16",1682260,1736716,54456
"15616","ENSG00000261744","","16",88579368,88597461,18093
"15617","ENSG00000261758","","3",136471472,136474622,3150
"15618","ENSG00000261762","","15",78881465,78883618,2153
"15619","ENSG00000261766","","16",28873487,28874661,1174
"15620","ENSG00000261770","","19",28248092,28251757,3665
"15621","ENSG00000261775","","15",74781943,74809300,27357
"15622","ENSG00000261777","","16",70349543,70380650,31107
"15623","ENSG00000261783","","16",75413716,75415158,1442
"15624","ENSG00000261794","GOLGA8H","15",30896329,30906764,10435
"15625","ENSG00000261799","","12",383120,386289,3169
"15626","ENSG00000261801","LOXL1-AS1","15",74200424,74220589,20165
"15627","ENSG00000261824","LINC00662","19",28175488,28284848,109360
"15628","ENSG00000261839","","6",28104627,28107456,2829
"15629","ENSG00000261840","","16",30709030,30710379,1349
"15630","ENSG00000261879","","17",5095379,5151364,55985
"15631","ENSG00000261884","","16",67963517,67969920,6403
"15632","ENSG00000261889","","16",3206737,3207484,747
"15633","ENSG00000261916","","17",3505055,3505566,511
"15634","ENSG00000261934","PCDHGA9","5",140782520,140892546,110026
"15635","ENSG00000261970","","6",80262511,80262877,366
"15636","ENSG00000261971","","16",3101992,3109371,7379
"15637","ENSG00000261997","","16",55572112,55575939,3827
"15638","ENSG00000262001","DLGAP1-AS2","18",3602998,3608334,5336
"15639","ENSG00000262049","","17",79668354,79670330,1976
"15640","ENSG00000262074","SNORD3B-2","17",18966762,18967449,687
"15641","ENSG00000262089","","17",6897961,6898508,547
"15642","ENSG00000262096","PCDHB19P","5",140619518,140621864,2346
"15643","ENSG00000262119","","14",27061953,27063723,1770
"15644","ENSG00000262155","","16",25078258,25080264,2006
"15645","ENSG00000262180","OCLM","1",186369704,186370587,883
"15646","ENSG00000262194","","17",3705459,3706676,1217
"15647","ENSG00000262198","","13",23492730,23498741,6011
"15648","ENSG00000262202","SNORD3D","17",19015313,19015949,636
"15649","ENSG00000262209","PCDHGB3","5",140749831,140892546,142715
"15650","ENSG00000262246","CORO7","16",4404543,4475706,71163
"15651","ENSG00000262248","","17",3522550,3523207,657
"15652","ENSG00000262251","","17",7588578,7589689,1111
"15653","ENSG00000262265","","17",45238441,45239430,989
"15654","ENSG00000262333","HNRNPA1P16","17",2210055,2211009,954
"15655","ENSG00000262380","","16",15777147,15778427,1280
"15656","ENSG00000262429","","17",4871290,4872117,827
"15657","ENSG00000262434","","17",692984,693765,781
"15658","ENSG00000262470","TVP23CP2","16",14294214,14294836,622
"15659","ENSG00000262484","CCER2","19",39399620,39402798,3178
"15660","ENSG00000262514","","16",68233698,68234884,1186
"15661","ENSG00000262576","PCDHGA4","5",140734768,140892546,157778
"15662","ENSG00000262580","","17",78174472,78179748,5276
"15663","ENSG00000262583","","16",75533686,75550178,16492
"15664","ENSG00000262601","","16",85204882,85218969,14087
"15665","ENSG00000262728","","15",32898619,32907361,8742
"15666","ENSG00000262758","","17",3710042,3712148,2106
"15667","ENSG00000262766","","16",31129399,31130068,669
"15668","ENSG00000262837","","17",47911601,47913816,2215
"15669","ENSG00000262873","","17",78991769,78993811,2042
"15670","ENSG00000262877","","17",79361930,79364056,2126
"15671","ENSG00000262879","","17",45061411,45177689,116278
"15672","ENSG00000262904","","16",74701404,74702604,1200
"15673","ENSG00000262944","","16",9198705,9200618,1913
"15674","ENSG00000263002","ZNF234","19",44645710,44663156,17446
"15675","ENSG00000263004","","17",55155659,55162385,6726
"15676","ENSG00000263006","ROCK1P1","18",109065,122219,13154
"15677","ENSG00000263013","","16",11032743,11033901,1158
"15678","ENSG00000263069","","17",78325628,78388968,63340
"15679","ENSG00000263072","","16",3166043,3184883,18840
"15680","ENSG00000263142","LRRC37A17P","17",45055847,45131935,76088
"15681","ENSG00000263214","ZNF205-AS1","16",3160461,3165599,5138
"15682","ENSG00000263235","","16",3700637,3701704,1067
"15683","ENSG00000263244","","16",9201098,9207038,5940
"15684","ENSG00000263276","","16",68258616,68261637,3021
"15685","ENSG00000263320","","16",71963914,71965102,1188
"15686","ENSG00000263327","TAPT1-AS1","4",16228286,16321763,93477
"15687","ENSG00000263335","","16",15820531,15826850,6319
"15688","ENSG00000263350","","18",19210099,19213485,3386
"15689","ENSG00000263391","","6",24840195,24840293,98
"15690","ENSG00000263400","","17",10633094,10718481,85387
"15691","ENSG00000263412","","17",46122503,46125435,2932
"15692","ENSG00000263426","RN7SL471P","6",28945252,28945547,295
"15693","ENSG00000263445","MIR4450","4",77494721,77494785,64
"15694","ENSG00000263470","","17",63096930,63107176,10246
"15695","ENSG00000263551","","18",976590,1174824,198234
"15696","ENSG00000263571","","17",32488756,32491270,2514
"15697","ENSG00000263603","","17",29056487,29058220,1733
"15698","ENSG00000263606","","18",2945548,2946888,1340
"15699","ENSG00000263621","RN7SL650P","14",21897669,21897965,296
"15700","ENSG00000263675","MIR5581","1",37966536,37966595,59
"15701","ENSG00000263677","","18",24268075,24269632,1557
"15702","ENSG00000263727","","18",653985,657259,3274
"15703","ENSG00000263731","","17",79836301,79838982,2681
"15704","ENSG00000263740","RN7SL4P","3",15780022,15780315,293
"15705","ENSG00000263753","LINC00667","18",5232875,5246507,13632
"15706","ENSG00000263766","","17",45681226,45726786,45560
"15707","ENSG00000263786","","17",73141356,73142641,1285
"15708","ENSG00000263809","","17",8271956,8286505,14549
"15709","ENSG00000263818","","17",37213272,37269443,56171
"15710","ENSG00000263843","","17",73267450,73269976,2526
"15711","ENSG00000263874","LINC00672","17",37081421,37084310,2889
"15712","ENSG00000263883","","17",61713961,61714473,512
"15713","ENSG00000263884","","18",268148,270278,2130
"15714","ENSG00000263934","SNORD3A","17",19091329,19092027,698
"15715","ENSG00000263968","RN7SL381P","16",85692984,85693279,295
"15716","ENSG00000264043","","12",109171920,109174194,2274
"15717","ENSG00000264063","MIR3687","21",9826203,9826263,60
"15718","ENSG00000264098","","17",26729128,26731067,1939
"15719","ENSG00000264099","MIR4803","5",71465294,71465367,73
"15720","ENSG00000264107","","17",29417805,29422468,4663
"15721","ENSG00000264109","MIR4712","15",50652526,50652607,81
"15722","ENSG00000264112","","17",56066400,56072211,5811
"15723","ENSG00000264222","","18",14244624,14252139,7515
"15724","ENSG00000264229","RNU4ATAC","2",122288457,122288583,126
"15725","ENSG00000264235","","18",3255434,3261848,6414
"15726","ENSG00000264247","LINC00909","18",72259010,72265744,6734
"15727","ENSG00000264278","","18",74506688,74534251,27563
"15728","ENSG00000264345","","18",22513451,22567646,54195
"15729","ENSG00000264350","SNRPGP2","18",51933259,51933484,225
"15730","ENSG00000264364","DYNLL2","17",56160776,56172897,12121
"15731","ENSG00000264370","MIR3125","2",12877493,12877570,77
"15732","ENSG00000264449","","18",5887486,5909121,21635
"15733","ENSG00000264462","MIR3648","21",9825832,9826011,179
"15734","ENSG00000264469","","17",25641669,25642952,1283
"15735","ENSG00000264496","","4",25355592,25355693,101
"15736","ENSG00000264538","","17",29036317,29117926,81609
"15737","ENSG00000264546","","17",60627087,60629482,2395
"15738","ENSG00000264575","LINC00526","18",5236723,5238597,1874
"15739","ENSG00000264596","","18",7814116,7815728,1612
"15740","ENSG00000264635","","18",738058,739662,1604
"15741","ENSG00000264660","","17",20841851,20885670,43819
"15742","ENSG00000264801","","9",21929456,21931072,1616
"15743","ENSG00000264853","","17",73367028,73369817,2789
"15744","ENSG00000264885","","17",18570942,18572774,1832
"15745","ENSG00000264895","","17",49326940,49329109,2169
"15746","ENSG00000264898","","9",66861461,66861543,82
"15747","ENSG00000264920","","17",45968621,45973178,4557
"15748","ENSG00000264940","SNORD3C","17",19092978,19093558,580
"15749","ENSG00000264943","SH3GL1P2","17",28951431,28952512,1081
"15750","ENSG00000264991","","8",101720106,101720191,85
"15751","ENSG00000265093","RN7SL246P","12",46267812,46268111,299
"15752","ENSG00000265112","MIR3153","9",91927140,91927221,81
"15753","ENSG00000265137","MIR3192","20",18451259,18451335,76
"15754","ENSG00000265148","BZRAP1-AS1","17",56402811,56493127,90316
"15755","ENSG00000265150","RN7SL2","14",50329271,50329567,296
"15756","ENSG00000265179","","18",902767,906668,3901
"15757","ENSG00000265185","SNORD3B-1","17",18965225,18965807,582
"15758","ENSG00000265195","MIR4312","15",69094189,69094264,75
"15759","ENSG00000265218","","17",62888847,62906298,17451
"15760","ENSG00000265242","","17",73161681,73163344,1663
"15761","ENSG00000265314","MIR548AH","4",77496704,77496779,75
"15762","ENSG00000265413","","18",8402845,8405159,2314
"15763","ENSG00000265451","","2",122287998,122290281,2283
"15764","ENSG00000265458","","17",80412149,80416397,4248
"15765","ENSG00000265462","MIR3680-2","16",21517370,21517456,86
"15766","ENSG00000265462","MIR3680-1","16",21517370,21517456,86
"15767","ENSG00000265579","","18",70410991,70413196,2205
"15768","ENSG00000265624","RN7SL166P","13",20311117,20311394,277
"15769","ENSG00000265625","","17",27971814,27972865,1051
"15770","ENSG00000265681","RPL17","18",47014851,47018906,4055
"15771","ENSG00000265683","","17",25678884,25679610,726
"15772","ENSG00000265688","MAFG-AS1","17",79885705,79888629,2924
"15773","ENSG00000265692","","17",80247922,80250690,2768
"15774","ENSG00000265713","","17",28102765,28103719,954
"15775","ENSG00000265727","RN7SL648P","X",73462445,73462736,291
"15776","ENSG00000265735","RN7SL5P","9",9442060,9442347,287
"15777","ENSG00000265750","","18",21739473,21742175,2702
"15778","ENSG00000265800","","17",73134511,73137445,2934
"15779","ENSG00000265806","MIR4292","9",139725409,139725475,66
"15780","ENSG00000265817","FSBP","8",95390605,95449180,58575
"15781","ENSG00000265821","RN7SL739P","17",43603820,43604112,292
"15782","ENSG00000265828","MIR3939","6",167411295,167411400,105
"15783","ENSG00000265917","MIR3685","12",95703699,95703760,61
"15784","ENSG00000265945","RN7SL721P","1",10450059,10450353,294
"15785","ENSG00000265948","","18",18896839,18897756,917
"15786","ENSG00000265962","","18",8695854,8707619,11765
"15787","ENSG00000265967","","15",64987240,64987793,553
"15788","ENSG00000265981","MIR544B","3",124451286,124451363,77
"15789","ENSG00000266019","MIR3609","7",98479273,98479352,79
"15790","ENSG00000266021","","9",68997409,68997484,75
"15791","ENSG00000266037","RN7SL3","14",50320336,50320632,296
"15792","ENSG00000266045","","5",75627662,75629781,2119
"15793","ENSG00000266053","","18",9121263,9136643,15380
"15794","ENSG00000266098","","1",19410046,19410145,99
"15795","ENSG00000266126","","17",19832685,19833050,365
"15796","ENSG00000266127","","18",9785105,9787802,2697
"15797","ENSG00000266173","STRADA","17",61780192,61819330,39138
"15798","ENSG00000266208","","17",38516907,38520945,4038
"15799","ENSG00000266236","NARF-IT1","17",80439974,80441264,1290
"15800","ENSG00000266239","MIR3605","1",33797994,33798093,99
"15801","ENSG00000266258","","18",68002675,68019695,17020
"15802","ENSG00000266352","RN7SL192P","19",11122384,11122680,296
"15803","ENSG00000266371","","17",29460200,29465536,5336
"15804","ENSG00000266378","","17",14230652,14232791,2139
"15805","ENSG00000266402","SNORA76","17",62223330,62223836,506
"15806","ENSG00000266405","CBX3P2","18",2652169,2655394,3225
"15807","ENSG00000266490","","17",29119390,29119851,461
"15808","ENSG00000266538","","17",15434087,15434403,316
"15809","ENSG00000266555","MIR3145","6",138756350,138756431,81
"15810","ENSG00000266638","","17",8090493,8090577,84
"15811","ENSG00000266644","","17",62895884,62896834,950
"15812","ENSG00000266680","","6",64280910,64282313,1403
"15813","ENSG00000266709","","17",14207171,14208822,1651
"15814","ENSG00000266714","MYO15B","17",73584139,73622929,38790
"15815","ENSG00000266753","","17",37408897,37410550,1653
"15816","ENSG00000266777","SH3GL1P1","17",30366993,30369847,2854
"15817","ENSG00000266803","","17",16461299,16462583,1284
"15818","ENSG00000266844","","18",74686646,74696118,9472
"15819","ENSG00000266852","MIR4482-1","10",106028080,106028177,97
"15820","ENSG00000266865","","17",29335515,29420145,84630
"15821","ENSG00000266896","","6",170170509,170172138,1629
"15822","ENSG00000266897","","19",13242385,13243224,839
"15823","ENSG00000266900","","18",59913043,59914645,1602
"15824","ENSG00000266904","LINC00663","19",19868175,19887232,19057
"15825","ENSG00000266910","","19",30528330,30529063,733
"15826","ENSG00000266912","","19",9455460,9456574,1114
"15827","ENSG00000266916","","19",37988063,37997948,9885
"15828","ENSG00000266921","","19",44501048,44506988,5940
"15829","ENSG00000266926","","19",1581789,1582322,533
"15830","ENSG00000266930","","19",33366831,33369327,2496
"15831","ENSG00000266935","","19",37119695,37121092,1397
"15832","ENSG00000266946","MRPL37P1","18",56357588,56359385,1797
"15833","ENSG00000266962","","17",40704456,40706766,2310
"15834","ENSG00000266965","","18",33175865,33177563,1698
"15835","ENSG00000266967","AARSD1","17",41102543,41116515,13972
"15836","ENSG00000266972","LRRC37A9P","17",34239639,34245014,5375
"15837","ENSG00000266993","","1",52259637,52264824,5187
"15838","ENSG00000266999","","17",34220711,34238027,17316
"15839","ENSG00000267002","","17",41316200,41322420,6220
"15840","ENSG00000267010","","18",56419380,56421709,2329
"15841","ENSG00000267030","","19",4447301,4448214,913
"15842","ENSG00000267034","","2",223181961,223183372,1411
"15843","ENSG00000267040","","18",55297534,55405276,107742
"15844","ENSG00000267041","ZNF850","19",37205285,37263727,58442
"15845","ENSG00000267058","","19",44395956,44405957,10001
"15846","ENSG00000267060","PTGES3L","17",41120105,41132545,12440
"15847","ENSG00000267080","ASB16-AS1","17",42253341,42264085,10744
"15848","ENSG00000267093","","19",55911113,55911787,674
"15849","ENSG00000267100","ILF3-AS1","19",10762538,10764520,1982
"15850","ENSG00000267102","","17",33736621,33737247,626
"15851","ENSG00000267106","C19orf82","19",9731967,9756572,24605
"15852","ENSG00000267127","","18",77794346,77854968,60622
"15853","ENSG00000267128","RNF157-AS1","17",74136637,74150731,14094
"15854","ENSG00000267152","","19",38219487,38221544,2057
"15855","ENSG00000267160","","17",42751057,42753625,2568
"15856","ENSG00000267161","","19",1573595,1575474,1879
"15857","ENSG00000267167","","18",44383187,44383857,670
"15858","ENSG00000267169","","19",14247991,14282079,34088
"15859","ENSG00000267191","","19",44406153,44430697,24544
"15860","ENSG00000267194","","17",67547499,67550002,2503
"15861","ENSG00000267199","","18",12438889,12448204,9315
"15862","ENSG00000267213","","19",32880956,32896466,15510
"15863","ENSG00000267216","","19",58790332,58826563,36231
"15864","ENSG00000267221","","17",40192731,40195135,2404
"15865","ENSG00000267226","","18",56337712,56339109,1397
"15866","ENSG00000267242","","19",44978645,44979403,758
"15867","ENSG00000267243","","19",28926295,29218684,292389
"15868","ENSG00000267248","","17",58203896,58213005,9109
"15869","ENSG00000267249","","18",12670425,12671144,719
"15870","ENSG00000267251","","18",77941563,77960875,19312
"15871","ENSG00000267254","","19",37288420,37319017,30597
"15872","ENSG00000267260","","19",37264055,37267980,3925
"15873","ENSG00000267270","","18",77905807,77936315,30508
"15874","ENSG00000267274","","19",12050774,12064196,13422
"15875","ENSG00000267279","","18",59252979,59274149,21170
"15876","ENSG00000267283","","19",1989400,1990369,969
"15877","ENSG00000267298","","19",56823297,56823855,558
"15878","ENSG00000267313","","18",39047395,39212149,164754
"15879","ENSG00000267317","","19",1457664,1462764,5100
"15880","ENSG00000267321","","17",33895139,33901811,6672
"15881","ENSG00000267347","","17",34145403,34150717,5314
"15882","ENSG00000267350","","17",18227536,18229211,1675
"15883","ENSG00000267365","KCNJ2-AS1","17",68163102,68165543,2441
"15884","ENSG00000267370","","19",9866828,9867539,711
"15885","ENSG00000267374","LINC00669","18",36786888,37380282,593394
"15886","ENSG00000267381","","19",37978901,37979554,653
"15887","ENSG00000267383","","19",20236186,20432114,195928
"15888","ENSG00000267390","","18",61034561,61048862,14301
"15889","ENSG00000267397","","18",33296334,33297942,1608
"15890","ENSG00000267405","","17",42872115,42875151,3036
"15891","ENSG00000267414","","18",42256892,42259682,2790
"15892","ENSG00000267416","","17",58156670,58166056,9386
"15893","ENSG00000267419","","19",19887411,19945736,58325
"15894","ENSG00000267427","","19",6210390,6212492,2102
"15895","ENSG00000267430","","18",61082550,61083702,1152
"15896","ENSG00000267454","ZNF582-AS1","19",56905025,56910541,5516
"15897","ENSG00000267470","ZNF571-AS1","19",38039816,38078249,38433
"15898","ENSG00000267473","","19",38888821,38890521,1700
"15899","ENSG00000267481","","19",19899564,19901340,1776
"15900","ENSG00000267500","","19",11759179,11763692,4513
"15901","ENSG00000267506","","17",75543022,75559325,16303
"15902","ENSG00000267508","ZNF285","19",44886459,44905774,19315
"15903","ENSG00000267526","","17",58140365,58142143,1778
"15904","ENSG00000267534","S1PR2","19",10334520,10341948,7428
"15905","ENSG00000267547","","17",33730856,33731392,536
"15906","ENSG00000267575","","19",28284371,28409771,125400
"15907","ENSG00000267586","LINC00907","18",39739247,40271387,532140
"15908","ENSG00000267587","","18",44432595,44433845,1250
"15909","ENSG00000267632","","17",40661802,40663537,1735
"15910","ENSG00000267672","","19",37582243,37583466,1223
"15911","ENSG00000267680","ZNF224","19",44598492,44612479,13987
"15912","ENSG00000267682","","19",37828138,37828645,507
"15913","ENSG00000267698","","19",36505410,36536874,31464
"15914","ENSG00000267701","","18",60981035,60981315,280
"15915","ENSG00000267717","SRSF10P1","18",48684652,48685753,1101
"15916","ENSG00000267745","","17",33733703,33736787,3084
"15917","ENSG00000267751","","19",567212,572215,5003
"15918","ENSG00000267756","","18",14074911,14075740,829
"15919","ENSG00000267784","","2",179588184,179591773,3589
"15920","ENSG00000267793","","Y",21760074,21760643,569
"15921","ENSG00000267796","LIN37","19",36239262,36245420,6158
"15922","ENSG00000267809","NDUFV2P1","19",53727226,53728132,906
"15923","ENSG00000267838","","19",54949847,54950362,515
"15924","ENSG00000267855","NDUFA7","19",8373490,8386280,12790
"15925","ENSG00000267858","","19",59070496,59086164,15668
"15926","ENSG00000267871","","19",57778588,57791702,13114
"15927","ENSG00000267886","","19",23258003,23283163,25160
"15928","ENSG00000267904","","19",16750778,16751479,701
"15929","ENSG00000267939","","19",8073613,8080909,7296
"15930","ENSG00000267940","","11",6223131,6224483,1352
"15931","ENSG00000267957","","10",75880013,75880621,608
"15932","ENSG00000267980","","19",4363786,4364637,851
"15933","ENSG00000268001","","19",48758932,48761456,2524
"15934","ENSG00000268006","PTOV1-AS1","19",50341896,50354933,13037
"15935","ENSG00000268049","","19",58869365,58870969,1604
"15936","ENSG00000268061","NAPA-AS1","19",47987539,48004854,17315
"15937","ENSG00000268105","","19",23308467,23311345,2878
"15938","ENSG00000268119","","19",21627043,21646710,19667
"15939","ENSG00000268129","","3",142719749,142720309,560
"15940","ENSG00000268175","","3",149689066,149690535,1469
"15941","ENSG00000268182","SMIM17","19",57154513,57167134,12621
"15942","ENSG00000268201","","19",58778001,58779051,1050
"15943","ENSG00000268205","","19",57815673,57819930,4257
"15944","ENSG00000268225","","19",53365060,53366119,1059
"15945","ENSG00000268279","","3",14176717,14189548,12831
"15946","ENSG00000268357","VN1R81P","19",21306620,21306991,371
"15947","ENSG00000268362","","19",24216247,24249711,33464
"15948","ENSG00000268364","SMC5-AS1","9",72808913,72873782,64869
"15949","ENSG00000268375","","19",51295942,51296841,899
"15950","ENSG00000268392","","19",58136400,58138318,1918
"15951","ENSG00000268397","","5",180682720,180684578,1858
"15952","ENSG00000268403","","11",9481747,9482010,263
"15953","ENSG00000268471","MIR4453","4",153457416,153460415,2999
"15954","ENSG00000268496","","19",54945363,54945845,482
"15955","ENSG00000268516","","19",58768639,58790174,21535
"15956","ENSG00000268521","VN1R83P","19",21472356,21472800,444
"15957","ENSG00000268543","","19",58929927,58930677,750
"15958","ENSG00000268573","","18",32860831,32870165,9334
"15959","ENSG00000268575","","1",1634175,1669127,34952
"15960","ENSG00000268584","","10",75385754,75386548,794
"15961","ENSG00000268670","","19",4061613,4062747,1134
"15962","ENSG00000268688","","2",37068327,37068530,203
"15963","ENSG00000268713","","19",57772722,57774106,1384
"15964","ENSG00000268798","","19",1440838,1441937,1099
"15965","ENSG00000268816","","19",54697731,54698394,663
"15966","ENSG00000268869","ESPNP","1",17013834,17046652,32818
"15967","ENSG00000268885","","5",667759,668839,1080
"15968","ENSG00000268895","A1BG-AS1","19",58859117,58866549,7432
"15969","ENSG00000268912","","19",58939999,58942515,2516
"15970","ENSG00000268948","","19",58203868,58204128,260
"15971","ENSG00000268995","VN1R82P","19",21371401,21371756,355
"15972","ENSG00000269019","","19",19051131,19057640,6509
"15973","ENSG00000269028","MTRNR2L12","3",96335981,96337000,1019
"15974","ENSG00000269044","","19",16744614,16746080,1466
"15975","ENSG00000269051","","19",53700364,53714268,13904
"15976","ENSG00000269054","","19",58873951,58877958,4007
"15977","ENSG00000269069","","19",40529291,40531409,2118
"15978","ENSG00000269113","TRABD2B","1",48226200,48462567,236367
"15979","ENSG00000269176","","11",62553498,62554257,759
"15980","ENSG00000269189","","13",98885904,98886954,1050
"15981","ENSG00000269190","FBXO17","19",39432044,39466550,34506
"15982","ENSG00000269293","ZSCAN16-AS1","6",28089573,28105071,15498
"15983","ENSG00000269337","","9",70646589,70648956,2367
"15984","ENSG00000269343","ZNF587B","19",58331099,58370018,38919
"15985","ENSG00000269352","","19",50360227,50362546,2319
"15986","ENSG00000269365","","18",45404666,45408815,4149
"15987","ENSG00000269374","","19",42989228,42989866,638
"15988","ENSG00000269375","","14",101359265,101360646,1381
"15989","ENSG00000269378","ITGB1P1","19",14732446,14733054,608
"15990","ENSG00000269386","RAB11B-AS1","19",8439257,8455569,16312
"15991","ENSG00000269397","","19",24110590,24112089,1499
"15992","ENSG00000269416","","19",23582035,23598877,16842
"15993","ENSG00000269421","ZNF92P3","19",24118022,24118975,953
"15994","ENSG00000269430","LRRC3DN","21",45879814,45882078,2264
"15995","ENSG00000269439","","19",17599799,17622698,22899
"15996","ENSG00000269473","","19",58951815,58957216,5401
"15997","ENSG00000269514","","12",48592170,48595814,3644
"15998","ENSG00000269533","","19",57901252,57931362,30110
"15999","ENSG00000269545","","19",58740831,58798173,57342
"16000","ENSG00000269609","","10",104209574,104220863,11289
"16001","ENSG00000269657","","17",66539369,66542970,3601
"16002","ENSG00000269688","","19",39335369,39336139,770
"16003","ENSG00000269693","","19",12636534,12691789,55255
"16004","ENSG00000269696","","19",57056935,57078780,21845
"16005","ENSG00000269707","","2",105469743,105542510,72767
"16006","ENSG00000269728","","3",179113877,179115965,2088
"16007","ENSG00000269772","","10",75880800,75881121,321
"16008","ENSG00000269821","KCNQ1OT1","11",2629558,2721224,91666
"16009","ENSG00000269825","","19",53153690,53156537,2847
"16010","ENSG00000269834","","19",52892095,52901019,8924
"16011","ENSG00000269837","","19",23437855,23440741,2886
"16012","ENSG00000269858","EGLN2","19",41304901,41314338,9437
"16013","ENSG00000269867","","19",58378406,58379540,1134
"16014","ENSG00000269887","","1",164649322,164650036,714
"16015","ENSG00000269891","ARHGAP19-SLIT1","10",98757795,99052413,294618
"16016","ENSG00000269893","SNHG8","4",119199864,119200978,1114
"16017","ENSG00000269895","","11",86544110,86548657,4547
"16018","ENSG00000269896","","1",2281853,2284259,2406
"16019","ENSG00000269900","RMRP","9",35657748,35658015,267
"16020","ENSG00000269902","","X",45624175,45624702,527
"16021","ENSG00000269906","","14",51129229,51129896,667
"16022","ENSG00000269918","","8",10962201,10964214,2013
"16023","ENSG00000269921","","4",57253791,57254319,528
"16024","ENSG00000269924","","8",48439959,48440710,751
"16025","ENSG00000269925","","1",7836443,7836835,392
"16026","ENSG00000269929","","9",96938740,96940174,1434
"16027","ENSG00000269936","MIR145","5",148809849,148812397,2548
"16028","ENSG00000269938","","12",124452570,124453126,556
"16029","ENSG00000269939","","11",82896563,82898078,1515
"16030","ENSG00000269940","","14",104160897,104161507,610
"16031","ENSG00000269942","","13",103331776,103332308,532
"16032","ENSG00000269947","","17",8181081,8181754,673
"16033","ENSG00000269951","","15",77359996,77360667,671
"16034","ENSG00000269958","","14",104162690,104163500,810
"16035","ENSG00000269963","","14",104179904,104180586,682
"16036","ENSG00000269965","","13",51935701,51936371,670
"16037","ENSG00000269967","","1",32317514,32387442,69928
"16038","ENSG00000269968","","12",6646960,6647536,576
"16039","ENSG00000269973","","2",10076489,10079719,3230
"16040","ENSG00000269974","","15",30941000,30941732,732
"16041","ENSG00000269978","","1",7760764,7761030,266
"16042","ENSG00000269979","","9",125086887,125087594,707
"16043","ENSG00000269982","","3",10000401,10004223,3822
"16044","ENSG00000269984","","3",169494980,169498122,3142
"16045","ENSG00000269990","","11",66303369,66305407,2038
"16046","ENSG00000269994","","9",89623370,89657041,33671
"16047","ENSG00000269996","","1",121133256,121134581,1325
"16048","ENSG00000269997","","12",124450624,124451176,552
"16049","ENSG00000269998","","1",98399030,98407302,8272
"16050","ENSG00000270005","","12",124420169,124420753,584
"16051","ENSG00000270010","","17",40190250,40190752,502
"16052","ENSG00000270011","ZNF559-ZNF177","19",9434850,9493293,58443
"16053","ENSG00000270012","","X",49129517,49132231,2714
"16054","ENSG00000270015","","15",31218717,31220610,1893
"16055","ENSG00000270016","","15",30899898,30900396,498
"16056","ENSG00000270018","","12",112335140,112335710,570
"16057","ENSG00000270019","","2",114645780,114647327,1547
"16058","ENSG00000270022","RNU12","22",43011250,43011913,663
"16059","ENSG00000270035","","1",7758363,7758932,569
"16060","ENSG00000270039","","12",58197621,58198198,577
"16061","ENSG00000270041","","22",24080865,24081476,611
"16062","ENSG00000270048","","12",124447102,124447364,262
"16063","ENSG00000270049","","16",67515217,67521153,5936
"16064","ENSG00000270055","","15",30780166,30782516,2350
"16065","ENSG00000270059","","3",65344943,65345392,449
"16066","ENSG00000270060","","11",47189832,47191114,1282
"16067","ENSG00000270061","","12",124454537,124454891,354
"16068","ENSG00000270062","","14",51190495,51190990,495
"16069","ENSG00000270066","SCARNA2","1",109642815,109643241,426
"16070","ENSG00000270067","","5",112229030,112229698,668
"16071","ENSG00000270069","","X",45604639,45629677,25038
"16072","ENSG00000270071","","21",17664112,17680454,16342
"16073","ENSG00000270081","","2",128601127,128603261,2134
"16074","ENSG00000270083","","22",42485634,42486032,398
"16075","ENSG00000270084","GAS5-AS1","1",173832386,173833079,693
"16076","ENSG00000270091","","17",19799903,19800600,697
"16077","ENSG00000270093","","21",18015848,18017384,1536
"16078","ENSG00000270095","","12",124456004,124456261,257
"16079","ENSG00000270100","","2",20878014,20878692,678
"16080","ENSG00000270101","","13",51936795,51937579,784
"16081","ENSG00000270103","RNU11","1",28975112,28975245,133
"16082","ENSG00000270108","","14",104153913,104154464,551
"16083","ENSG00000270109","","4",57330324,57330745,421
"16084","ENSG00000270115","","1",33726813,33727281,468
"16085","ENSG00000270116","","21",38473114,38473643,529
"16086","ENSG00000270124","","16",85613615,85617177,3562
"16087","ENSG00000270127","","15",101087972,101090358,2386
"16088","ENSG00000270130","","12",124445264,124445791,527
"16089","ENSG00000270133","","5",93947611,93953827,6216
"16090","ENSG00000270137","","8",133838424,133839148,724
"16091","ENSG00000270140","","14",74371970,74372339,369
"16092","ENSG00000270141","TERC","3",169482308,169482848,540
"16093","ENSG00000270143","","19",15346330,15346819,489
"16094","ENSG00000270145","","17",38459457,38460909,1452
"16095","ENSG00000270157","","7",141362722,141363646,924
"16096","ENSG00000270170","NCBP2-AS2","3",196669494,196670411,917
"16097","ENSG00000270171","","1",7753184,7754904,1720
"16098","ENSG00000270172","","1",53708036,53710212,2176
"16099","ENSG00000270175","","12",53893946,53894720,774
"16100","ENSG00000270177","","5",133562101,133563518,1417
"16101","ENSG00000270189","","X",53198279,53200096,1817
"16102","ENSG00000270195","","4",1714548,1715349,801
"16103","ENSG00000270246","SNORD109A","15",25287065,25287575,510
"16104","ENSG00000270277","","2",179413611,179415408,1797
"16105","ENSG00000270332","","9",106842305,106855354,13049
"16106","ENSG00000270343","UNGP3","14",81725909,81726583,674
"16107","ENSG00000270346","","6",3020388,3022984,2596
"16108","ENSG00000270362","HMGN3-AS1","6",79943435,79946514,3079
"16109","ENSG00000270408","","20",10625847,10627014,1167
"16110","ENSG00000270419","CAHM","6",163834097,163834992,895
"16111","ENSG00000270426","","4",185393078,185393763,685
"16112","ENSG00000270441","","3",49177519,49198284,20765
"16113","ENSG00000270491","","11",34764453,34764746,293
"16114","ENSG00000270504","","6",3751345,3754105,2760
"16115","ENSG00000270540","","2",237276203,237277745,1542
"16116","ENSG00000270558","","5",37286551,37287079,528
"16117","ENSG00000270574","","2",179443517,179445633,2116
"16118","ENSG00000270581","","13",103053821,103054807,986
"16119","ENSG00000270604","HCG17","6",30201816,30293911,92095
"16120","ENSG00000270605","","1",28566020,28567964,1944
"16121","ENSG00000270638","","6",146056706,146058354,1648
"16122","ENSG00000270659","","2",214017694,214018383,689
"16123","ENSG00000270661","","6",112538841,112540771,1930
"16124","ENSG00000270681","","4",152061143,152062255,1112
"16125","ENSG00000270696","","2",75887588,75889334,1746
"16126","ENSG00000270704","SNORD64","15",25230011,25230320,309
"16127","ENSG00000270804","","19",58379253,58380202,949
"16128","ENSG00000270820","","2",61698323,61711265,12942
"16129","ENSG00000270878","","14",64060749,64062009,1260
"16130","ENSG00000270923","TAS2R6","7",141487615,141488440,825
"16131","ENSG00000270933","","7",25988277,25989023,746
"16132","ENSG00000270949","","6",160529406,160532536,3130
"16133","ENSG00000270953","","7",130147501,130148123,622
"16134","ENSG00000270956","","2",179405852,179406526,674
"16135","ENSG00000270959","LPP-AS2","3",187868994,187871845,2851
"16136","ENSG00000270964","","15",67833410,67834942,1532
"16137","ENSG00000271009","","16",73094369,73096215,1846
"16138","ENSG00000271011","","2",179441830,179442349,519
"16139","ENSG00000271020","","3",33838641,33839173,532
"16140","ENSG00000271043","MTRNR2L2","5",79945819,79946855,1036
"16141","ENSG00000271122","","7",35734824,35739023,4199
"16142","ENSG00000271133","","7",20367922,20371370,3448
"16143","ENSG00000271141","","2",179481308,179481850,542
"16144","ENSG00000271147","","X",101854440,101969599,115159
"16145","ENSG00000271151","","2",174833079,174834146,1067
"16146","ENSG00000271204","","7",130614968,130616965,1997
"16147","ENSG00000271270","TMCC1-AS1","3",129612714,129637418,24704
"16148","ENSG00000271327","","12",89761584,89763078,1494
"16149","ENSG00000271335","","10",35603480,35625329,21849
"16150","ENSG00000271347","","15",25236633,25236900,267
"16151","ENSG00000271359","","4",90032651,90033519,868
"16152","ENSG00000271369","","11",34731147,34731708,561
"16153","ENSG00000271380","","1",154934301,154935099,798
"16154","ENSG00000271401","","2",179509444,179509906,462
"16155","ENSG00000271417","","14",101433989,101452987,18998
"16156","ENSG00000271430","","X",73420064,73461983,41919
"16157","ENSG00000271452","","2",75897115,75897580,465
"16158","ENSG00000271474","","4",96470280,96473608,3328
"16159","ENSG00000271533","","X",73429811,73433495,3684
"16160","ENSG00000271551","","6",157097494,157098211,717
"16161","ENSG00000271576","","1",84542014,84543614,1600
"16162","ENSG00000271590","","2",111968572,111970053,1481
"16163","ENSG00000271614","LINC00936","12",90102736,90106367,3631
"16164","ENSG00000271643","","3",33837180,33838442,1262
"16165","ENSG00000271646","","4",185395956,185398458,2502
"16166","ENSG00000271659","","9",98276327,98276802,475
"16167","ENSG00000271721","","1",146647181,146649319,2138
"16168","ENSG00000271738","","10",82194765,82196869,2104
"16169","ENSG00000271743","","8",6473125,6474719,1594
"16170","ENSG00000271769","","12",121438289,121439071,782
"16171","ENSG00000271780","","14",102414684,102415762,1078
"16172","ENSG00000271781","","5",675941,676731,790
"16173","ENSG00000271789","","6",111618329,111619713,1384
"16174","ENSG00000271815","","5",74659585,74660067,482
"16175","ENSG00000271816","","10",75458909,75490245,31336
"16176","ENSG00000271833","","9",130129049,130129676,627
"16177","ENSG00000271835","","3",37026534,37026975,441
"16178","ENSG00000271840","","1",22427106,22427853,747
"16179","ENSG00000271843","","3",63993758,63994368,610
"16180","ENSG00000271851","","17",9456640,9459013,2373
"16181","ENSG00000271862","","5",82345195,82346783,1588
"16182","ENSG00000271870","","3",3194626,3195119,493
"16183","ENSG00000271895","","1",11089716,11090585,869
"16184","ENSG00000271912","","8",144683416,144685394,1978
"16185","ENSG00000271913","","6",159409210,159485957,76747
"16186","ENSG00000271917","","1",164797673,164799189,1516
"16187","ENSG00000271918","","5",115419504,115421113,1609
"16188","ENSG00000271927","","8",6503576,6506025,2449
"16189","ENSG00000271936","","2",25048479,25049586,1107
"16190","ENSG00000271947","","2",7045855,7046432,577
"16191","ENSG00000271948","","8",17082473,17082978,505
"16192","ENSG00000271964","","3",16355946,16356494,548
"16193","ENSG00000271966","","8",68256210,68257322,1112
"16194","ENSG00000271971","","8",94727606,94728341,735
"16195","ENSG00000271975","","8",125318430,125320617,2187
"16196","ENSG00000271976","","3",53893021,53895603,2582
"16197","ENSG00000271997","","15",89045175,89049018,3843
"16198","ENSG00000272002","","2",7401002,7401635,633
"16199","ENSG00000272003","","15",42188137,42189031,894
"16200","ENSG00000272004","","1",1590786,1594063,3277
"16201","ENSG00000272005","","8",424455,427966,3511
"16202","ENSG00000272008","","6",87860877,87865003,4126
"16203","ENSG00000272016","","5",10654332,10657928,3596
"16204","ENSG00000272033","","1",167348345,167350237,1892
"16205","ENSG00000272034","SNORD14A","11",17096201,17096291,90
"16206","ENSG00000272047","GTF2H5","6",158589384,158620376,30992
"16207","ENSG00000272048","","2",25450724,25451090,366
"16208","ENSG00000272053","","6",25015180,25042398,27218
"16209","ENSG00000272054","","2",37436018,37439820,3802
"16210","ENSG00000272056","","2",27276486,27277144,658
"16211","ENSG00000272066","","X",82761031,82764222,3191
"16212","ENSG00000272070","","5",140705777,140708924,3147
"16213","ENSG00000272072","","7",106833004,106833745,741
"16214","ENSG00000272076","","8",52722670,52723241,571
"16215","ENSG00000272077","","3",44708904,44710856,1952
"16216","ENSG00000272084","","1",19398604,19402005,3401
"16217","ENSG00000272086","","5",32174577,32175378,801
"16218","ENSG00000272091","","1",54492356,54494172,1816
"16219","ENSG00000272093","","5",71656517,71658805,2288
"16220","ENSG00000272106","","1",1549138,1551175,2037
"16221","ENSG00000272108","","5",140498262,140500347,2085
"16222","ENSG00000272129","","6",81065141,81066576,1435
"16223","ENSG00000272137","","6",80270849,80271319,470
"16224","ENSG00000272140","","10",75463493,75473339,9846
"16225","ENSG00000272142","","6",5030206,5043683,13477
"16226","ENSG00000272143","FGF14-AS2","13",103046980,103048053,1073
"16227","ENSG00000272145","NFYC-AS1","1",41156052,41157738,1686
"16228","ENSG00000272146","","3",57583442,57586654,3212
"16229","ENSG00000272148","","2",27285296,27285775,479
"16230","ENSG00000272155","","8",66626569,66627013,444
"16231","ENSG00000272159","","8",38265566,38266260,694
"16232","ENSG00000272163","","8",24769678,24772230,2552
"16233","ENSG00000272168","CASC15","6",21665003,22214734,549731
"16234","ENSG00000272198","","1",181060245,181062035,1790
"16235","ENSG00000272201","","12",7087683,7089103,1420
"16236","ENSG00000272216","","22",22638312,22641586,3274
"16237","ENSG00000272219","","7",101603396,101605174,1778
"16238","ENSG00000272223","","6",43001635,43002143,508
"16239","ENSG00000272263","","3",12873718,12874227,509
"16240","ENSG00000272267","","8",9412656,9414030,1374
"16241","ENSG00000272275","","2",10908001,10910184,2183
"16242","ENSG00000272277","","6",3068279,3069128,849
"16243","ENSG00000272283","","21",47955709,47956003,294
"16244","ENSG00000272288","","6",34664094,34665247,1153
"16245","ENSG00000272294","","X",82766304,82767135,831
"16246","ENSG00000272301","","11",76100692,76101172,480
"16247","ENSG00000272308","","5",60162284,60162762,478
"16248","ENSG00000272316","","6",58234838,58240189,5351
"16249","ENSG00000272325","NUDT3","6",34247456,34360451,112995
"16250","ENSG00000272327","","8",32623643,32625477,1834
"16251","ENSG00000272335","","5",44826178,44828694,2516
"16252","ENSG00000272338","","8",33218361,33218933,572
"16253","ENSG00000272343","","8",57135247,57135732,485
"16254","ENSG00000272344","SNORD114-21","14",101448312,101448383,71
"16255","ENSG00000272345","","6",24701135,24702021,886
"16256","ENSG00000272356","","6",111630406,111634720,4314
"16257","ENSG00000272365","","5",71663446,71664222,776
"16258","ENSG00000272367","","5",86672073,86672997,924
"16259","ENSG00000272369","","12",46931285,47046333,115048
"16260","ENSG00000272371","","1",53020490,53020945,455
"16261","ENSG00000272373","","10",43069633,43134016,64383
"16262","ENSG00000272374","","6",35188147,35192407,4260
"16263","ENSG00000272377","","7",96251318,96293650,42332
"16264","ENSG00000272379","","6",13290250,13290722,472
"16265","ENSG00000272403","","6",116765323,116766023,700
"16266","ENSG00000272426","","1",17230834,17231271,437
"16267","ENSG00000272447","","10",81585658,81587358,1700
"16268","ENSG00000272449","","1",2477904,2478899,995
"16269","ENSG00000272452","","3",40507957,40510078,2121
"16270","ENSG00000272455","","1",1344476,1345998,1522
"16271","ENSG00000272462","","6",25992890,26002003,9113
"16272","ENSG00000272468","","6",27090436,27091000,564
"16273","ENSG00000272472","","6",122964533,122965916,1383
"16274","ENSG00000272476","","6",108278617,108281190,2573
"16275","ENSG00000272498","","3",16380815,16381378,563
"16276","ENSG00000272501","","6",31162977,31165814,2837
"16277","ENSG00000272505","","8",10344317,10347176,2859
"16278","ENSG00000272511","","3",21453714,21455436,1722
"16279","ENSG00000272512","","1",931346,933431,2085
"16280","ENSG00000272515","","13",88260162,88261489,1327
"16281","ENSG00000272518","","8",80868700,80869616,916
"16282","ENSG00000272520","","5",6671219,6674499,3280
"16283","ENSG00000272525","","5",72793375,72794118,743
"16284","ENSG00000272529","","3",16386633,16387947,1314
"16285","ENSG00000272533","SNORA28","14",103804186,103804311,125
"16286","ENSG00000272544","","7",101676303,101677447,1144
"16287","ENSG00000272549","","6",168067520,168079950,12430
"16288","ENSG00000272562","","1",226248413,226249577,1164
"16289","ENSG00000272563","","2",114190177,114193619,3442
"16290","ENSG00000272565","","3",141876369,141880820,4451
"16291","ENSG00000272572","","10",102670860,102672496,1636
"16292","ENSG00000272574","","1",162562893,162563544,651
"16293","ENSG00000272576","","4",52784938,52785547,609
"16294","ENSG00000272578","","22",24000281,24059543,59262
"16295","ENSG00000272579","","1",193059996,193060686,690
"16296","ENSG00000272593","","9",131153740,131154295,555
"16297","ENSG00000272599","","10",74884331,74885163,832
"16298","ENSG00000272604","","7",105211530,105214107,2577
"16299","ENSG00000272606","","2",55845044,55845508,464
"16300","ENSG00000272610","MAGI1-IT1","3",65858490,65940233,81743
"16301","ENSG00000272630","","10",74857802,74861055,3253
"16302","ENSG00000272631","","10",88509511,88516055,6544
"16303","ENSG00000272644","","2",219934076,219934531,455
"16304","ENSG00000272645","","1",224139096,224141141,2045
"16305","ENSG00000272654","","1",153950219,153951636,1417
"16306","ENSG00000272655","","7",44053161,44058769,5608
"16307","ENSG00000272658","","14",24778161,24781252,3091
"16308","ENSG00000272667","","2",128644130,128644759,629
"16309","ENSG00000272677","","4",83295454,83305180,9726
"16310","ENSG00000272686","","7",123389122,123391220,2098
"16311","ENSG00000272688","","18",3246399,3247084,685
"16312","ENSG00000272711","","2",75059782,75061114,1332
"16313","ENSG00000272716","","2",32390115,32390826,711
"16314","ENSG00000272732","","7",7589735,7592071,2336
"16315","ENSG00000272750","","1",222832209,222834854,2645
"16316","ENSG00000272754","","2",32546707,32548071,1364
"16317","ENSG00000272758","","3",122135054,122162027,26973
"16318","ENSG00000272761","","3",112315641,112320749,5108
"16319","ENSG00000272764","","10",5855948,5856404,456
"16320","ENSG00000272769","","2",133103189,133104870,1681
"16321","ENSG00000272777","","4",99988407,99989276,869
"16322","ENSG00000272779","","22",22657589,22664766,7177
"16323","ENSG00000272782","","7",97937257,97939753,2496
"16324","ENSG00000272788","","18",8801654,8802303,649
"16325","ENSG00000272791","","10",75390314,75391248,934
"16326","ENSG00000272796","","1",23243175,23247993,4818
"16327","ENSG00000272797","","3",168645263,168645707,444
"16328","ENSG00000272800","","2",184079047,184080128,1081
"16329","ENSG00000272807","","2",210893141,210893880,739
"16330","ENSG00000272812","","8",183119,183692,573
"16331","ENSG00000272817","","10",93667888,93669105,1217
"16332","ENSG00000272821","","22",50962355,50963209,854
"16333","ENSG00000272831","","7",66204816,66205372,556
"16334","ENSG00000272841","","6",161411350,161413374,2024
"16335","ENSG00000272842","","9",19371384,19371943,559
"16336","ENSG00000272870","","4",174284931,174291597,6666
"16337","ENSG00000272871","","9",14588795,14590063,1268
"16338","ENSG00000272888","","15",93425937,93441975,16038
"16339","ENSG00000272892","","10",69609283,69610504,1221
"16340","ENSG00000272894","","7",7592093,7606627,14534
"16341","ENSG00000272899","","7",128510821,128512098,1277
"16342","ENSG00000272909","","14",64907087,64908956,1869
"16343","ENSG00000272911","","17",2591767,2592254,487
"16344","ENSG00000272918","","7",104743285,104745930,2645
"16345","ENSG00000272931","","1",90285733,90286427,694
"16346","ENSG00000272936","","4",44706422,44706982,560
"16347","ENSG00000272944","","2",222437226,222439174,1948
"16348","ENSG00000272945","","20",32869438,32874272,4834
"16349","ENSG00000272947","","3",124467422,124468120,698
"16350","ENSG00000272954","","22",22016223,22016652,429
"16351","ENSG00000272955","","22",24375562,24376211,649
"16352","ENSG00000272960","","9",131067440,131067794,354
"16353","ENSG00000272970","","3",184451863,184456737,4874
"16354","ENSG00000272977","","22",25872185,25875938,3753
"16355","ENSG00000272980","","6",167412893,167552629,139736
"16356","ENSG00000272983","","10",38426265,38433327,7062
"16357","ENSG00000272986","","4",71569464,71570208,744
"16358","ENSG00000272993","","1",149817383,149818053,670
"16359","ENSG00000272994","","2",105950484,105953932,3448
"16360","ENSG00000273002","","1",155948590,155952777,4187
"16361","ENSG00000273004","","1",185286911,185287662,751
"16362","ENSG00000273007","","4",123803033,123805867,2834
"16363","ENSG00000273014","","7",32798494,32798965,471
"16364","ENSG00000273015","LINC00938","12",46119510,46121558,2048
"16365","ENSG00000273017","","21",30731323,30731774,451
"16366","ENSG00000273032","DGCR9","22",19005347,19007761,2414
"16367","ENSG00000273033","","3",122605788,122611243,5455
"16368","ENSG00000273035","","2",39550469,39550945,476
"16369","ENSG00000273038","","10",33176189,33178239,2050
"16370","ENSG00000273058","","1",236699473,236700004,531
"16371","ENSG00000273061","","9",4676600,4679502,2902
"16372","ENSG00000273064","","2",68480002,68480980,978
"16373","ENSG00000273066","","9",139693675,139704494,10819
"16374","ENSG00000273079","GRIN2B","12",13693165,14133053,439888
"16375","ENSG00000273080","","2",86422713,86423172,459
"16376","ENSG00000273081","","7",140702410,140704649,2239
"16377","ENSG00000273084","","7",5468362,5469303,941
"16378","ENSG00000273117","","7",155087628,155089251,1623
"16379","ENSG00000273131","","1",120693320,120697146,3826
"16380","ENSG00000273133","","4",15565321,15565876,555
"16381","ENSG00000273148","","20",18775173,18776711,1538
"16382","ENSG00000273156","","4",83266029,83266693,664
"16383","ENSG00000273162","","10",102819786,102820762,976
"16384","ENSG00000273165","","2",32078045,32078492,447
"16385","ENSG00000273173","","15",25200133,25223729,23596
"16386","ENSG00000273175","","1",245028040,245028574,534
"16387","ENSG00000273186","","9",131193877,131194285,408
"16388","ENSG00000273192","","22",50295876,50298224,2348
"16389","ENSG00000273230","","7",1504133,1507158,3025
"16390","ENSG00000273243","","22",45551420,45551892,472
"16391","ENSG00000273247","","4",140333081,140375188,42107
"16392","ENSG00000273270","","7",128164070,128171123,7053
"16393","ENSG00000273271","","21",33039041,33039560,519
"16394","ENSG00000273274","ZBTB8B","1",32930670,32962287,31617
"16395","ENSG00000273281","","9",131068269,131068629,360
"16396","ENSG00000273284","","18",9259386,9260388,1002
"16397","ENSG00000273290","","17",10575791,10579323,3532
"16398","ENSG00000273294","","5",33987279,34124633,137354
"16399","ENSG00000273295","","22",24243619,24249255,5636
"16400","ENSG00000273306","","2",100021680,100022305,625
"16401","ENSG00000273311","DGCR11","22",19033675,19035888,2213
"16402","ENSG00000273314","","7",148393559,148395756,2197
"16403","ENSG00000273329","","7",129244389,129251471,7082
"16404","ENSG00000273343","","22",20305642,20306272,630
"16405","ENSG00000273344","PAXIP1-AS1","7",154795158,154797413,2255
"16406","ENSG00000273352","","18",9519447,9520197,750
"16407","ENSG00000273355","","18",813275,813757,482
"16408","ENSG00000273373","","1",110912776,110915625,2849
"16409","ENSG00000273381","","9",93968457,93972581,4124
"16410","ENSG00000273382","","1",109630593,109633480,2887
"16411","ENSG00000273402","","8",187045,187669,624
"16412","ENSG00000273419","","7",149555489,149559581,4092
"16413","ENSG00000273448","","7",66798034,66799370,1336
"16414","ENSG00000273449","","4",164450923,164451849,926
"16415","ENSG00000273451","","20",45976881,45977886,1005
"16416","ENSG00000273456","","2",203239655,203240327,672
"16417","ENSG00000273466","","2",219497979,219498737,758
"16418","ENSG00000273477","","7",16127152,16129275,2123
"16419","ENSG00000273486","","3",136556180,136557863,1683
"16420","ENSG00000273489","","7",131178723,131182453,3730
